Regret,NumWaitingJob,STime_A_Avg,STime_B_Avg,STime_A_VS_B_Avg,STime_A_VS_B_Avg_Diff,STime_A_Min,STime_B_Min,STime_A_VS_B_Min,STime_A_VS_B_Min_Diff,STime_A_Max,STime_B_Max,STime_A_VS_B_Max,STime_A_VS_B_Max_Diff,PTime_A_Avg,PTime_B_Avg,PTime_A_VS_B_Avg,PTime_A_VS_B_Avg_Diff,PTime_A_Min,PTime_B_Min,PTime_A_VS_B_Min,PTime_A_VS_B_Min_Diff,PTime_A_Max,PTime_B_Max,PTime_A_VS_B_Max,PTime_A_VS_B_Max_Diff,Due_A,Due_B,Due_A_VS_B,Due_A_VS_B_Diff
0,17,0.0,0.0,=,0.0,0,0,=,0,0,0,=,0,42.0,43.666666666666664,<,-1.6666666666666643,38,39,<,-1,45,46,<,-1,127,200,<,-73
86,17,0.0,0.0,=,0.0,0,0,=,0,0,0,=,0,43.666666666666664,42.0,>,1.6666666666666643,39,38,>,1,46,45,>,1,200,127,>,73
0,17,0.0,0.0,=,0.0,0,0,=,0,0,0,=,0,42.0,42.666666666666664,<,-0.6666666666666643,38,37,>,1,45,50,<,-5,127,192,<,-65
14,17,0.0,0.0,=,0.0,0,0,=,0,0,0,=,0,42.666666666666664,42.0,>,0.6666666666666643,37,38,<,-1,50,45,>,5,192,127,>,65
0,17,0.0,0.0,=,0.0,0,0,=,0,0,0,=,0,42.0,38.666666666666664,>,3.3333333333333357,38,33,>,5,45,43,>,2,127,152,<,-25
19,17,0.0,0.0,=,0.0,0,0,=,0,0,0,=,0,38.666666666666664,42.0,<,-3.3333333333333357,33,38,<,-5,43,45,<,-2,152,127,>,25
0,17,0.0,0.0,=,0.0,0,0,=,0,0,0,=,0,42.0,45.666666666666664,<,-3.6666666666666643,38,39,<,-1,45,54,<,-9,127,198,<,-71
22,17,0.0,0.0,=,0.0,0,0,=,0,0,0,=,0,45.666666666666664,42.0,>,3.6666666666666643,39,38,>,1,54,45,>,9,198,127,>,71
0,17,0.0,0.0,=,0.0,0,0,=,0,0,0,=,0,42.0,40.666666666666664,>,1.3333333333333357,38,32,>,6,45,57,<,-12,127,148,<,-21
30,17,0.0,0.0,=,0.0,0,0,=,0,0,0,=,0,40.666666666666664,42.0,<,-1.3333333333333357,32,38,<,-6,57,45,>,12,148,127,>,21
0,17,0.0,0.0,=,0.0,0,0,=,0,0,0,=,0,42.0,44.0,<,-2.0,38,36,>,2,45,50,<,-5,127,96,>,31
47,17,0.0,0.0,=,0.0,0,0,=,0,0,0,=,0,44.0,42.0,>,2.0,36,38,<,-2,50,45,>,5,96,127,<,-31
0,17,0.0,0.0,=,0.0,0,0,=,0,0,0,=,0,42.0,53.333333333333336,<,-11.333333333333336,38,50,<,-12,45,56,<,-11,127,259,<,-132
49,17,0.0,0.0,=,0.0,0,0,=,0,0,0,=,0,53.333333333333336,42.0,>,11.333333333333336,50,38,>,12,56,45,>,11,259,127,>,132
0,17,0.0,0.0,=,0.0,0,0,=,0,0,0,=,0,42.0,43.666666666666664,<,-1.6666666666666643,38,31,>,7,45,56,<,-11,127,256,<,-129
95,17,0.0,0.0,=,0.0,0,0,=,0,0,0,=,0,43.666666666666664,42.0,>,1.6666666666666643,31,38,<,-7,56,45,>,11,256,127,>,129
0,17,0.0,0.0,=,0.0,0,0,=,0,0,0,=,0,42.0,58.0,<,-16.0,38,56,<,-18,45,59,<,-14,127,242,<,-115
59,17,0.0,0.0,=,0.0,0,0,=,0,0,0,=,0,58.0,42.0,>,16.0,56,38,>,18,59,45,>,14,242,127,>,115
0,17,0.0,0.0,=,0.0,0,0,=,0,0,0,=,0,42.0,49.333333333333336,<,-7.333333333333336,38,40,<,-2,45,54,<,-9,127,273,<,-146
80,17,0.0,0.0,=,0.0,0,0,=,0,0,0,=,0,49.333333333333336,42.0,>,7.333333333333336,40,38,>,2,54,45,>,9,273,127,>,146
0,17,0.0,0.0,=,0.0,0,0,=,0,0,0,=,0,42.0,47.666666666666664,<,-5.666666666666664,38,42,<,-4,45,57,<,-12,127,196,<,-69
4,17,0.0,0.0,=,0.0,0,0,=,0,0,0,=,0,47.666666666666664,42.0,>,5.666666666666664,42,38,>,4,57,45,>,12,196,127,>,69
0,17,0.0,0.0,=,0.0,0,0,=,0,0,0,=,0,42.0,47.333333333333336,<,-5.333333333333336,38,31,>,7,45,60,<,-15,127,225,<,-98
71,17,0.0,0.0,=,0.0,0,0,=,0,0,0,=,0,47.333333333333336,42.0,>,5.333333333333336,31,38,<,-7,60,45,>,15,225,127,>,98
0,17,0.0,0.0,=,0.0,0,0,=,0,0,0,=,0,42.0,50.0,<,-8.0,38,44,<,-6,45,56,<,-11,127,118,>,9
9,17,0.0,0.0,=,0.0,0,0,=,0,0,0,=,0,50.0,42.0,>,8.0,44,38,>,6,56,45,>,11,118,127,<,-9
0,17,0.0,0.0,=,0.0,0,0,=,0,0,0,=,0,42.0,41.666666666666664,>,0.3333333333333357,38,35,>,3,45,49,<,-4,127,218,<,-91
5,17,0.0,0.0,=,0.0,0,0,=,0,0,0,=,0,41.666666666666664,42.0,<,-0.3333333333333357,35,38,<,-3,49,45,>,4,218,127,>,91
0,17,0.0,0.0,=,0.0,0,0,=,0,0,0,=,0,42.0,36.0,>,6.0,38,31,>,7,45,39,>,6,127,234,<,-107
26,17,0.0,0.0,=,0.0,0,0,=,0,0,0,=,0,36.0,42.0,<,-6.0,31,38,<,-7,39,45,<,-6,234,127,>,107
0,17,0.0,0.0,=,0.0,0,0,=,0,0,0,=,0,42.0,37.333333333333336,>,4.666666666666664,38,31,>,7,45,48,<,-3,127,105,>,22
75,17,0.0,0.0,=,0.0,0,0,=,0,0,0,=,0,37.333333333333336,42.0,<,-4.666666666666664,31,38,<,-7,48,45,>,3,105,127,<,-22
0,16,14.0,6.666666666666667,>,7.333333333333333,0,0,=,0,42,20,>,22,44.0,47.666666666666664,<,-3.6666666666666643,36,42,<,-6,50,57,<,-7,96,196,<,-100
8,16,6.666666666666667,14.0,<,-7.333333333333333,0,0,=,0,20,42,<,-22,47.666666666666664,44.0,>,3.6666666666666643,42,36,>,6,57,50,>,7,196,96,>,100
0,16,14.0,12.666666666666666,>,1.333333333333334,0,0,=,0,42,38,>,4,44.0,41.666666666666664,>,2.3333333333333357,36,35,>,1,50,49,>,1,96,218,<,-122
80,16,12.666666666666666,14.0,<,-1.333333333333334,0,0,=,0,38,42,<,-4,41.666666666666664,44.0,<,-2.3333333333333357,35,36,<,-1,49,50,<,-1,218,96,>,122
0,16,14.0,19.333333333333332,<,-5.333333333333332,0,0,=,0,42,58,<,-16,44.0,50.0,<,-6.0,36,44,<,-8,50,56,<,-6,96,118,<,-22
58,16,19.333333333333332,14.0,>,5.333333333333332,0,0,=,0,58,42,>,16,50.0,44.0,>,6.0,44,36,>,8,56,50,>,6,118,96,>,22
0,16,14.0,12.666666666666666,>,1.333333333333334,0,0,=,0,42,38,>,4,44.0,42.666666666666664,>,1.3333333333333357,36,37,<,-1,50,50,=,0,96,192,<,-96
18,16,12.666666666666666,14.0,<,-1.333333333333334,0,0,=,0,38,42,<,-4,42.666666666666664,44.0,<,-1.3333333333333357,37,36,>,1,50,50,=,0,192,96,>,96
0,16,14.0,7.333333333333333,>,6.666666666666667,0,0,=,0,42,22,>,20,44.0,38.666666666666664,>,5.333333333333336,36,33,>,3,50,43,>,7,96,152,<,-56
29,16,7.333333333333333,14.0,<,-6.666666666666667,0,0,=,0,22,42,<,-20,38.666666666666664,44.0,<,-5.333333333333336,33,36,<,-3,43,50,<,-7,152,96,>,56
0,16,14.0,16.333333333333332,<,-2.333333333333332,0,0,=,0,42,49,<,-7,44.0,45.666666666666664,<,-1.6666666666666643,36,39,<,-3,50,54,<,-4,96,198,<,-102
54,16,16.333333333333332,14.0,>,2.333333333333332,0,0,=,0,49,42,>,7,45.666666666666664,44.0,>,1.6666666666666643,39,36,>,3,54,50,>,4,198,96,>,102
0,16,14.0,17.0,<,-3.0,0,0,=,0,42,51,<,-9,44.0,36.0,>,8.0,36,31,>,5,50,39,>,11,96,234,<,-138
85,16,17.0,14.0,>,3.0,0,0,=,0,51,42,>,9,36.0,44.0,<,-8.0,31,36,<,-5,39,50,<,-11,234,96,>,138
0,16,14.0,13.666666666666666,>,0.3333333333333339,0,0,=,0,42,41,>,1,44.0,40.666666666666664,>,3.3333333333333357,36,32,>,4,50,57,<,-7,96,148,<,-52
49,16,13.666666666666666,14.0,<,-0.3333333333333339,0,0,=,0,41,42,<,-1,40.666666666666664,44.0,<,-3.3333333333333357,32,36,<,-4,57,50,>,7,148,96,>,52
0,16,14.0,18.666666666666668,<,-4.666666666666668,0,0,=,0,42,56,<,-14,44.0,53.333333333333336,<,-9.333333333333336,36,50,<,-14,50,56,<,-6,96,259,<,-163
101,16,18.666666666666668,14.0,>,4.666666666666668,0,0,=,0,56,42,>,14,53.333333333333336,44.0,>,9.333333333333336,50,36,>,14,56,50,>,6,259,96,>,163
0,16,14.0,17.666666666666668,<,-3.666666666666668,0,0,=,0,42,53,<,-11,44.0,58.0,<,-14.0,36,56,<,-20,50,59,<,-9,96,242,<,-146
121,16,17.666666666666668,14.0,>,3.666666666666668,0,0,=,0,53,42,>,11,58.0,44.0,>,14.0,56,36,>,20,59,50,>,9,242,96,>,146
0,16,14.0,29.0,<,-15.0,0,0,=,0,42,87,<,-45,44.0,47.333333333333336,<,-3.3333333333333357,36,31,>,5,50,60,<,-10,96,225,<,-129
0,16,29.0,14.0,>,15.0,0,0,=,0,87,42,>,45,47.333333333333336,44.0,>,3.3333333333333357,31,36,<,-5,60,50,>,10,225,96,>,129
0,16,14.0,13.0,>,1.0,0,0,=,0,42,39,>,3,44.0,37.333333333333336,>,6.666666666666664,36,31,>,5,50,48,>,2,96,105,<,-9
0,16,13.0,14.0,<,-1.0,0,0,=,0,39,42,<,-3,37.333333333333336,44.0,<,-6.666666666666664,31,36,<,-5,48,50,<,-2,105,96,>,9
0,16,14.0,3.6666666666666665,>,10.333333333333334,0,0,=,0,42,11,>,31,44.0,49.333333333333336,<,-5.333333333333336,36,40,<,-4,50,54,<,-4,96,273,<,-177
58,16,3.6666666666666665,14.0,<,-10.333333333333334,0,0,=,0,11,42,<,-31,49.333333333333336,44.0,>,5.333333333333336,40,36,>,4,54,50,>,4,273,96,>,177
0,16,14.0,22.333333333333332,<,-8.333333333333332,0,0,=,0,42,67,<,-25,44.0,43.666666666666664,>,0.3333333333333357,36,39,<,-3,50,46,>,4,96,200,<,-104
110,16,22.333333333333332,14.0,>,8.333333333333332,0,0,=,0,67,42,>,25,43.666666666666664,44.0,<,-0.3333333333333357,39,36,>,3,46,50,<,-4,200,96,>,104
0,16,14.0,12.0,>,2.0,0,0,=,0,42,36,>,6,44.0,43.666666666666664,>,0.3333333333333357,36,31,>,5,50,56,<,-6,96,256,<,-160
79,16,12.0,14.0,<,-2.0,0,0,=,0,36,42,<,-6,43.666666666666664,44.0,<,-0.3333333333333357,31,36,<,-5,56,50,>,6,256,96,>,160
0,15,42.666666666666664,37.0,>,5.666666666666664,0,0,=,0,87,72,>,15,47.333333333333336,37.333333333333336,>,10.0,31,31,=,0,60,48,>,12,225,105,>,120
0,15,37.0,42.666666666666664,<,-5.666666666666664,0,0,=,0,72,87,<,-15,37.333333333333336,47.333333333333336,<,-10.0,31,31,=,0,48,60,<,-12,105,225,<,-120
0,15,42.666666666666664,14.333333333333334,>,28.33333333333333,0,0,=,0,87,23,>,64,47.333333333333336,47.666666666666664,<,-0.3333333333333286,31,42,<,-11,60,57,>,3,225,196,>,29
8,15,14.333333333333334,42.666666666666664,<,-28.33333333333333,0,0,=,0,23,87,<,-64,47.666666666666664,47.333333333333336,>,0.3333333333333286,42,31,>,11,57,60,<,-3,196,225,<,-29
0,15,42.666666666666664,31.666666666666668,>,10.999999999999996,0,0,=,0,87,57,>,30,47.333333333333336,42.666666666666664,>,4.666666666666671,31,37,<,-6,60,50,>,10,225,192,>,33
105,15,31.666666666666668,42.666666666666664,<,-10.999999999999996,0,0,=,0,57,87,<,-30,42.666666666666664,47.333333333333336,<,-4.666666666666671,37,31,>,6,50,60,<,-10,192,225,<,-33
0,15,42.666666666666664,21.666666666666668,>,20.999999999999996,0,0,=,0,87,43,>,44,47.333333333333336,38.666666666666664,>,8.666666666666671,31,33,<,-2,60,43,>,17,225,152,>,73
29,15,21.666666666666668,42.666666666666664,<,-20.999999999999996,0,0,=,0,43,87,<,-44,38.666666666666664,47.333333333333336,<,-8.666666666666671,33,31,>,2,43,60,<,-17,152,225,<,-73
0,15,42.666666666666664,27.333333333333332,>,15.333333333333332,0,0,=,0,87,41,>,46,47.333333333333336,40.666666666666664,>,6.666666666666671,31,32,<,-1,60,57,>,3,225,148,>,77
49,15,27.333333333333332,42.666666666666664,<,-15.333333333333332,0,0,=,0,41,87,<,-46,40.666666666666664,47.333333333333336,<,-6.666666666666671,32,31,>,1,57,60,<,-3,148,225,<,-77
0,15,42.666666666666664,43.333333333333336,<,-0.6666666666666714,0,0,=,0,87,81,>,6,47.333333333333336,45.666666666666664,>,1.6666666666666714,31,39,<,-8,60,54,>,6,225,198,>,27
92,15,43.333333333333336,42.666666666666664,>,0.6666666666666714,0,0,=,0,81,87,<,-6,45.666666666666664,47.333333333333336,<,-1.6666666666666714,39,31,>,8,54,60,<,-6,198,225,<,-27
0,15,42.666666666666664,19.0,>,23.666666666666664,0,0,=,0,87,46,>,41,47.333333333333336,49.333333333333336,<,-2.0,31,40,<,-9,60,54,>,6,225,273,<,-48
90,15,19.0,42.666666666666664,<,-23.666666666666664,0,0,=,0,46,87,<,-41,49.333333333333336,47.333333333333336,>,2.0,40,31,>,9,54,60,<,-6,273,225,>,48
0,15,42.666666666666664,24.333333333333332,>,18.333333333333332,0,0,=,0,87,58,>,29,47.333333333333336,50.0,<,-2.6666666666666643,31,44,<,-13,60,56,>,4,225,118,>,107
0,15,24.333333333333332,42.666666666666664,<,-18.333333333333332,0,0,=,0,58,87,<,-29,50.0,47.333333333333336,>,2.6666666666666643,44,31,>,13,56,60,<,-4,118,225,<,-107
0,15,42.666666666666664,25.666666666666668,>,16.999999999999996,0,0,=,0,87,41,>,46,47.333333333333336,43.666666666666664,>,3.6666666666666714,31,31,=,0,60,56,>,4,225,256,<,-31
165,15,25.666666666666668,42.666666666666664,<,-16.999999999999996,0,0,=,0,41,87,<,-46,43.666666666666664,47.333333333333336,<,-3.6666666666666714,31,31,=,0,56,60,<,-4,256,225,>,31
0,15,42.666666666666664,31.0,>,11.666666666666664,0,0,=,0,87,55,>,32,47.333333333333336,41.666666666666664,>,5.666666666666671,31,35,<,-4,60,49,>,11,225,218,>,7
89,15,31.0,42.666666666666664,<,-11.666666666666664,0,0,=,0,55,87,<,-32,41.666666666666664,47.333333333333336,<,-5.666666666666671,35,31,>,4,49,60,<,-11,218,225,<,-7
0,15,42.666666666666664,31.333333333333332,>,11.333333333333332,0,0,=,0,87,51,>,36,47.333333333333336,36.0,>,11.333333333333336,31,31,=,0,60,39,>,21,225,234,<,-9
90,15,31.333333333333332,42.666666666666664,<,-11.333333333333332,0,0,=,0,51,87,<,-36,36.0,47.333333333333336,<,-11.333333333333336,31,31,=,0,39,60,<,-21,234,225,>,9
0,15,42.666666666666664,34.0,>,8.666666666666664,0,0,=,0,87,56,>,31,47.333333333333336,53.333333333333336,<,-6.0,31,50,<,-19,60,56,>,4,225,259,<,-34
149,15,34.0,42.666666666666664,<,-8.666666666666664,0,0,=,0,56,87,<,-31,53.333333333333336,47.333333333333336,>,6.0,50,31,>,19,56,60,<,-4,259,225,>,34
0,15,42.666666666666664,34.0,>,8.666666666666664,0,0,=,0,87,67,>,20,47.333333333333336,43.666666666666664,>,3.6666666666666714,31,39,<,-8,60,46,>,14,225,200,>,25
89,15,34.0,42.666666666666664,<,-8.666666666666664,0,0,=,0,67,87,<,-20,43.666666666666664,47.333333333333336,<,-3.6666666666666714,39,31,>,8,46,60,<,-14,200,225,<,-25
0,15,42.666666666666664,28.333333333333332,>,14.333333333333332,0,0,=,0,87,53,>,34,47.333333333333336,58.0,<,-10.666666666666664,31,56,<,-25,60,59,>,1,225,242,<,-17
108,15,28.333333333333332,42.666666666666664,<,-14.333333333333332,0,0,=,0,53,87,<,-34,58.0,47.333333333333336,>,10.666666666666664,56,31,>,25,59,60,<,-1,242,225,>,17
0,14,31.333333333333332,54.0,<,-22.666666666666668,15,39,<,-24,58,72,<,-14,50.0,37.333333333333336,>,12.666666666666664,44,31,>,13,56,48,>,8,118,105,>,13
0,14,54.0,31.333333333333332,>,22.666666666666668,39,15,>,24,72,58,>,14,37.333333333333336,50.0,<,-12.666666666666664,31,44,<,-13,48,56,<,-8,105,118,<,-13
0,14,31.333333333333332,18.666666666666668,>,12.666666666666664,15,13,>,2,58,23,>,35,50.0,47.666666666666664,>,2.3333333333333357,44,42,>,2,56,57,<,-1,118,196,<,-78
0,14,18.666666666666668,31.333333333333332,<,-12.666666666666664,13,15,<,-2,23,58,<,-35,47.666666666666664,50.0,<,-2.3333333333333357,42,44,<,-2,57,56,>,1,196,118,>,78
0,14,31.333333333333332,46.333333333333336,<,-15.000000000000004,15,22,<,-7,58,74,<,-16,50.0,38.666666666666664,>,11.333333333333336,44,33,>,11,56,43,>,13,118,152,<,-34
174,14,46.333333333333336,31.333333333333332,>,15.000000000000004,22,15,>,7,74,58,>,16,38.666666666666664,50.0,<,-11.333333333333336,33,44,<,-11,43,56,<,-13,152,118,>,34
0,14,31.333333333333332,49.0,<,-17.666666666666668,15,41,<,-26,58,65,<,-7,50.0,40.666666666666664,>,9.333333333333336,44,32,>,12,56,57,<,-1,118,148,<,-30
122,14,49.0,31.333333333333332,>,17.666666666666668,41,15,>,26,65,58,>,7,40.666666666666664,50.0,<,-9.333333333333336,32,44,<,-12,57,56,>,1,148,118,>,30
0,14,31.333333333333332,45.0,<,-13.666666666666668,15,33,<,-18,58,67,<,-9,50.0,43.666666666666664,>,6.333333333333336,44,39,>,5,56,46,>,10,118,200,<,-82
149,14,45.0,31.333333333333332,>,13.666666666666668,33,15,>,18,67,58,>,9,43.666666666666664,50.0,<,-6.333333333333336,39,44,<,-5,46,56,<,-10,200,118,>,82
0,14,31.333333333333332,35.0,<,-3.666666666666668,15,12,>,3,58,55,>,3,50.0,41.666666666666664,>,8.333333333333336,44,35,>,9,56,49,>,7,118,218,<,-100
86,14,35.0,31.333333333333332,>,3.666666666666668,12,15,<,-3,55,58,<,-3,41.666666666666664,50.0,<,-8.333333333333336,35,44,<,-9,49,56,<,-7,218,118,>,100
0,14,31.333333333333332,33.333333333333336,<,-2.0000000000000036,15,11,>,4,58,46,>,12,50.0,49.333333333333336,>,0.6666666666666643,44,40,>,4,56,54,>,2,118,273,<,-155
90,14,33.333333333333336,31.333333333333332,>,2.0000000000000036,11,15,<,-4,46,58,<,-12,49.333333333333336,50.0,<,-0.6666666666666643,40,44,<,-4,54,56,<,-2,273,118,>,155
0,14,31.333333333333332,39.666666666666664,<,-8.333333333333332,15,25,<,-10,58,51,>,7,50.0,36.0,>,14.0,44,31,>,13,56,39,>,17,118,234,<,-116
134,14,39.666666666666664,31.333333333333332,>,8.333333333333332,25,15,>,10,51,58,<,-7,36.0,50.0,<,-14.0,31,44,<,-13,39,56,<,-17,234,118,>,116
0,14,31.333333333333332,65.0,<,-33.66666666666667,15,49,<,-34,58,81,<,-23,50.0,45.666666666666664,>,4.333333333333336,44,39,>,5,56,54,>,2,118,198,<,-80
206,14,65.0,31.333333333333332,>,33.66666666666667,49,15,>,34,81,58,>,23,45.666666666666664,50.0,<,-4.333333333333336,39,44,<,-5,54,56,<,-2,198,118,>,80
0,14,31.333333333333332,61.666666666666664,<,-30.333333333333332,15,38,<,-23,58,90,<,-32,50.0,42.666666666666664,>,7.333333333333336,44,37,>,7,56,50,>,6,118,192,<,-74
135,14,61.666666666666664,31.333333333333332,>,30.333333333333332,38,15,>,23,90,58,>,32,42.666666666666664,50.0,<,-7.333333333333336,37,44,<,-7,50,56,<,-6,192,118,>,74
0,14,31.333333333333332,40.333333333333336,<,-9.000000000000004,15,32,<,-17,58,53,>,5,50.0,58.0,<,-8.0,44,56,<,-12,56,59,<,-3,118,242,<,-124
193,14,40.333333333333336,31.333333333333332,>,9.000000000000004,32,15,>,17,53,58,<,-5,58.0,50.0,>,8.0,56,44,>,12,59,56,>,3,242,118,>,124
0,14,31.333333333333332,43.0,<,-11.666666666666668,15,27,<,-12,58,56,>,2,50.0,53.333333333333336,<,-3.3333333333333357,44,50,<,-6,56,56,=,0,118,259,<,-141
188,14,43.0,31.333333333333332,>,11.666666666666668,27,15,>,12,56,58,<,-2,53.333333333333336,50.0,>,3.3333333333333357,50,44,>,6,56,56,=,0,259,118,>,141
0,14,31.333333333333332,50.666666666666664,<,-19.333333333333332,15,36,<,-21,58,75,<,-17,50.0,43.666666666666664,>,6.333333333333336,44,31,>,13,56,56,=,0,118,256,<,-138
175,14,50.666666666666664,31.333333333333332,>,19.333333333333332,36,15,>,21,75,58,>,17,43.666666666666664,50.0,<,-6.333333333333336,31,44,<,-13,56,56,=,0,256,118,>,138
0,13,20.333333333333332,53.333333333333336,<,-33.0,13,39,<,-26,28,70,<,-42,47.666666666666664,37.333333333333336,>,10.333333333333329,42,31,>,11,57,48,>,9,196,105,>,91
0,13,53.333333333333336,20.333333333333332,>,33.0,39,13,>,26,70,28,>,42,37.333333333333336,47.666666666666664,<,-10.333333333333329,31,42,<,-11,48,57,<,-9,105,196,<,-91
0,13,20.333333333333332,27.0,<,-6.666666666666668,13,12,>,1,28,38,<,-10,47.666666666666664,41.666666666666664,>,6.0,42,35,>,7,57,49,>,8,196,218,<,-22
31,13,27.0,20.333333333333332,>,6.666666666666668,12,13,<,-1,38,28,>,10,41.666666666666664,47.666666666666664,<,-6.0,35,42,<,-7,49,57,<,-8,218,196,>,22
0,13,20.333333333333332,42.666666666666664,<,-22.333333333333332,13,11,>,2,28,74,<,-46,47.666666666666664,49.333333333333336,<,-1.6666666666666714,42,40,>,2,57,54,>,3,196,273,<,-77
90,13,42.666666666666664,20.333333333333332,>,22.333333333333332,11,13,<,-2,74,28,>,46,49.333333333333336,47.666666666666664,>,1.6666666666666714,40,42,<,-2,54,57,<,-3,273,196,>,77
0,13,20.333333333333332,60.0,<,-39.66666666666667,13,41,<,-28,28,74,<,-46,47.666666666666664,40.666666666666664,>,7.0,42,32,>,10,57,57,=,0,196,148,>,48
200,13,60.0,20.333333333333332,>,39.66666666666667,41,13,>,28,74,28,>,46,40.666666666666664,47.666666666666664,<,-7.0,32,42,<,-10,57,57,=,0,148,196,<,-48
0,13,20.333333333333332,53.0,<,-32.66666666666667,13,25,<,-12,28,83,<,-55,47.666666666666664,36.0,>,11.666666666666664,42,31,>,11,57,39,>,18,196,234,<,-38
162,13,53.0,20.333333333333332,>,32.66666666666667,25,13,>,12,83,28,>,55,36.0,47.666666666666664,<,-11.666666666666664,31,42,<,-11,39,57,<,-18,234,196,>,38
0,13,20.333333333333332,59.666666666666664,<,-39.33333333333333,13,38,<,-25,28,90,<,-62,47.666666666666664,42.666666666666664,>,5.0,42,37,>,5,57,50,>,7,196,192,>,4
97,13,59.666666666666664,20.333333333333332,>,39.33333333333333,38,13,>,25,90,28,>,62,42.666666666666664,47.666666666666664,<,-5.0,37,42,<,-5,50,57,<,-7,192,196,<,-4
0,13,20.333333333333332,49.0,<,-28.666666666666668,13,33,<,-20,28,67,<,-39,47.666666666666664,43.666666666666664,>,4.0,42,39,>,3,57,46,>,11,196,200,<,-4
149,13,49.0,20.333333333333332,>,28.666666666666668,33,13,>,20,67,28,>,39,43.666666666666664,47.666666666666664,<,-4.0,39,42,<,-3,46,57,<,-11,200,196,>,4
0,13,20.333333333333332,39.0,<,-18.666666666666668,13,21,<,-8,28,74,<,-46,47.666666666666664,38.666666666666664,>,9.0,42,33,>,9,57,43,>,14,196,152,>,44
86,13,39.0,20.333333333333332,>,18.666666666666668,21,13,>,8,74,28,>,46,38.666666666666664,47.666666666666664,<,-9.0,33,42,<,-9,43,57,<,-14,152,196,<,-44
0,13,20.333333333333332,49.666666666666664,<,-29.333333333333332,13,36,<,-23,28,75,<,-47,47.666666666666664,43.666666666666664,>,4.0,42,31,>,11,57,56,>,1,196,256,<,-60
97,13,49.666666666666664,20.333333333333332,>,29.333333333333332,36,13,>,23,75,28,>,47,43.666666666666664,47.666666666666664,<,-4.0,31,42,<,-11,56,57,<,-1,256,196,>,60
0,13,20.333333333333332,48.333333333333336,<,-28.000000000000004,13,27,<,-14,28,62,<,-34,47.666666666666664,53.333333333333336,<,-5.666666666666671,42,50,<,-8,57,56,>,1,196,259,<,-63
153,13,48.333333333333336,20.333333333333332,>,28.000000000000004,27,13,>,14,62,28,>,34,53.333333333333336,47.666666666666664,>,5.666666666666671,50,42,>,8,56,57,<,-1,259,196,>,63
0,13,20.333333333333332,39.0,<,-18.666666666666668,13,28,<,-15,28,53,<,-25,47.666666666666664,58.0,<,-10.333333333333336,42,56,<,-14,57,59,<,-2,196,242,<,-46
84,13,39.0,20.333333333333332,>,18.666666666666668,28,13,>,15,53,28,>,25,58.0,47.666666666666664,>,10.333333333333336,56,42,>,14,59,57,>,2,242,196,>,46
0,13,20.333333333333332,46.333333333333336,<,-26.000000000000004,13,25,<,-12,28,65,<,-37,47.666666666666664,45.666666666666664,>,2.0,42,39,>,3,57,54,>,3,196,198,<,-2
0,13,46.333333333333336,20.333333333333332,>,26.000000000000004,25,13,>,12,65,28,>,37,45.666666666666664,47.666666666666664,<,-2.0,39,42,<,-3,54,57,<,-3,198,196,>,2
0,12,35.666666666666664,60.333333333333336,<,-24.66666666666667,25,39,<,-14,49,72,<,-23,45.666666666666664,37.333333333333336,>,8.333333333333329,39,31,>,8,54,48,>,6,198,105,>,93
0,12,60.333333333333336,35.666666666666664,>,24.66666666666667,39,25,>,14,72,49,>,23,37.333333333333336,45.666666666666664,<,-8.333333333333329,31,39,<,-8,48,54,<,-6,105,198,<,-93
0,12,35.666666666666664,34.0,>,1.6666666666666643,25,31,<,-6,49,38,>,11,45.666666666666664,41.666666666666664,>,4.0,39,35,>,4,54,49,>,5,198,218,<,-20
31,12,34.0,35.666666666666664,<,-1.6666666666666643,31,25,>,6,38,49,<,-11,41.666666666666664,45.666666666666664,<,-4.0,35,39,<,-4,49,54,<,-5,218,198,>,20
0,12,35.666666666666664,45.333333333333336,<,-9.666666666666671,25,28,<,-3,49,55,<,-6,45.666666666666664,58.0,<,-12.333333333333336,39,56,<,-17,54,59,<,-5,198,242,<,-44
84,12,45.333333333333336,35.666666666666664,>,9.666666666666671,28,25,>,3,55,49,>,6,58.0,45.666666666666664,>,12.333333333333336,56,39,>,17,59,54,>,5,242,198,>,44
0,12,35.666666666666664,17.666666666666668,>,17.999999999999996,25,10,>,15,49,22,>,27,45.666666666666664,38.666666666666664,>,7.0,39,33,>,6,54,43,>,11,198,152,>,46
0,12,17.666666666666668,35.666666666666664,<,-17.999999999999996,10,25,<,-15,22,49,<,-27,38.666666666666664,45.666666666666664,<,-7.0,33,39,<,-6,43,54,<,-11,152,198,<,-46
0,12,35.666666666666664,32.333333333333336,>,3.3333333333333286,25,11,>,14,49,74,<,-25,45.666666666666664,49.333333333333336,<,-3.6666666666666714,39,40,<,-1,54,54,=,0,198,273,<,-75
90,12,32.333333333333336,35.666666666666664,<,-3.3333333333333286,11,25,<,-14,74,49,>,25,49.333333333333336,45.666666666666664,>,3.6666666666666714,40,39,>,1,54,54,=,0,273,198,>,75
0,12,35.666666666666664,43.0,<,-7.333333333333336,25,38,<,-13,49,51,<,-2,45.666666666666664,42.666666666666664,>,3.0,39,37,>,2,54,50,>,4,198,192,>,6
97,12,43.0,35.666666666666664,>,7.333333333333336,38,25,>,13,51,49,>,2,42.666666666666664,45.666666666666664,<,-3.0,37,39,<,-2,50,54,<,-4,192,198,<,-6
0,12,35.666666666666664,40.666666666666664,<,-5.0,25,36,<,-11,49,48,>,1,45.666666666666664,43.666666666666664,>,2.0,39,31,>,8,54,56,<,-2,198,256,<,-58
97,12,40.666666666666664,35.666666666666664,>,5.0,36,25,>,11,48,49,<,-1,43.666666666666664,45.666666666666664,<,-2.0,31,39,<,-8,56,54,>,2,256,198,>,58
0,12,35.666666666666664,41.666666666666664,<,-6.0,25,11,>,14,49,67,<,-18,45.666666666666664,43.666666666666664,>,2.0,39,39,=,0,54,46,>,8,198,200,<,-2
117,12,41.666666666666664,35.666666666666664,>,6.0,11,25,<,-14,67,49,>,18,43.666666666666664,45.666666666666664,<,-2.0,39,39,=,0,46,54,<,-8,200,198,>,2
0,12,35.666666666666664,51.0,<,-15.333333333333336,25,35,<,-10,49,62,<,-13,45.666666666666664,53.333333333333336,<,-7.666666666666671,39,50,<,-11,54,56,<,-2,198,259,<,-61
153,12,51.0,35.666666666666664,>,15.333333333333336,35,25,>,10,62,49,>,13,53.333333333333336,45.666666666666664,>,7.666666666666671,50,39,>,11,56,54,>,2,259,198,>,61
0,12,35.666666666666664,60.333333333333336,<,-24.66666666666667,25,47,<,-22,49,83,<,-34,45.666666666666664,36.0,>,9.666666666666664,39,31,>,8,54,39,>,15,198,234,<,-36
171,12,60.333333333333336,35.666666666666664,>,24.66666666666667,47,25,>,22,83,49,>,34,36.0,45.666666666666664,<,-9.666666666666664,31,39,<,-8,39,54,<,-15,234,198,>,36
0,12,35.666666666666664,51.666666666666664,<,-16.0,25,40,<,-15,49,74,<,-25,45.666666666666664,40.666666666666664,>,5.0,39,32,>,7,54,57,<,-3,198,148,>,50
124,12,51.666666666666664,35.666666666666664,>,16.0,40,25,>,15,74,49,>,25,40.666666666666664,45.666666666666664,<,-5.0,32,39,<,-7,57,54,>,3,148,198,<,-50
0,11,24.666666666666668,47.333333333333336,<,-22.666666666666668,10,31,<,-21,42,72,<,-30,38.666666666666664,37.333333333333336,>,1.3333333333333286,33,31,>,2,43,48,<,-5,152,105,>,47
0,11,47.333333333333336,24.666666666666668,>,22.666666666666668,31,10,>,21,72,42,>,30,37.333333333333336,38.666666666666664,<,-1.3333333333333286,31,33,<,-2,48,43,>,5,105,152,<,-47
0,11,24.666666666666668,42.666666666666664,<,-17.999999999999996,10,33,<,-23,42,57,<,-15,38.666666666666664,41.666666666666664,<,-3.0,33,35,<,-2,43,49,<,-6,152,218,<,-66
75,11,42.666666666666664,24.666666666666668,>,17.999999999999996,33,10,>,23,57,42,>,15,41.666666666666664,38.666666666666664,>,3.0,35,33,>,2,49,43,>,6,218,152,>,66
0,11,24.666666666666668,42.0,<,-17.333333333333332,10,18,<,-8,42,55,<,-13,38.666666666666664,58.0,<,-19.333333333333336,33,56,<,-23,43,59,<,-16,152,242,<,-90
0,11,42.0,24.666666666666668,>,17.333333333333332,18,10,>,8,55,42,>,13,58.0,38.666666666666664,>,19.333333333333336,56,33,>,23,59,43,>,16,242,152,>,90
0,11,24.666666666666668,18.0,>,6.666666666666668,10,11,<,-1,42,31,>,11,38.666666666666664,49.333333333333336,<,-10.666666666666671,33,40,<,-7,43,54,<,-11,152,273,<,-121
58,11,18.0,24.666666666666668,<,-6.666666666666668,11,10,>,1,31,42,<,-11,49.333333333333336,38.666666666666664,>,10.666666666666671,40,33,>,7,54,43,>,11,273,152,>,121
0,11,24.666666666666668,54.0,<,-29.333333333333332,10,38,<,-28,42,84,<,-42,38.666666666666664,42.666666666666664,<,-4.0,33,37,<,-4,43,50,<,-7,152,192,<,-40
135,11,54.0,24.666666666666668,>,29.333333333333332,38,10,>,28,84,42,>,42,42.666666666666664,38.666666666666664,>,4.0,37,33,>,4,50,43,>,7,192,152,>,40
0,11,24.666666666666668,33.0,<,-8.333333333333332,10,15,<,-5,42,48,<,-6,38.666666666666664,43.666666666666664,<,-5.0,33,31,>,2,43,56,<,-13,152,256,<,-104
2,11,33.0,24.666666666666668,>,8.333333333333332,15,10,>,5,48,42,>,6,43.666666666666664,38.666666666666664,>,5.0,31,33,<,-2,56,43,>,13,256,152,>,104
0,11,24.666666666666668,42.666666666666664,<,-17.999999999999996,10,11,<,-1,42,67,<,-25,38.666666666666664,43.666666666666664,<,-5.0,33,39,<,-6,43,46,<,-3,152,200,<,-48
117,11,42.666666666666664,24.666666666666668,>,17.999999999999996,11,10,>,1,67,42,>,25,43.666666666666664,38.666666666666664,>,5.0,39,33,>,6,46,43,>,3,200,152,>,48
0,11,24.666666666666668,47.666666666666664,<,-22.999999999999996,10,40,<,-30,42,62,<,-20,38.666666666666664,40.666666666666664,<,-2.0,33,32,>,1,43,57,<,-14,152,148,>,4
155,11,47.666666666666664,24.666666666666668,>,22.999999999999996,40,10,>,30,62,42,>,20,40.666666666666664,38.666666666666664,>,2.0,32,33,<,-1,57,43,>,14,148,152,<,-4
0,11,24.666666666666668,55.666666666666664,<,-30.999999999999996,10,35,<,-25,42,76,<,-34,38.666666666666664,53.333333333333336,<,-14.666666666666671,33,50,<,-17,43,56,<,-13,152,259,<,-107
107,11,55.666666666666664,24.666666666666668,>,30.999999999999996,35,10,>,25,76,42,>,34,53.333333333333336,38.666666666666664,>,14.666666666666671,50,33,>,17,56,43,>,13,259,152,>,107
0,11,24.666666666666668,56.333333333333336,<,-31.666666666666668,10,47,<,-37,42,71,<,-29,38.666666666666664,36.0,>,2.6666666666666643,33,31,>,2,43,39,>,4,152,234,<,-82
104,11,56.333333333333336,24.666666666666668,>,31.666666666666668,47,10,>,37,71,42,>,29,36.0,38.666666666666664,<,-2.6666666666666643,31,33,<,-2,39,43,<,-4,234,152,>,82
0,10,37.666666666666664,39.0,<,-1.3333333333333357,18,31,<,-13,53,47,>,6,58.0,37.333333333333336,>,20.666666666666664,56,31,>,25,59,48,>,11,242,105,>,137
0,10,39.0,37.666666666666664,>,1.3333333333333357,31,18,>,13,47,53,<,-6,37.333333333333336,58.0,<,-20.666666666666664,31,56,<,-25,48,59,<,-11,105,242,<,-137
0,10,37.666666666666664,33.333333333333336,>,4.333333333333329,18,15,>,3,53,49,>,4,58.0,43.666666666666664,>,14.333333333333336,56,31,>,25,59,56,>,3,242,256,<,-14
2,10,33.333333333333336,37.666666666666664,<,-4.333333333333329,15,18,<,-3,49,53,<,-4,43.666666666666664,58.0,<,-14.333333333333336,31,56,<,-25,56,59,<,-3,256,242,>,14
0,10,37.666666666666664,39.0,<,-1.3333333333333357,18,11,>,7,53,75,<,-22,58.0,49.333333333333336,>,8.666666666666664,56,40,>,16,59,54,>,5,242,273,<,-31
58,10,39.0,37.666666666666664,>,1.3333333333333357,11,18,<,-7,75,53,>,22,49.333333333333336,58.0,<,-8.666666666666664,40,56,<,-16,54,59,<,-5,273,242,>,31
0,10,37.666666666666664,52.0,<,-14.333333333333336,18,38,<,-20,53,61,<,-8,58.0,41.666666666666664,>,16.333333333333336,56,35,>,21,59,49,>,10,242,218,>,24
75,10,52.0,37.666666666666664,>,14.333333333333336,38,18,>,20,61,53,>,8,41.666666666666664,58.0,<,-16.333333333333336,35,56,<,-21,49,59,<,-10,218,242,<,-24
0,10,37.666666666666664,57.333333333333336,<,-19.66666666666667,18,50,<,-32,53,71,<,-18,58.0,36.0,>,22.0,56,31,>,25,59,39,>,20,242,234,>,8
104,10,57.333333333333336,37.666666666666664,>,19.66666666666667,50,18,>,32,71,53,>,18,36.0,58.0,<,-22.0,31,56,<,-25,39,59,<,-20,234,242,<,-8
0,10,37.666666666666664,56.333333333333336,<,-18.66666666666667,18,37,<,-19,53,76,<,-23,58.0,53.333333333333336,>,4.666666666666664,56,50,>,6,59,56,>,3,242,259,<,-17
107,10,56.333333333333336,37.666666666666664,>,18.66666666666667,37,18,>,19,76,53,>,23,53.333333333333336,58.0,<,-4.666666666666664,50,56,<,-6,56,59,<,-3,259,242,>,17
0,10,37.666666666666664,63.666666666666664,<,-26.0,18,50,<,-32,53,74,<,-21,58.0,43.666666666666664,>,14.333333333333336,56,39,>,17,59,46,>,13,242,200,>,42
203,10,63.666666666666664,37.666666666666664,>,26.0,50,18,>,32,74,53,>,21,43.666666666666664,58.0,<,-14.333333333333336,39,56,<,-17,46,59,<,-13,200,242,<,-42
0,10,37.666666666666664,49.333333333333336,<,-11.666666666666671,18,26,<,-8,53,84,<,-31,58.0,42.666666666666664,>,15.333333333333336,56,37,>,19,59,50,>,9,242,192,>,50
135,10,49.333333333333336,37.666666666666664,>,11.666666666666671,26,18,>,8,84,53,>,31,42.666666666666664,58.0,<,-15.333333333333336,37,56,<,-19,50,59,<,-9,192,242,<,-50
0,10,37.666666666666664,38.0,<,-0.3333333333333357,18,11,>,7,53,62,<,-9,58.0,40.666666666666664,>,17.333333333333336,56,32,>,24,59,57,>,2,242,148,>,94
0,10,38.0,37.666666666666664,>,0.3333333333333357,11,18,<,-7,62,53,>,9,40.666666666666664,58.0,<,-17.333333333333336,32,56,<,-24,57,59,<,-2,148,242,<,-94
0,9,37.333333333333336,49.0,<,-11.666666666666664,11,39,<,-28,60,61,<,-1,40.666666666666664,37.333333333333336,>,3.3333333333333286,32,31,>,1,57,48,>,9,148,105,>,43
0,9,49.0,37.333333333333336,>,11.666666666666664,39,11,>,28,61,60,>,1,37.333333333333336,40.666666666666664,<,-3.3333333333333286,31,32,<,-1,48,57,<,-9,105,148,<,-43
0,9,37.333333333333336,35.333333333333336,>,2.0,11,21,<,-10,60,49,>,11,40.666666666666664,43.666666666666664,<,-3.0,32,31,>,1,57,56,>,1,148,256,<,-108
0,9,35.333333333333336,37.333333333333336,<,-2.0,21,11,>,10,49,60,<,-11,43.666666666666664,40.666666666666664,>,3.0,31,32,<,-1,56,57,<,-1,256,148,>,108
0,9,37.333333333333336,49.0,<,-11.666666666666664,11,11,=,0,60,75,<,-15,40.666666666666664,49.333333333333336,<,-8.666666666666671,32,40,<,-8,57,54,>,3,148,273,<,-125
78,9,49.0,37.333333333333336,>,11.666666666666664,11,11,=,0,75,60,>,15,49.333333333333336,40.666666666666664,>,8.666666666666671,40,32,>,8,54,57,<,-3,273,148,>,125
0,9,37.333333333333336,60.0,<,-22.666666666666664,11,38,<,-27,60,81,<,-21,40.666666666666664,41.666666666666664,<,-1.0,32,35,<,-3,57,49,>,8,148,218,<,-70
60,9,60.0,37.333333333333336,>,22.666666666666664,38,11,>,27,81,60,>,21,41.666666666666664,40.666666666666664,>,1.0,35,32,>,3,49,57,<,-8,218,148,>,70
0,9,37.333333333333336,49.666666666666664,<,-12.333333333333329,11,48,<,-37,60,51,>,9,40.666666666666664,36.0,>,4.666666666666664,32,31,>,1,57,39,>,18,148,234,<,-86
110,9,49.666666666666664,37.333333333333336,>,12.333333333333329,48,11,>,37,51,60,<,-9,36.0,40.666666666666664,<,-4.666666666666664,31,32,<,-1,39,57,<,-18,234,148,>,86
0,9,37.333333333333336,41.0,<,-3.6666666666666643,11,30,<,-19,60,56,>,4,40.666666666666664,53.333333333333336,<,-12.666666666666671,32,50,<,-18,57,56,>,1,148,259,<,-111
50,9,41.0,37.333333333333336,>,3.6666666666666643,30,11,>,19,56,60,<,-4,53.333333333333336,40.666666666666664,>,12.666666666666671,50,32,>,18,56,57,<,-1,259,148,>,111
0,9,37.333333333333336,45.333333333333336,<,-8.0,11,26,<,-15,60,72,<,-12,40.666666666666664,42.666666666666664,<,-2.0,32,37,<,-5,57,50,>,7,148,192,<,-44
154,9,45.333333333333336,37.333333333333336,>,8.0,26,11,>,15,72,60,>,12,42.666666666666664,40.666666666666664,>,2.0,37,32,>,5,50,57,<,-7,192,148,>,44
0,9,37.333333333333336,53.333333333333336,<,-16.0,11,19,<,-8,60,74,<,-14,40.666666666666664,43.666666666666664,<,-3.0,32,39,<,-7,57,46,>,11,148,200,<,-52
159,9,53.333333333333336,37.333333333333336,>,16.0,19,11,>,8,74,60,>,14,43.666666666666664,40.666666666666664,>,3.0,39,32,>,7,46,57,<,-11,200,148,>,52
0,8,41.0,38.0,>,3.0,21,14,>,7,66,61,>,5,43.666666666666664,37.333333333333336,>,6.333333333333329,31,31,=,0,56,48,>,8,256,105,>,151
0,8,38.0,41.0,<,-3.0,14,21,<,-7,61,66,<,-5,37.333333333333336,43.666666666666664,<,-6.333333333333329,31,31,=,0,48,56,<,-8,105,256,<,-151
0,8,41.0,46.666666666666664,<,-5.666666666666664,21,30,<,-9,66,56,>,10,43.666666666666664,53.333333333333336,<,-9.666666666666671,31,50,<,-19,56,56,=,0,256,259,<,-3
50,8,46.666666666666664,41.0,>,5.666666666666664,30,21,>,9,56,66,<,-10,53.333333333333336,43.666666666666664,>,9.666666666666671,50,31,>,19,56,56,=,0,259,256,>,3
0,8,41.0,57.0,<,-16.0,21,38,<,-17,66,81,<,-15,43.666666666666664,41.666666666666664,>,2.0,31,35,<,-4,56,49,>,7,256,218,>,38
60,8,57.0,41.0,>,16.0,38,21,>,17,81,66,>,15,41.666666666666664,43.666666666666664,<,-2.0,35,31,>,4,49,56,<,-7,218,256,<,-38
0,8,41.0,32.333333333333336,>,8.666666666666664,21,11,>,10,66,61,>,5,43.666666666666664,49.333333333333336,<,-5.666666666666671,31,40,<,-9,56,54,>,2,256,273,<,-17
78,8,32.333333333333336,41.0,<,-8.666666666666664,11,21,<,-10,61,66,<,-5,49.333333333333336,43.666666666666664,>,5.666666666666671,40,31,>,9,54,56,<,-2,273,256,>,17
0,8,41.0,58.333333333333336,<,-17.333333333333336,21,48,<,-27,66,76,<,-10,43.666666666666664,36.0,>,7.666666666666664,31,31,=,0,56,39,>,17,256,234,>,22
110,8,58.333333333333336,41.0,>,17.333333333333336,48,21,>,27,76,66,>,10,36.0,43.666666666666664,<,-7.666666666666664,31,31,=,0,39,56,<,-17,234,256,<,-22
0,8,41.0,56.666666666666664,<,-15.666666666666664,21,38,<,-17,66,72,<,-6,43.666666666666664,42.666666666666664,>,1.0,31,37,<,-6,56,50,>,6,256,192,>,64
154,8,56.666666666666664,41.0,>,15.666666666666664,38,21,>,17,72,66,>,6,42.666666666666664,43.666666666666664,<,-1.0,37,31,>,6,50,56,<,-6,192,256,<,-64
0,8,41.0,32.333333333333336,>,8.666666666666664,21,11,>,10,66,67,<,-1,43.666666666666664,43.666666666666664,=,0.0,31,39,<,-8,56,46,>,10,256,200,>,56
0,8,32.333333333333336,41.0,<,-8.666666666666664,11,21,<,-10,67,66,>,1,43.666666666666664,43.666666666666664,=,0.0,39,31,>,8,46,56,<,-10,200,256,<,-56
0,7,50.666666666666664,32.0,>,18.666666666666664,11,14,<,-3,74,43,>,31,43.666666666666664,37.333333333333336,>,6.333333333333329,39,31,>,8,46,48,<,-2,200,105,>,95
0,7,32.0,50.666666666666664,<,-18.666666666666664,14,11,>,3,43,74,<,-31,37.333333333333336,43.666666666666664,<,-6.333333333333329,31,39,<,-8,48,46,>,2,105,200,<,-95
0,7,50.666666666666664,58.666666666666664,<,-8.0,11,54,<,-43,74,66,>,8,43.666666666666664,53.333333333333336,<,-9.666666666666671,39,50,<,-11,46,56,<,-10,200,259,<,-59
65,7,58.666666666666664,50.666666666666664,>,8.0,54,11,>,43,66,74,<,-8,53.333333333333336,43.666666666666664,>,9.666666666666671,50,39,>,11,56,46,>,10,259,200,>,59
0,7,50.666666666666664,37.666666666666664,>,13.0,11,23,<,-12,74,52,>,22,43.666666666666664,41.666666666666664,>,2.0,39,35,>,4,46,49,<,-3,200,218,<,-18
0,7,37.666666666666664,50.666666666666664,<,-13.0,23,11,>,12,52,74,<,-22,41.666666666666664,43.666666666666664,<,-2.0,35,39,<,-4,49,46,>,3,218,200,>,18
0,7,50.666666666666664,37.333333333333336,>,13.333333333333329,11,11,=,0,74,76,<,-2,43.666666666666664,49.333333333333336,<,-5.666666666666671,39,40,<,-1,46,54,<,-8,200,273,<,-73
91,7,37.333333333333336,50.666666666666664,<,-13.333333333333329,11,11,=,0,76,74,>,2,49.333333333333336,43.666666666666664,>,5.666666666666671,40,39,>,1,54,46,>,8,273,200,>,73
0,7,50.666666666666664,61.666666666666664,<,-11.0,11,51,<,-40,74,76,<,-2,43.666666666666664,36.0,>,7.666666666666664,39,31,>,8,46,39,>,7,200,234,<,-34
120,7,61.666666666666664,50.666666666666664,>,11.0,51,11,>,40,76,74,>,2,36.0,43.666666666666664,<,-7.666666666666664,31,39,<,-8,39,46,<,-7,234,200,>,34
0,7,50.666666666666664,61.666666666666664,<,-11.0,11,38,<,-27,74,87,<,-13,43.666666666666664,42.666666666666664,>,1.0,39,37,>,2,46,50,<,-4,200,192,>,8
161,7,61.666666666666664,50.666666666666664,>,11.0,38,11,>,27,87,74,>,13,42.666666666666664,43.666666666666664,<,-1.0,37,39,<,-2,50,46,>,4,192,200,<,-8
0,6,30.333333333333332,53.666666666666664,<,-23.333333333333332,23,39,<,-16,38,79,<,-41,41.666666666666664,37.333333333333336,>,4.333333333333329,35,31,>,4,49,48,>,1,218,105,>,113
0,6,53.666666666666664,30.333333333333332,>,23.333333333333332,39,23,>,16,79,38,>,41,37.333333333333336,41.666666666666664,<,-4.333333333333329,31,35,<,-4,48,49,<,-1,105,218,<,-113
0,6,30.333333333333332,46.0,<,-15.666666666666668,23,16,>,7,38,66,<,-28,41.666666666666664,53.333333333333336,<,-11.666666666666671,35,50,<,-15,49,56,<,-7,218,259,<,-41
0,6,46.0,30.333333333333332,>,15.666666666666668,16,23,<,-7,66,38,>,28,53.333333333333336,41.666666666666664,>,11.666666666666671,50,35,>,15,56,49,>,7,259,218,>,41
0,6,30.333333333333332,48.666666666666664,<,-18.333333333333332,23,11,>,12,38,76,<,-38,41.666666666666664,49.333333333333336,<,-7.666666666666671,35,40,<,-5,49,54,<,-5,218,273,<,-55
71,6,48.666666666666664,30.333333333333332,>,18.333333333333332,11,23,<,-12,76,38,>,38,49.333333333333336,41.666666666666664,>,7.666666666666671,40,35,>,5,54,49,>,5,273,218,>,55
0,6,30.333333333333332,53.666666666666664,<,-23.333333333333332,23,51,<,-28,38,58,<,-20,41.666666666666664,36.0,>,5.666666666666664,35,31,>,4,49,39,>,10,218,234,<,-16
120,6,53.666666666666664,30.333333333333332,>,23.333333333333332,51,23,>,28,58,38,>,20,36.0,41.666666666666664,<,-5.666666666666664,31,35,<,-4,39,49,<,-10,234,218,>,16
0,6,30.333333333333332,61.0,<,-30.666666666666668,23,38,<,-15,38,87,<,-49,41.666666666666664,42.666666666666664,<,-1.0,35,37,<,-2,49,50,<,-1,218,192,>,26
161,6,61.0,30.333333333333332,>,30.666666666666668,38,23,>,15,87,38,>,49,42.666666666666664,41.666666666666664,>,1.0,37,35,>,2,50,49,>,1,192,218,<,-26
0,5,43.666666666666664,49.0,<,-5.333333333333336,16,29,<,-13,59,79,<,-20,53.333333333333336,37.333333333333336,>,16.0,50,31,>,19,56,48,>,8,259,105,>,154
0,5,49.0,43.666666666666664,>,5.333333333333336,29,16,>,13,79,59,>,20,37.333333333333336,53.333333333333336,<,-16.0,31,50,<,-19,48,56,<,-8,105,259,<,-154
0,5,43.666666666666664,53.333333333333336,<,-9.666666666666671,16,11,>,5,59,90,<,-31,53.333333333333336,49.333333333333336,>,4.0,50,40,>,10,56,54,>,2,259,273,<,-14
71,5,53.333333333333336,43.666666666666664,>,9.666666666666671,11,16,<,-5,90,59,>,31,49.333333333333336,53.333333333333336,<,-4.0,40,50,<,-10,54,56,<,-2,273,259,>,14
0,5,43.666666666666664,39.333333333333336,>,4.333333333333329,16,15,>,1,59,52,>,7,53.333333333333336,36.0,>,17.333333333333336,50,31,>,19,56,39,>,17,259,234,>,25
143,5,39.333333333333336,43.666666666666664,<,-4.333333333333329,15,16,<,-1,52,59,<,-7,36.0,53.333333333333336,<,-17.333333333333336,31,50,<,-19,39,56,<,-17,234,259,<,-25
0,5,43.666666666666664,38.333333333333336,>,5.333333333333329,16,19,<,-3,59,58,>,1,53.333333333333336,42.666666666666664,>,10.666666666666671,50,37,>,13,56,50,>,6,259,192,>,67
161,5,38.333333333333336,43.666666666666664,<,-5.333333333333329,19,16,>,3,58,59,<,-1,42.666666666666664,53.333333333333336,<,-10.666666666666671,37,50,<,-13,50,56,<,-6,192,259,<,-67
0,4,34.0,61.666666666666664,<,-27.666666666666664,29,11,>,18,39,90,<,-51,37.333333333333336,49.333333333333336,<,-12.0,31,40,<,-9,48,54,<,-6,105,273,<,-168
125,4,61.666666666666664,34.0,>,27.666666666666664,11,29,<,-18,90,39,>,51,49.333333333333336,37.333333333333336,>,12.0,40,31,>,9,54,48,>,6,273,105,>,168
0,4,34.0,45.333333333333336,<,-11.333333333333336,29,15,>,14,39,70,<,-31,37.333333333333336,36.0,>,1.3333333333333357,31,31,=,0,48,39,>,9,105,234,<,-129
149,4,45.333333333333336,34.0,>,11.333333333333336,15,29,<,-14,70,39,>,31,36.0,37.333333333333336,<,-1.3333333333333357,31,31,=,0,39,48,<,-9,234,105,>,129
0,4,34.0,28.0,>,6.0,29,19,>,10,39,38,>,1,37.333333333333336,42.666666666666664,<,-5.333333333333329,31,37,<,-6,48,50,<,-2,105,192,<,-87
161,4,28.0,34.0,<,-6.0,19,29,<,-10,38,39,<,-1,42.666666666666664,37.333333333333336,>,5.333333333333329,37,31,>,6,50,48,>,2,192,105,>,87
0,3,23.0,69.66666666666667,<,-46.66666666666667,19,35,<,-16,27,90,<,-63,42.666666666666664,49.333333333333336,<,-6.666666666666671,37,40,<,-3,50,54,<,-4,192,273,<,-81
132,3,69.66666666666667,23.0,>,46.66666666666667,35,19,>,16,90,27,>,63,49.333333333333336,42.666666666666664,>,6.666666666666671,40,37,>,3,54,50,>,4,273,192,>,81
0,3,23.0,53.666666666666664,<,-30.666666666666664,19,15,>,4,27,76,<,-49,42.666666666666664,36.0,>,6.666666666666664,37,31,>,6,50,39,>,11,192,234,<,-42
149,3,53.666666666666664,23.0,>,30.666666666666664,15,19,<,-4,76,27,>,49,36.0,42.666666666666664,<,-6.666666666666664,31,37,<,-6,39,50,<,-11,234,192,>,42
0,2,34.666666666666664,74.33333333333333,<,-39.666666666666664,15,49,<,-34,70,90,<,-20,36.0,49.333333333333336,<,-13.333333333333336,31,40,<,-9,39,54,<,-15,234,273,<,-39
87,2,74.33333333333333,34.666666666666664,>,39.666666666666664,49,15,>,34,90,70,>,20,49.333333333333336,36.0,>,13.333333333333336,40,31,>,9,54,39,>,15,273,234,>,39
0,13,0.0,0.0,=,0.0,0,0,=,0,0,0,=,0,54.666666666666664,44.333333333333336,>,10.333333333333329,50,32,>,18,60,52,>,8,174,201,<,-27
51,13,0.0,0.0,=,0.0,0,0,=,0,0,0,=,0,44.333333333333336,54.666666666666664,<,-10.333333333333329,32,50,<,-18,52,60,<,-8,201,174,>,27
0,13,0.0,0.0,=,0.0,0,0,=,0,0,0,=,0,54.666666666666664,36.333333333333336,>,18.33333333333333,50,30,>,20,60,45,>,15,174,131,>,43
56,13,0.0,0.0,=,0.0,0,0,=,0,0,0,=,0,36.333333333333336,54.666666666666664,<,-18.33333333333333,30,50,<,-20,45,60,<,-15,131,174,<,-43
0,13,0.0,0.0,=,0.0,0,0,=,0,0,0,=,0,54.666666666666664,50.0,>,4.666666666666664,50,45,>,5,60,56,>,4,174,167,>,7
49,13,0.0,0.0,=,0.0,0,0,=,0,0,0,=,0,50.0,54.666666666666664,<,-4.666666666666664,45,50,<,-5,56,60,<,-4,167,174,<,-7
0,13,0.0,0.0,=,0.0,0,0,=,0,0,0,=,0,54.666666666666664,53.666666666666664,>,1.0,50,50,=,0,60,56,>,4,174,125,>,49
0,13,0.0,0.0,=,0.0,0,0,=,0,0,0,=,0,53.666666666666664,54.666666666666664,<,-1.0,50,50,=,0,56,60,<,-4,125,174,<,-49
0,13,0.0,0.0,=,0.0,0,0,=,0,0,0,=,0,54.666666666666664,46.0,>,8.666666666666664,50,35,>,15,60,56,>,4,174,179,<,-5
18,13,0.0,0.0,=,0.0,0,0,=,0,0,0,=,0,46.0,54.666666666666664,<,-8.666666666666664,35,50,<,-15,56,60,<,-4,179,174,>,5
0,13,0.0,0.0,=,0.0,0,0,=,0,0,0,=,0,54.666666666666664,37.0,>,17.666666666666664,50,31,>,19,60,45,>,15,174,139,>,35
49,13,0.0,0.0,=,0.0,0,0,=,0,0,0,=,0,37.0,54.666666666666664,<,-17.666666666666664,31,50,<,-19,45,60,<,-15,139,174,<,-35
0,13,0.0,0.0,=,0.0,0,0,=,0,0,0,=,0,54.666666666666664,44.0,>,10.666666666666664,50,31,>,19,60,53,>,7,174,84,>,90
0,13,0.0,0.0,=,0.0,0,0,=,0,0,0,=,0,44.0,54.666666666666664,<,-10.666666666666664,31,50,<,-19,53,60,<,-7,84,174,<,-90
0,13,0.0,0.0,=,0.0,0,0,=,0,0,0,=,0,54.666666666666664,47.333333333333336,>,7.333333333333329,50,32,>,18,60,57,>,3,174,169,>,5
41,13,0.0,0.0,=,0.0,0,0,=,0,0,0,=,0,47.333333333333336,54.666666666666664,<,-7.333333333333329,32,50,<,-18,57,60,<,-3,169,174,<,-5
0,13,0.0,0.0,=,0.0,0,0,=,0,0,0,=,0,54.666666666666664,36.333333333333336,>,18.33333333333333,50,31,>,19,60,40,>,20,174,157,>,17
50,13,0.0,0.0,=,0.0,0,0,=,0,0,0,=,0,36.333333333333336,54.666666666666664,<,-18.33333333333333,31,50,<,-19,40,60,<,-20,157,174,<,-17
0,13,0.0,0.0,=,0.0,0,0,=,0,0,0,=,0,54.666666666666664,45.666666666666664,>,9.0,50,38,>,12,60,60,=,0,174,95,>,79
56,13,0.0,0.0,=,0.0,0,0,=,0,0,0,=,0,45.666666666666664,54.666666666666664,<,-9.0,38,50,<,-12,60,60,=,0,95,174,<,-79
0,13,0.0,0.0,=,0.0,0,0,=,0,0,0,=,0,54.666666666666664,52.666666666666664,>,2.0,50,51,<,-1,60,56,>,4,174,135,>,39
9,13,0.0,0.0,=,0.0,0,0,=,0,0,0,=,0,52.666666666666664,54.666666666666664,<,-2.0,51,50,>,1,56,60,<,-4,135,174,<,-39
0,13,0.0,0.0,=,0.0,0,0,=,0,0,0,=,0,54.666666666666664,35.333333333333336,>,19.33333333333333,50,32,>,18,60,41,>,19,174,197,<,-23
44,13,0.0,0.0,=,0.0,0,0,=,0,0,0,=,0,35.333333333333336,54.666666666666664,<,-19.33333333333333,32,50,<,-18,41,60,<,-19,197,174,>,23
0,12,7.333333333333333,17.666666666666668,<,-10.333333333333336,0,0,=,0,22,53,<,-31,53.666666666666664,44.0,>,9.666666666666664,50,31,>,19,56,53,>,3,125,84,>,41
0,12,17.666666666666668,7.333333333333333,>,10.333333333333336,0,0,=,0,53,22,>,31,44.0,53.666666666666664,<,-9.666666666666664,31,50,<,-19,53,56,<,-3,84,125,<,-41
0,12,7.333333333333333,4.666666666666667,>,2.666666666666666,0,0,=,0,22,14,>,8,53.666666666666664,52.666666666666664,>,1.0,50,51,<,-1,56,56,=,0,125,135,<,-10
0,12,4.666666666666667,7.333333333333333,<,-2.666666666666666,0,0,=,0,14,22,<,-8,52.666666666666664,53.666666666666664,<,-1.0,51,50,>,1,56,56,=,0,135,125,>,10
0,12,7.333333333333333,24.333333333333332,<,-17.0,0,0,=,0,22,73,<,-51,53.666666666666664,46.0,>,7.666666666666664,50,35,>,15,56,56,=,0,125,179,<,-54
72,12,24.333333333333332,7.333333333333333,>,17.0,0,0,=,0,73,22,>,51,46.0,53.666666666666664,<,-7.666666666666664,35,50,<,-15,56,56,=,0,179,125,>,54
0,12,7.333333333333333,15.333333333333334,<,-8.0,0,0,=,0,22,46,<,-24,53.666666666666664,47.333333333333336,>,6.333333333333329,50,32,>,18,56,57,<,-1,125,169,<,-44
87,12,15.333333333333334,7.333333333333333,>,8.0,0,0,=,0,46,22,>,24,47.333333333333336,53.666666666666664,<,-6.333333333333329,32,50,<,-18,57,56,>,1,169,125,>,44
0,12,7.333333333333333,24.666666666666668,<,-17.333333333333336,0,0,=,0,22,74,<,-52,53.666666666666664,35.333333333333336,>,18.33333333333333,50,32,>,18,56,41,>,15,125,197,<,-72
99,12,24.666666666666668,7.333333333333333,>,17.333333333333336,0,0,=,0,74,22,>,52,35.333333333333336,53.666666666666664,<,-18.33333333333333,32,50,<,-18,41,56,<,-15,197,125,>,72
0,12,7.333333333333333,23.0,<,-15.666666666666668,0,0,=,0,22,69,<,-47,53.666666666666664,50.0,>,3.6666666666666643,50,45,>,5,56,56,=,0,125,167,<,-42
102,12,23.0,7.333333333333333,>,15.666666666666668,0,0,=,0,69,22,>,47,50.0,53.666666666666664,<,-3.6666666666666643,45,50,<,-5,56,56,=,0,167,125,>,42
0,12,7.333333333333333,26.333333333333332,<,-19.0,0,0,=,0,22,79,<,-57,53.666666666666664,37.0,>,16.666666666666664,50,31,>,19,56,45,>,11,125,139,<,-14
74,12,26.333333333333332,7.333333333333333,>,19.0,0,0,=,0,79,22,>,57,37.0,53.666666666666664,<,-16.666666666666664,31,50,<,-19,45,56,<,-11,139,125,>,14
0,12,7.333333333333333,8.333333333333334,<,-1.0000000000000009,0,0,=,0,22,25,<,-3,53.666666666666664,36.333333333333336,>,17.33333333333333,50,31,>,19,56,40,>,16,125,157,<,-32
62,12,8.333333333333334,7.333333333333333,>,1.0000000000000009,0,0,=,0,25,22,>,3,36.333333333333336,53.666666666666664,<,-17.33333333333333,31,50,<,-19,40,56,<,-16,157,125,>,32
0,12,7.333333333333333,9.333333333333334,<,-2.000000000000001,0,0,=,0,22,28,<,-6,53.666666666666664,44.333333333333336,>,9.333333333333329,50,32,>,18,56,52,>,4,125,201,<,-76
122,12,9.333333333333334,7.333333333333333,>,2.000000000000001,0,0,=,0,28,22,>,6,44.333333333333336,53.666666666666664,<,-9.333333333333329,32,50,<,-18,52,56,<,-4,201,125,>,76
0,12,7.333333333333333,16.666666666666668,<,-9.333333333333336,0,0,=,0,22,50,<,-28,53.666666666666664,36.333333333333336,>,17.33333333333333,50,30,>,20,56,45,>,11,125,131,<,-6
100,12,16.666666666666668,7.333333333333333,>,9.333333333333336,0,0,=,0,50,22,>,28,36.333333333333336,53.666666666666664,<,-17.33333333333333,30,50,<,-20,45,56,<,-11,131,125,>,6
0,12,7.333333333333333,26.333333333333332,<,-19.0,0,0,=,0,22,79,<,-57,53.666666666666664,45.666666666666664,>,8.0,50,38,>,12,56,60,<,-4,125,95,>,30
100,12,26.333333333333332,7.333333333333333,>,19.0,0,0,=,0,79,22,>,57,45.666666666666664,53.666666666666664,<,-8.0,38,50,<,-12,60,56,>,4,95,125,<,-30
0,11,23.666666666666668,9.333333333333334,>,14.333333333333334,0,0,=,0,53,14,>,39,44.0,52.666666666666664,<,-8.666666666666664,31,51,<,-20,53,56,<,-3,84,135,<,-51
0,11,9.333333333333334,23.666666666666668,<,-14.333333333333334,0,0,=,0,14,53,<,-39,52.666666666666664,44.0,>,8.666666666666664,51,31,>,20,56,53,>,3,135,84,>,51
0,11,23.666666666666668,36.666666666666664,<,-12.999999999999996,0,0,=,0,53,85,<,-32,44.0,36.333333333333336,>,7.666666666666664,31,31,=,0,53,40,>,13,84,157,<,-73
113,11,36.666666666666664,23.666666666666668,>,12.999999999999996,0,0,=,0,85,53,>,32,36.333333333333336,44.0,<,-7.666666666666664,31,31,=,0,40,53,<,-13,157,84,>,73
0,11,23.666666666666668,34.0,<,-10.333333333333332,0,0,=,0,53,73,<,-20,44.0,46.0,<,-2.0,31,35,<,-4,53,56,<,-3,84,179,<,-95
122,11,34.0,23.666666666666668,>,10.333333333333332,0,0,=,0,73,53,>,20,46.0,44.0,>,2.0,35,31,>,4,56,53,>,3,179,84,>,95
0,11,23.666666666666668,34.666666666666664,<,-10.999999999999996,0,0,=,0,53,79,<,-26,44.0,37.0,>,7.0,31,31,=,0,53,45,>,8,84,139,<,-55
0,11,34.666666666666664,23.666666666666668,>,10.999999999999996,0,0,=,0,79,53,>,26,37.0,44.0,<,-7.0,31,31,=,0,45,53,<,-8,139,84,>,55
0,11,23.666666666666668,31.0,<,-7.333333333333332,0,0,=,0,53,47,>,6,44.0,47.333333333333336,<,-3.3333333333333357,31,32,<,-1,53,57,<,-4,84,169,<,-85
87,11,31.0,23.666666666666668,>,7.333333333333332,0,0,=,0,47,53,<,-6,47.333333333333336,44.0,>,3.3333333333333357,32,31,>,1,57,53,>,4,169,84,>,85
0,11,23.666666666666668,53.333333333333336,<,-29.666666666666668,0,0,=,0,53,86,<,-33,44.0,35.333333333333336,>,8.666666666666664,31,32,<,-1,53,41,>,12,84,197,<,-113
194,11,53.333333333333336,23.666666666666668,>,29.666666666666668,0,0,=,0,86,53,>,33,35.333333333333336,44.0,<,-8.666666666666664,32,31,>,1,41,53,<,-12,197,84,>,113
0,11,23.666666666666668,43.0,<,-19.333333333333332,0,0,=,0,53,79,<,-26,44.0,36.333333333333336,>,7.666666666666664,31,30,>,1,53,45,>,8,84,131,<,-47
170,11,43.0,23.666666666666668,>,19.333333333333332,0,0,=,0,79,53,>,26,36.333333333333336,44.0,<,-7.666666666666664,30,31,<,-1,45,53,<,-8,131,84,>,47
0,11,23.666666666666668,42.666666666666664,<,-18.999999999999996,0,0,=,0,53,79,<,-26,44.0,45.666666666666664,<,-1.6666666666666643,31,38,<,-7,53,60,<,-7,84,95,<,-11
110,11,42.666666666666664,23.666666666666668,>,18.999999999999996,0,0,=,0,79,53,>,26,45.666666666666664,44.0,>,1.6666666666666643,38,31,>,7,60,53,>,7,95,84,>,11
0,11,23.666666666666668,49.666666666666664,<,-25.999999999999996,0,0,=,0,53,80,<,-27,44.0,50.0,<,-6.0,31,45,<,-14,53,56,<,-3,84,167,<,-83
163,11,49.666666666666664,23.666666666666668,>,25.999999999999996,0,0,=,0,80,53,>,27,50.0,44.0,>,6.0,45,31,>,14,56,53,>,3,167,84,>,83
0,11,23.666666666666668,22.666666666666668,>,1.0,0,0,=,0,53,40,>,13,44.0,44.333333333333336,<,-0.3333333333333357,31,32,<,-1,53,52,>,1,84,201,<,-117
115,11,22.666666666666668,23.666666666666668,<,-1.0,0,0,=,0,40,53,<,-13,44.333333333333336,44.0,>,0.3333333333333357,32,31,>,1,52,53,<,-1,201,84,>,117
0,10,46.0,31.333333333333332,>,14.666666666666668,25,14,>,11,79,66,>,13,37.0,52.666666666666664,<,-15.666666666666664,31,51,<,-20,45,56,<,-11,139,135,>,4
0,10,31.333333333333332,46.0,<,-14.666666666666668,14,25,<,-11,66,79,<,-13,52.666666666666664,37.0,>,15.666666666666664,51,31,>,20,56,45,>,11,135,139,<,-4
0,10,46.0,50.0,<,-4.0,25,46,<,-21,79,57,>,22,37.0,47.333333333333336,<,-10.333333333333336,31,32,<,-1,45,57,<,-12,139,169,<,-30
87,10,50.0,46.0,>,4.0,46,25,>,21,57,79,<,-22,47.333333333333336,37.0,>,10.333333333333336,32,31,>,1,57,45,>,12,169,139,>,30
0,10,46.0,48.0,<,-2.0,25,16,>,9,79,79,=,0,37.0,45.666666666666664,<,-8.666666666666664,31,38,<,-7,45,60,<,-15,139,95,>,44
0,10,48.0,46.0,>,2.0,16,25,<,-9,79,79,=,0,45.666666666666664,37.0,>,8.666666666666664,38,31,>,7,60,45,>,15,95,139,<,-44
0,10,46.0,51.666666666666664,<,-5.666666666666664,25,25,=,0,79,85,<,-6,37.0,36.333333333333336,>,0.6666666666666643,31,31,=,0,45,40,>,5,139,157,<,-18
137,10,51.666666666666664,46.0,>,5.666666666666664,25,25,=,0,85,79,>,6,36.333333333333336,37.0,<,-0.6666666666666643,31,31,=,0,40,45,<,-5,157,139,>,18
0,10,46.0,47.666666666666664,<,-1.6666666666666643,25,28,<,-3,79,75,>,4,37.0,44.333333333333336,<,-7.333333333333336,31,32,<,-1,45,52,<,-7,139,201,<,-62
115,10,47.666666666666664,46.0,>,1.6666666666666643,28,25,>,3,75,79,<,-4,44.333333333333336,37.0,>,7.333333333333336,32,31,>,1,52,45,>,7,201,139,>,62
0,10,46.0,41.666666666666664,>,4.333333333333336,25,23,>,2,79,73,>,6,37.0,46.0,<,-9.0,31,35,<,-4,45,56,<,-11,139,179,<,-40
122,10,41.666666666666664,46.0,<,-4.333333333333336,23,25,<,-2,73,79,<,-6,46.0,37.0,>,9.0,35,31,>,4,56,45,>,11,179,139,>,40
0,10,46.0,59.333333333333336,<,-13.333333333333336,25,29,<,-4,79,80,<,-1,37.0,50.0,<,-13.0,31,45,<,-14,45,56,<,-11,139,167,<,-28
163,10,59.333333333333336,46.0,>,13.333333333333336,29,25,>,4,80,79,>,1,50.0,37.0,>,13.0,45,31,>,14,56,45,>,11,167,139,>,28
0,10,46.0,63.0,<,-17.0,25,50,<,-25,79,79,=,0,37.0,36.333333333333336,>,0.6666666666666643,31,30,>,1,45,45,=,0,139,131,>,8
182,10,63.0,46.0,>,17.0,50,25,>,25,79,79,=,0,36.333333333333336,37.0,<,-0.6666666666666643,30,31,<,-1,45,45,=,0,131,139,<,-8
0,10,46.0,71.0,<,-25.0,25,53,<,-28,79,86,<,-7,37.0,35.333333333333336,>,1.6666666666666643,31,32,<,-1,45,41,>,4,139,197,<,-58
194,10,71.0,46.0,>,25.0,53,25,>,28,86,79,>,7,35.333333333333336,37.0,<,-1.6666666666666643,32,31,>,1,41,45,<,-4,197,139,>,58
0,9,51.333333333333336,34.0,>,17.333333333333336,16,14,>,2,79,66,>,13,45.666666666666664,52.666666666666664,<,-7.0,38,51,<,-13,60,56,>,4,95,135,<,-40
0,9,34.0,51.333333333333336,<,-17.333333333333336,14,16,<,-2,66,79,<,-13,52.666666666666664,45.666666666666664,>,7.0,51,38,>,13,56,60,<,-4,135,95,>,40
0,9,51.333333333333336,41.0,>,10.333333333333336,16,20,<,-4,79,57,>,22,45.666666666666664,47.333333333333336,<,-1.6666666666666714,38,32,>,6,60,57,>,3,95,169,<,-74
87,9,41.0,51.333333333333336,<,-10.333333333333336,20,16,>,4,57,79,<,-22,47.333333333333336,45.666666666666664,>,1.6666666666666714,32,38,<,-6,57,60,<,-3,169,95,>,74
0,9,51.333333333333336,40.666666666666664,>,10.666666666666671,16,19,<,-3,79,75,>,4,45.666666666666664,44.333333333333336,>,1.3333333333333286,38,32,>,6,60,52,>,8,95,201,<,-106
107,9,40.666666666666664,51.333333333333336,<,-10.666666666666671,19,16,>,3,75,79,<,-4,44.333333333333336,45.666666666666664,<,-1.3333333333333286,32,38,<,-6,52,60,<,-8,201,95,>,106
0,9,51.333333333333336,61.333333333333336,<,-10.0,16,23,<,-7,79,88,<,-9,45.666666666666664,46.0,<,-0.3333333333333357,38,35,>,3,60,56,>,4,95,179,<,-84
157,9,61.333333333333336,51.333333333333336,>,10.0,23,16,>,7,88,79,>,9,46.0,45.666666666666664,>,0.3333333333333357,35,38,<,-3,56,60,<,-4,179,95,>,84
0,9,51.333333333333336,42.0,>,9.333333333333336,16,25,<,-9,79,56,>,23,45.666666666666664,36.333333333333336,>,9.333333333333329,38,31,>,7,60,40,>,20,95,157,<,-62
137,9,42.0,51.333333333333336,<,-9.333333333333336,25,16,>,9,56,79,<,-23,36.333333333333336,45.666666666666664,<,-9.333333333333329,31,38,<,-7,40,60,<,-20,157,95,>,62
0,9,51.333333333333336,36.333333333333336,>,15.0,16,11,>,5,79,69,>,10,45.666666666666664,50.0,<,-4.333333333333336,38,45,<,-7,60,56,>,4,95,167,<,-72
0,9,36.333333333333336,51.333333333333336,<,-15.0,11,16,<,-5,69,79,<,-10,50.0,45.666666666666664,>,4.333333333333336,45,38,>,7,56,60,<,-4,167,95,>,72
0,9,51.333333333333336,42.666666666666664,>,8.666666666666671,16,18,<,-2,79,60,>,19,45.666666666666664,36.333333333333336,>,9.333333333333329,38,30,>,8,60,45,>,15,95,131,<,-36
136,9,42.666666666666664,51.333333333333336,<,-8.666666666666671,18,16,>,2,60,79,<,-19,36.333333333333336,45.666666666666664,<,-9.333333333333329,30,38,<,-8,45,60,<,-15,131,95,>,36
0,9,51.333333333333336,66.33333333333333,<,-14.999999999999993,16,53,<,-37,79,74,>,5,45.666666666666664,35.333333333333336,>,10.333333333333329,38,32,>,6,60,41,>,19,95,197,<,-102
125,9,66.33333333333333,51.333333333333336,>,14.999999999999993,53,16,>,37,74,79,<,-5,35.333333333333336,45.666666666666664,<,-10.333333333333329,32,38,<,-6,41,60,<,-19,197,95,>,102
0,8,37.0,21.0,>,16.0,11,14,<,-3,69,27,>,42,50.0,52.666666666666664,<,-2.6666666666666643,45,51,<,-6,56,56,=,0,167,135,>,32
0,8,21.0,37.0,<,-16.0,14,11,>,3,27,69,<,-42,52.666666666666664,50.0,>,2.6666666666666643,51,45,>,6,56,56,=,0,135,167,<,-32
0,8,37.0,43.0,<,-6.0,11,20,<,-9,69,63,>,6,50.0,47.333333333333336,>,2.6666666666666643,45,32,>,13,56,57,<,-1,167,169,<,-2
87,8,43.0,37.0,>,6.0,20,11,>,9,63,69,<,-6,47.333333333333336,50.0,<,-2.6666666666666643,32,45,<,-13,57,56,>,1,169,167,>,2
0,8,37.0,24.0,>,13.0,11,19,<,-8,69,28,>,41,50.0,44.333333333333336,>,5.666666666666664,45,32,>,13,56,52,>,4,167,201,<,-34
107,8,24.0,37.0,<,-13.0,19,11,>,8,28,69,<,-41,44.333333333333336,50.0,<,-5.666666666666664,32,45,<,-13,52,56,<,-4,201,167,>,34
0,8,37.0,69.66666666666667,<,-32.66666666666667,11,63,<,-52,69,74,<,-5,50.0,35.333333333333336,>,14.666666666666664,45,32,>,13,56,41,>,15,167,197,<,-30
125,8,69.66666666666667,37.0,>,32.66666666666667,63,11,>,52,74,69,>,5,35.333333333333336,50.0,<,-14.666666666666664,32,45,<,-13,41,56,<,-15,197,167,>,30
0,8,37.0,26.666666666666668,>,10.333333333333332,11,12,<,-1,69,50,>,19,50.0,36.333333333333336,>,13.666666666666664,45,30,>,15,56,45,>,11,167,131,>,36
0,8,26.666666666666668,37.0,<,-10.333333333333332,12,11,>,1,50,69,<,-19,36.333333333333336,50.0,<,-13.666666666666664,30,45,<,-15,45,56,<,-11,131,167,<,-36
0,8,37.0,51.666666666666664,<,-14.666666666666664,11,25,<,-14,69,74,<,-5,50.0,36.333333333333336,>,13.666666666666664,45,31,>,14,56,40,>,16,167,157,>,10
137,8,51.666666666666664,37.0,>,14.666666666666664,25,11,>,14,74,69,>,5,36.333333333333336,50.0,<,-13.666666666666664,31,45,<,-14,40,56,<,-16,157,167,<,-10
0,8,37.0,67.0,<,-30.0,11,40,<,-29,69,88,<,-19,50.0,46.0,>,4.0,45,35,>,10,56,56,=,0,167,179,<,-12
152,8,67.0,37.0,>,30.0,40,11,>,29,88,69,>,19,46.0,50.0,<,-4.0,35,45,<,-10,56,56,=,0,179,167,>,12
0,7,44.0,37.333333333333336,>,6.666666666666664,12,14,<,-2,70,71,<,-1,36.333333333333336,52.666666666666664,<,-16.33333333333333,30,51,<,-21,45,56,<,-11,131,135,<,-4
0,7,37.333333333333336,44.0,<,-6.666666666666664,14,12,>,2,71,70,>,1,52.666666666666664,36.333333333333336,>,16.33333333333333,51,30,>,21,56,45,>,11,135,131,>,4
0,7,44.0,48.0,<,-4.0,12,35,<,-23,70,63,>,7,36.333333333333336,47.333333333333336,<,-11.0,30,32,<,-2,45,57,<,-12,131,169,<,-38
87,7,48.0,44.0,>,4.0,35,12,>,23,63,70,<,-7,47.333333333333336,36.333333333333336,>,11.0,32,30,>,2,57,45,>,12,169,131,>,38
0,7,44.0,21.0,>,23.0,12,10,>,2,70,28,>,42,36.333333333333336,44.333333333333336,<,-8.0,30,32,<,-2,45,52,<,-7,131,201,<,-70
0,7,21.0,44.0,<,-23.0,10,12,<,-2,28,70,<,-42,44.333333333333336,36.333333333333336,>,8.0,32,30,>,2,52,45,>,7,201,131,>,70
0,7,44.0,73.66666666666667,<,-29.66666666666667,12,63,<,-51,70,84,<,-14,36.333333333333336,35.333333333333336,>,1.0,30,32,<,-2,45,41,>,4,131,197,<,-66
76,7,73.66666666666667,44.0,>,29.66666666666667,63,12,>,51,84,70,>,14,35.333333333333336,36.333333333333336,<,-1.0,32,30,>,2,41,45,<,-4,197,131,>,66
0,7,44.0,61.333333333333336,<,-17.333333333333336,12,25,<,-13,70,85,<,-15,36.333333333333336,36.333333333333336,=,0.0,30,31,<,-1,45,40,>,5,131,157,<,-26
119,7,61.333333333333336,44.0,>,17.333333333333336,25,12,>,13,85,70,>,15,36.333333333333336,36.333333333333336,=,0.0,31,30,>,1,40,45,<,-5,157,131,>,26
0,7,44.0,59.666666666666664,<,-15.666666666666664,12,40,<,-28,70,73,<,-3,36.333333333333336,46.0,<,-9.666666666666664,30,35,<,-5,45,56,<,-11,131,179,<,-48
33,7,59.666666666666664,44.0,>,15.666666666666664,40,12,>,28,73,70,>,3,46.0,36.333333333333336,>,9.666666666666664,35,30,>,5,56,45,>,11,179,131,>,48
0,6,25.666666666666668,40.0,<,-14.333333333333332,10,14,<,-4,39,71,<,-32,44.333333333333336,52.666666666666664,<,-8.333333333333329,32,51,<,-19,52,56,<,-4,201,135,>,66
0,6,40.0,25.666666666666668,>,14.333333333333332,14,10,>,4,71,39,>,32,52.666666666666664,44.333333333333336,>,8.333333333333329,51,32,>,19,56,52,>,4,135,201,<,-66
0,6,25.666666666666668,51.0,<,-25.333333333333332,10,14,<,-4,39,73,<,-34,44.333333333333336,46.0,<,-1.6666666666666643,32,35,<,-3,52,56,<,-4,201,179,>,22
33,6,51.0,25.666666666666668,>,25.333333333333332,14,10,>,4,73,39,>,34,46.0,44.333333333333336,>,1.6666666666666643,35,32,>,3,56,52,>,4,179,201,<,-22
0,6,25.666666666666668,57.333333333333336,<,-31.666666666666668,10,14,<,-4,39,84,<,-45,44.333333333333336,35.333333333333336,>,9.0,32,32,=,0,52,41,>,11,201,197,>,4
57,6,57.333333333333336,25.666666666666668,>,31.666666666666668,14,10,>,4,84,39,>,45,35.333333333333336,44.333333333333336,<,-9.0,32,32,=,0,41,52,<,-11,197,201,<,-4
0,6,25.666666666666668,51.333333333333336,<,-25.666666666666668,10,35,<,-25,39,73,<,-34,44.333333333333336,47.333333333333336,<,-3.0,32,32,=,0,52,57,<,-5,201,169,>,32
87,6,51.333333333333336,25.666666666666668,>,25.666666666666668,35,10,>,25,73,39,>,34,47.333333333333336,44.333333333333336,>,3.0,32,32,=,0,57,52,>,5,169,201,<,-32
0,6,25.666666666666668,42.0,<,-16.333333333333332,10,16,<,-6,39,85,<,-46,44.333333333333336,36.333333333333336,>,8.0,32,31,>,1,52,40,>,12,201,157,>,44
0,6,42.0,25.666666666666668,>,16.333333333333332,16,10,>,6,85,39,>,46,36.333333333333336,44.333333333333336,<,-8.0,31,32,<,-1,40,52,<,-12,157,201,<,-44
0,5,20.666666666666668,22.666666666666668,<,-2.0,16,14,>,2,25,35,<,-10,36.333333333333336,52.666666666666664,<,-16.33333333333333,31,51,<,-20,40,56,<,-16,157,135,>,22
0,5,22.666666666666668,20.666666666666668,>,2.0,14,16,<,-2,35,25,>,10,52.666666666666664,36.333333333333336,>,16.33333333333333,51,31,>,20,56,40,>,16,135,157,<,-22
0,5,20.666666666666668,50.666666666666664,<,-29.999999999999996,16,14,>,2,25,73,<,-48,36.333333333333336,46.0,<,-9.666666666666664,31,35,<,-4,40,56,<,-16,157,179,<,-22
53,5,50.666666666666664,20.666666666666668,>,29.999999999999996,14,16,<,-2,73,25,>,48,46.0,36.333333333333336,>,9.666666666666664,35,31,>,4,56,40,>,16,179,157,>,22
0,5,20.666666666666668,56.0,<,-35.33333333333333,16,14,>,2,25,80,<,-55,36.333333333333336,35.333333333333336,>,1.0,31,32,<,-1,40,41,<,-1,157,197,<,-40
57,5,56.0,20.666666666666668,>,35.33333333333333,14,16,<,-2,80,25,>,55,35.333333333333336,36.333333333333336,<,-1.0,32,31,>,1,41,40,>,1,197,157,>,40
0,5,20.666666666666668,60.333333333333336,<,-39.66666666666667,16,46,<,-30,25,73,<,-48,36.333333333333336,47.333333333333336,<,-11.0,31,32,<,-1,40,57,<,-17,157,169,<,-12
87,5,60.333333333333336,20.666666666666668,>,39.66666666666667,46,16,>,30,73,25,>,48,47.333333333333336,36.333333333333336,>,11.0,32,31,>,1,57,40,>,17,169,157,>,12
0,4,23.666666666666668,56.0,<,-32.33333333333333,14,30,<,-16,38,73,<,-35,52.666666666666664,46.0,>,6.666666666666664,51,35,>,16,56,56,=,0,135,179,<,-44
52,4,56.0,23.666666666666668,>,32.33333333333333,30,14,>,16,73,38,>,35,46.0,52.666666666666664,<,-6.666666666666664,35,51,<,-16,56,56,=,0,179,135,>,44
0,4,23.666666666666668,57.333333333333336,<,-33.66666666666667,14,18,<,-4,38,80,<,-42,52.666666666666664,35.333333333333336,>,17.33333333333333,51,32,>,19,56,41,>,15,135,197,<,-62
0,4,57.333333333333336,23.666666666666668,>,33.66666666666667,18,14,>,4,80,38,>,42,35.333333333333336,52.666666666666664,<,-17.33333333333333,32,51,<,-19,41,56,<,-15,197,135,>,62
0,4,23.666666666666668,60.0,<,-36.33333333333333,14,46,<,-32,38,72,<,-34,52.666666666666664,47.333333333333336,>,5.333333333333329,51,32,>,19,56,57,<,-1,135,169,<,-34
87,4,60.0,23.666666666666668,>,36.33333333333333,46,14,>,32,72,38,>,34,47.333333333333336,52.666666666666664,<,-5.333333333333329,32,51,<,-19,57,56,>,1,169,135,>,34
0,3,55.666666666666664,56.333333333333336,<,-0.6666666666666714,18,30,<,-12,80,74,>,6,35.333333333333336,46.0,<,-10.666666666666664,32,35,<,-3,41,56,<,-15,197,179,>,18
52,3,56.333333333333336,55.666666666666664,>,0.6666666666666714,30,18,>,12,74,80,<,-6,46.0,35.333333333333336,>,10.666666666666664,35,32,>,3,56,41,>,15,179,197,<,-18
0,3,55.666666666666664,49.666666666666664,>,6.0,18,15,>,3,80,72,>,8,35.333333333333336,47.333333333333336,<,-12.0,32,32,=,0,41,57,<,-16,197,169,>,28
0,3,49.666666666666664,55.666666666666664,<,-6.0,15,18,<,-3,72,80,<,-8,47.333333333333336,35.333333333333336,>,12.0,32,32,=,0,57,41,>,16,169,197,<,-28
0,2,51.0,72.0,<,-21.0,15,65,<,-50,76,77,<,-1,47.333333333333336,46.0,>,1.3333333333333357,32,35,<,-3,57,56,>,1,169,179,<,-10
99,2,72.0,51.0,>,21.0,65,15,>,50,77,76,>,1,46.0,47.333333333333336,<,-1.3333333333333357,35,32,>,3,56,57,<,-1,179,169,>,10
0,18,0.0,0.0,=,0.0,0,0,=,0,0,0,=,0,40.333333333333336,45.666666666666664,<,-5.333333333333329,30,44,<,-14,48,49,<,-1,132,274,<,-142
158,18,0.0,0.0,=,0.0,0,0,=,0,0,0,=,0,45.666666666666664,40.333333333333336,>,5.333333333333329,44,30,>,14,49,48,>,1,274,132,>,142
0,18,0.0,0.0,=,0.0,0,0,=,0,0,0,=,0,40.333333333333336,48.666666666666664,<,-8.333333333333329,30,40,<,-10,48,57,<,-9,132,128,>,4
10,18,0.0,0.0,=,0.0,0,0,=,0,0,0,=,0,48.666666666666664,40.333333333333336,>,8.333333333333329,40,30,>,10,57,48,>,9,128,132,<,-4
0,18,0.0,0.0,=,0.0,0,0,=,0,0,0,=,0,40.333333333333336,40.0,>,0.3333333333333357,30,35,<,-5,48,43,>,5,132,228,<,-96
137,18,0.0,0.0,=,0.0,0,0,=,0,0,0,=,0,40.0,40.333333333333336,<,-0.3333333333333357,35,30,>,5,43,48,<,-5,228,132,>,96
0,18,0.0,0.0,=,0.0,0,0,=,0,0,0,=,0,40.333333333333336,53.666666666666664,<,-13.333333333333329,30,43,<,-13,48,60,<,-12,132,238,<,-106
70,18,0.0,0.0,=,0.0,0,0,=,0,0,0,=,0,53.666666666666664,40.333333333333336,>,13.333333333333329,43,30,>,13,60,48,>,12,238,132,>,106
0,18,0.0,0.0,=,0.0,0,0,=,0,0,0,=,0,40.333333333333336,40.666666666666664,<,-0.3333333333333286,30,39,<,-9,48,43,>,5,132,150,<,-18
49,18,0.0,0.0,=,0.0,0,0,=,0,0,0,=,0,40.666666666666664,40.333333333333336,>,0.3333333333333286,39,30,>,9,43,48,<,-5,150,132,>,18
0,18,0.0,0.0,=,0.0,0,0,=,0,0,0,=,0,40.333333333333336,50.333333333333336,<,-10.0,30,35,<,-5,48,58,<,-10,132,108,>,24
68,18,0.0,0.0,=,0.0,0,0,=,0,0,0,=,0,50.333333333333336,40.333333333333336,>,10.0,35,30,>,5,58,48,>,10,108,132,<,-24
0,18,0.0,0.0,=,0.0,0,0,=,0,0,0,=,0,40.333333333333336,37.0,>,3.3333333333333357,30,33,<,-3,48,41,>,7,132,231,<,-99
87,18,0.0,0.0,=,0.0,0,0,=,0,0,0,=,0,37.0,40.333333333333336,<,-3.3333333333333357,33,30,>,3,41,48,<,-7,231,132,>,99
0,18,0.0,0.0,=,0.0,0,0,=,0,0,0,=,0,40.333333333333336,50.666666666666664,<,-10.333333333333329,30,37,<,-7,48,58,<,-10,132,118,>,14
60,18,0.0,0.0,=,0.0,0,0,=,0,0,0,=,0,50.666666666666664,40.333333333333336,>,10.333333333333329,37,30,>,7,58,48,>,10,118,132,<,-14
0,18,0.0,0.0,=,0.0,0,0,=,0,0,0,=,0,40.333333333333336,52.0,<,-11.666666666666664,30,45,<,-15,48,56,<,-8,132,125,>,7
138,18,0.0,0.0,=,0.0,0,0,=,0,0,0,=,0,52.0,40.333333333333336,>,11.666666666666664,45,30,>,15,56,48,>,8,125,132,<,-7
0,18,0.0,0.0,=,0.0,0,0,=,0,0,0,=,0,40.333333333333336,49.0,<,-8.666666666666664,30,38,<,-8,48,55,<,-7,132,137,<,-5
0,18,0.0,0.0,=,0.0,0,0,=,0,0,0,=,0,49.0,40.333333333333336,>,8.666666666666664,38,30,>,8,55,48,>,7,137,132,>,5
0,18,0.0,0.0,=,0.0,0,0,=,0,0,0,=,0,40.333333333333336,38.333333333333336,>,2.0,30,30,=,0,48,53,<,-5,132,278,<,-146
144,18,0.0,0.0,=,0.0,0,0,=,0,0,0,=,0,38.333333333333336,40.333333333333336,<,-2.0,30,30,=,0,53,48,>,5,278,132,>,146
0,18,0.0,0.0,=,0.0,0,0,=,0,0,0,=,0,40.333333333333336,42.0,<,-1.6666666666666643,30,32,<,-2,48,53,<,-5,132,201,<,-69
47,18,0.0,0.0,=,0.0,0,0,=,0,0,0,=,0,42.0,40.333333333333336,>,1.6666666666666643,32,30,>,2,53,48,>,5,201,132,>,69
0,18,0.0,0.0,=,0.0,0,0,=,0,0,0,=,0,40.333333333333336,46.666666666666664,<,-6.333333333333329,30,38,<,-8,48,60,<,-12,132,209,<,-77
159,18,0.0,0.0,=,0.0,0,0,=,0,0,0,=,0,46.666666666666664,40.333333333333336,>,6.333333333333329,38,30,>,8,60,48,>,12,209,132,>,77
0,18,0.0,0.0,=,0.0,0,0,=,0,0,0,=,0,40.333333333333336,43.333333333333336,<,-3.0,30,33,<,-3,48,50,<,-2,132,198,<,-66
98,18,0.0,0.0,=,0.0,0,0,=,0,0,0,=,0,43.333333333333336,40.333333333333336,>,3.0,33,30,>,3,50,48,>,2,198,132,>,66
0,18,0.0,0.0,=,0.0,0,0,=,0,0,0,=,0,40.333333333333336,46.0,<,-5.666666666666664,30,38,<,-8,48,51,<,-3,132,120,>,12
0,18,0.0,0.0,=,0.0,0,0,=,0,0,0,=,0,46.0,40.333333333333336,>,5.666666666666664,38,30,>,8,51,48,>,3,120,132,<,-12
0,18,0.0,0.0,=,0.0,0,0,=,0,0,0,=,0,40.333333333333336,50.666666666666664,<,-10.333333333333329,30,48,<,-18,48,54,<,-6,132,243,<,-111
100,18,0.0,0.0,=,0.0,0,0,=,0,0,0,=,0,50.666666666666664,40.333333333333336,>,10.333333333333329,48,30,>,18,54,48,>,6,243,132,>,111
0,18,0.0,0.0,=,0.0,0,0,=,0,0,0,=,0,40.333333333333336,49.0,<,-8.666666666666664,30,41,<,-11,48,60,<,-12,132,171,<,-39
58,18,0.0,0.0,=,0.0,0,0,=,0,0,0,=,0,49.0,40.333333333333336,>,8.666666666666664,41,30,>,11,60,48,>,12,171,132,>,39
0,17,13.333333333333334,25.333333333333332,<,-11.999999999999998,0,0,=,0,40,76,<,-36,49.0,46.0,>,3.0,38,38,=,0,55,51,>,4,137,120,>,17
0,17,25.333333333333332,13.333333333333334,>,11.999999999999998,0,0,=,0,76,40,>,36,46.0,49.0,<,-3.0,38,38,=,0,51,55,<,-4,120,137,<,-17
0,17,13.333333333333334,15.333333333333334,<,-2.0,0,0,=,0,40,46,<,-6,49.0,48.666666666666664,>,0.3333333333333357,38,40,<,-2,55,57,<,-2,137,128,>,9
53,17,15.333333333333334,13.333333333333334,>,2.0,0,0,=,0,46,40,>,6,48.666666666666664,49.0,<,-0.3333333333333357,40,38,>,2,57,55,>,2,128,137,<,-9
0,17,13.333333333333334,18.0,<,-4.666666666666666,0,0,=,0,40,54,<,-14,49.0,42.0,>,7.0,38,32,>,6,55,53,>,2,137,201,<,-64
122,17,18.0,13.333333333333334,>,4.666666666666666,0,0,=,0,54,40,>,14,42.0,49.0,<,-7.0,32,38,<,-6,53,55,<,-2,201,137,>,64
0,17,13.333333333333334,11.666666666666666,>,1.6666666666666679,0,0,=,0,40,35,>,5,49.0,40.666666666666664,>,8.333333333333336,38,39,<,-1,55,43,>,12,137,150,<,-13
74,17,11.666666666666666,13.333333333333334,<,-1.6666666666666679,0,0,=,0,35,40,<,-5,40.666666666666664,49.0,<,-8.333333333333336,39,38,>,1,43,55,<,-12,150,137,>,13
0,17,13.333333333333334,25.666666666666668,<,-12.333333333333334,0,0,=,0,40,77,<,-37,49.0,49.0,=,0.0,38,41,<,-3,55,60,<,-5,137,171,<,-34
193,17,25.666666666666668,13.333333333333334,>,12.333333333333334,0,0,=,0,77,40,>,37,49.0,49.0,=,0.0,41,38,>,3,60,55,>,5,171,137,>,34
0,17,13.333333333333334,4.0,>,9.333333333333334,0,0,=,0,40,12,>,28,49.0,50.666666666666664,<,-1.6666666666666643,38,37,>,1,55,58,<,-3,137,118,>,19
0,17,4.0,13.333333333333334,<,-9.333333333333334,0,0,=,0,12,40,<,-28,50.666666666666664,49.0,>,1.6666666666666643,37,38,<,-1,58,55,>,3,118,137,<,-19
0,17,13.333333333333334,20.333333333333332,<,-6.999999999999998,0,0,=,0,40,61,<,-21,49.0,50.333333333333336,<,-1.3333333333333357,38,35,>,3,55,58,<,-3,137,108,>,29
105,17,20.333333333333332,13.333333333333334,>,6.999999999999998,0,0,=,0,61,40,>,21,50.333333333333336,49.0,>,1.3333333333333357,35,38,<,-3,58,55,>,3,108,137,<,-29
0,17,13.333333333333334,19.666666666666668,<,-6.333333333333334,0,0,=,0,40,59,<,-19,49.0,53.666666666666664,<,-4.666666666666664,38,43,<,-5,55,60,<,-5,137,238,<,-101
70,17,19.666666666666668,13.333333333333334,>,6.333333333333334,0,0,=,0,59,40,>,19,53.666666666666664,49.0,>,4.666666666666664,43,38,>,5,60,55,>,5,238,137,>,101
0,17,13.333333333333334,17.666666666666668,<,-4.333333333333334,0,0,=,0,40,53,<,-13,49.0,37.0,>,12.0,38,33,>,5,55,41,>,14,137,231,<,-94
149,17,17.666666666666668,13.333333333333334,>,4.333333333333334,0,0,=,0,53,40,>,13,37.0,49.0,<,-12.0,33,38,<,-5,41,55,<,-14,231,137,>,94
0,17,13.333333333333334,26.666666666666668,<,-13.333333333333334,0,0,=,0,40,80,<,-40,49.0,43.333333333333336,>,5.666666666666664,38,33,>,5,55,50,>,5,137,198,<,-61
103,17,26.666666666666668,13.333333333333334,>,13.333333333333334,0,0,=,0,80,40,>,40,43.333333333333336,49.0,<,-5.666666666666664,33,38,<,-5,50,55,<,-5,198,137,>,61
0,17,13.333333333333334,8.0,>,5.333333333333334,0,0,=,0,40,24,>,16,49.0,50.666666666666664,<,-1.6666666666666643,38,48,<,-10,55,54,>,1,137,243,<,-106
88,17,8.0,13.333333333333334,<,-5.333333333333334,0,0,=,0,24,40,<,-16,50.666666666666664,49.0,>,1.6666666666666643,48,38,>,10,54,55,<,-1,243,137,>,106
0,17,13.333333333333334,24.333333333333332,<,-10.999999999999998,0,0,=,0,40,73,<,-33,49.0,40.0,>,9.0,38,35,>,3,55,43,>,12,137,228,<,-91
122,17,24.333333333333332,13.333333333333334,>,10.999999999999998,0,0,=,0,73,40,>,33,40.0,49.0,<,-9.0,35,38,<,-3,43,55,<,-12,228,137,>,91
0,17,13.333333333333334,22.0,<,-8.666666666666666,0,0,=,0,40,66,<,-26,49.0,52.0,<,-3.0,38,45,<,-7,55,56,<,-1,137,125,>,12
156,17,22.0,13.333333333333334,>,8.666666666666666,0,0,=,0,66,40,>,26,52.0,49.0,>,3.0,45,38,>,7,56,55,>,1,125,137,<,-12
0,17,13.333333333333334,30.0,<,-16.666666666666664,0,0,=,0,40,90,<,-50,49.0,38.333333333333336,>,10.666666666666664,38,30,>,8,55,53,>,2,137,278,<,-141
157,17,30.0,13.333333333333334,>,16.666666666666664,0,0,=,0,90,40,>,50,38.333333333333336,49.0,<,-10.666666666666664,30,38,<,-8,53,55,<,-2,278,137,>,141
0,17,13.333333333333334,25.333333333333332,<,-11.999999999999998,0,0,=,0,40,76,<,-36,49.0,45.666666666666664,>,3.3333333333333357,38,44,<,-6,55,49,>,6,137,274,<,-137
196,17,25.333333333333332,13.333333333333334,>,11.999999999999998,0,0,=,0,76,40,>,36,45.666666666666664,49.0,<,-3.3333333333333357,44,38,>,6,49,55,<,-6,274,137,>,137
0,17,13.333333333333334,22.0,<,-8.666666666666666,0,0,=,0,40,66,<,-26,49.0,46.666666666666664,>,2.3333333333333357,38,38,=,0,55,60,<,-5,137,209,<,-72
169,17,22.0,13.333333333333334,>,8.666666666666666,0,0,=,0,66,40,>,26,46.666666666666664,49.0,<,-2.3333333333333357,38,38,=,0,60,55,>,5,209,137,>,72
0,16,25.0,37.0,<,-12.0,0,0,=,0,63,76,<,-13,50.666666666666664,46.0,>,4.666666666666664,37,38,<,-1,58,51,>,7,118,120,<,-2
0,16,37.0,25.0,>,12.0,0,0,=,0,76,63,>,13,46.0,50.666666666666664,<,-4.666666666666664,38,37,>,1,51,58,<,-7,120,118,>,2
0,16,25.0,21.666666666666668,>,3.333333333333332,0,0,=,0,63,46,>,17,50.666666666666664,48.666666666666664,>,2.0,37,40,<,-3,58,57,>,1,118,128,<,-10
54,16,21.666666666666668,25.0,<,-3.333333333333332,0,0,=,0,46,63,<,-17,48.666666666666664,50.666666666666664,<,-2.0,40,37,>,3,57,58,<,-1,128,118,>,10
0,16,25.0,43.0,<,-18.0,0,0,=,0,63,70,<,-7,50.666666666666664,53.666666666666664,<,-3.0,37,43,<,-6,58,60,<,-2,118,238,<,-120
70,16,43.0,25.0,>,18.0,0,0,=,0,70,63,>,7,53.666666666666664,50.666666666666664,>,3.0,43,37,>,6,60,58,>,2,238,118,>,120
0,16,25.0,29.666666666666668,<,-4.666666666666668,0,0,=,0,63,54,>,9,50.666666666666664,40.666666666666664,>,10.0,37,39,<,-2,58,43,>,15,118,150,<,-32
106,16,29.666666666666668,25.0,>,4.666666666666668,0,0,=,0,54,63,<,-9,40.666666666666664,50.666666666666664,<,-10.0,39,37,>,2,43,58,<,-15,150,118,>,32
0,16,25.0,13.333333333333334,>,11.666666666666666,0,0,=,0,63,24,>,39,50.666666666666664,50.666666666666664,=,0.0,37,48,<,-11,58,54,>,4,118,243,<,-125
88,16,13.333333333333334,25.0,<,-11.666666666666666,0,0,=,0,24,63,<,-39,50.666666666666664,50.666666666666664,=,0.0,48,37,>,11,54,58,<,-4,243,118,>,125
0,16,25.0,37.666666666666664,<,-12.666666666666664,0,0,=,0,63,80,<,-17,50.666666666666664,43.333333333333336,>,7.333333333333329,37,33,>,4,58,50,>,8,118,198,<,-80
103,16,37.666666666666664,25.0,>,12.666666666666664,0,0,=,0,80,63,>,17,43.333333333333336,50.666666666666664,<,-7.333333333333329,33,37,<,-4,50,58,<,-8,198,118,>,80
0,16,25.0,25.0,=,0.0,0,0,=,0,63,61,>,2,50.666666666666664,50.333333333333336,>,0.3333333333333286,37,35,>,2,58,58,=,0,118,108,>,10
54,16,25.0,25.0,=,0.0,0,0,=,0,61,63,<,-2,50.333333333333336,50.666666666666664,<,-0.3333333333333286,35,37,<,-2,58,58,=,0,108,118,<,-10
0,16,25.0,41.0,<,-16.0,0,0,=,0,63,73,<,-10,50.666666666666664,40.0,>,10.666666666666664,37,35,>,2,58,43,>,15,118,228,<,-110
149,16,41.0,25.0,>,16.0,0,0,=,0,73,63,>,10,40.0,50.666666666666664,<,-10.666666666666664,35,37,<,-2,43,58,<,-15,228,118,>,110
0,16,25.0,41.0,<,-16.0,0,0,=,0,63,69,<,-6,50.666666666666664,42.0,>,8.666666666666664,37,32,>,5,58,53,>,5,118,201,<,-83
122,16,41.0,25.0,>,16.0,0,0,=,0,69,63,>,6,42.0,50.666666666666664,<,-8.666666666666664,32,37,<,-5,53,58,<,-5,201,118,>,83
0,16,25.0,42.0,<,-17.0,0,0,=,0,63,73,<,-10,50.666666666666664,37.0,>,13.666666666666664,37,33,>,4,58,41,>,17,118,231,<,-113
166,16,42.0,25.0,>,17.0,0,0,=,0,73,63,>,10,37.0,50.666666666666664,<,-13.666666666666664,33,37,<,-4,41,58,<,-17,231,118,>,113
0,16,25.0,45.666666666666664,<,-20.666666666666664,0,0,=,0,63,71,<,-8,50.666666666666664,52.0,<,-1.3333333333333357,37,45,<,-8,58,56,>,2,118,125,<,-7
156,16,45.666666666666664,25.0,>,20.666666666666664,0,0,=,0,71,63,>,8,52.0,50.666666666666664,>,1.3333333333333357,45,37,>,8,56,58,<,-2,125,118,>,7
0,16,25.0,44.666666666666664,<,-19.666666666666664,0,0,=,0,63,90,<,-27,50.666666666666664,38.333333333333336,>,12.333333333333329,37,30,>,7,58,53,>,5,118,278,<,-160
157,16,44.666666666666664,25.0,>,19.666666666666664,0,0,=,0,90,63,>,27,38.333333333333336,50.666666666666664,<,-12.333333333333329,30,37,<,-7,53,58,<,-5,278,118,>,160
0,16,25.0,51.666666666666664,<,-26.666666666666664,0,0,=,0,63,89,<,-26,50.666666666666664,46.666666666666664,>,4.0,37,38,<,-1,58,60,<,-2,118,209,<,-91
155,16,51.666666666666664,25.0,>,26.666666666666664,0,0,=,0,89,63,>,26,46.666666666666664,50.666666666666664,<,-4.0,38,37,>,1,60,58,>,2,209,118,>,91
0,16,25.0,47.333333333333336,<,-22.333333333333336,0,0,=,0,63,77,<,-14,50.666666666666664,49.0,>,1.6666666666666643,37,41,<,-4,58,60,<,-2,118,171,<,-53
167,16,47.333333333333336,25.0,>,22.333333333333336,0,0,=,0,77,63,>,14,49.0,50.666666666666664,<,-1.6666666666666643,41,37,>,4,60,58,>,2,171,118,>,53
0,16,25.0,38.666666666666664,<,-13.666666666666664,0,0,=,0,63,76,<,-13,50.666666666666664,45.666666666666664,>,5.0,37,44,<,-7,58,49,>,9,118,274,<,-156
190,16,38.666666666666664,25.0,>,13.666666666666664,0,0,=,0,76,63,>,13,45.666666666666664,50.666666666666664,<,-5.0,44,37,>,7,49,58,<,-9,274,118,>,156
0,15,22.333333333333332,14.666666666666666,>,7.666666666666666,0,0,=,0,35,25,>,10,46.0,48.666666666666664,<,-2.6666666666666643,38,40,<,-2,51,57,<,-6,120,128,<,-8
76,15,14.666666666666666,22.333333333333332,<,-7.666666666666666,0,0,=,0,25,35,<,-10,48.666666666666664,46.0,>,2.6666666666666643,40,38,>,2,57,51,>,6,128,120,>,8
0,15,22.333333333333332,31.666666666666668,<,-9.333333333333336,0,0,=,0,35,81,<,-46,46.0,50.333333333333336,<,-4.333333333333336,38,35,>,3,51,58,<,-7,120,108,>,12
0,15,31.666666666666668,22.333333333333332,>,9.333333333333336,0,0,=,0,81,35,>,46,50.333333333333336,46.0,>,4.333333333333336,35,38,<,-3,58,51,>,7,108,120,<,-12
0,15,22.333333333333332,45.666666666666664,<,-23.333333333333332,0,0,=,0,35,70,<,-35,46.0,53.666666666666664,<,-7.666666666666664,38,43,<,-5,51,60,<,-9,120,238,<,-118
70,15,45.666666666666664,22.333333333333332,>,23.333333333333332,0,0,=,0,70,35,>,35,53.666666666666664,46.0,>,7.666666666666664,43,38,>,5,60,51,>,9,238,120,>,118
0,15,22.333333333333332,13.0,>,9.333333333333332,0,0,=,0,35,23,>,12,46.0,50.666666666666664,<,-4.666666666666664,38,48,<,-10,51,54,<,-3,120,243,<,-123
74,15,13.0,22.333333333333332,<,-9.333333333333332,0,0,=,0,23,35,<,-12,50.666666666666664,46.0,>,4.666666666666664,48,38,>,10,54,51,>,3,243,120,>,123
0,15,22.333333333333332,22.0,>,0.33333333333333215,0,0,=,0,35,33,>,2,46.0,43.333333333333336,>,2.6666666666666643,38,33,>,5,51,50,>,1,120,198,<,-78
103,15,22.0,22.333333333333332,<,-0.33333333333333215,0,0,=,0,33,35,<,-2,43.333333333333336,46.0,<,-2.6666666666666643,33,38,<,-5,50,51,<,-1,198,120,>,78
0,15,22.333333333333332,25.0,<,-2.666666666666668,0,0,=,0,35,54,<,-19,46.0,40.666666666666664,>,5.333333333333336,38,39,<,-1,51,43,>,8,120,150,<,-30
43,15,25.0,22.333333333333332,>,2.666666666666668,0,0,=,0,54,35,>,19,40.666666666666664,46.0,<,-5.333333333333336,39,38,>,1,43,51,<,-8,150,120,>,30
0,15,22.333333333333332,29.666666666666668,<,-7.333333333333336,0,0,=,0,35,69,<,-34,46.0,42.0,>,4.0,38,32,>,6,51,53,<,-2,120,201,<,-81
99,15,29.666666666666668,22.333333333333332,>,7.333333333333336,0,0,=,0,69,35,>,34,42.0,46.0,<,-4.0,32,38,<,-6,53,51,>,2,201,120,>,81
0,15,22.333333333333332,40.333333333333336,<,-18.000000000000004,0,0,=,0,35,71,<,-36,46.0,40.0,>,6.0,38,35,>,3,51,43,>,8,120,228,<,-108
140,15,40.333333333333336,22.333333333333332,>,18.000000000000004,0,0,=,0,71,35,>,36,40.0,46.0,<,-6.0,35,38,<,-3,43,51,<,-8,228,120,>,108
0,15,22.333333333333332,48.333333333333336,<,-26.000000000000004,0,0,=,0,35,89,<,-54,46.0,46.666666666666664,<,-0.6666666666666643,38,38,=,0,51,60,<,-9,120,209,<,-89
155,15,48.333333333333336,22.333333333333332,>,26.000000000000004,0,0,=,0,89,35,>,54,46.666666666666664,46.0,>,0.6666666666666643,38,38,=,0,60,51,>,9,209,120,>,89
0,15,22.333333333333332,50.333333333333336,<,-28.000000000000004,0,0,=,0,35,80,<,-45,46.0,52.0,<,-6.0,38,45,<,-7,51,56,<,-5,120,125,<,-5
138,15,50.333333333333336,22.333333333333332,>,28.000000000000004,0,0,=,0,80,35,>,45,52.0,46.0,>,6.0,45,38,>,7,56,51,>,5,125,120,>,5
0,15,22.333333333333332,41.333333333333336,<,-19.000000000000004,0,0,=,0,35,80,<,-45,46.0,38.333333333333336,>,7.666666666666664,38,30,>,8,51,53,<,-2,120,278,<,-158
157,15,41.333333333333336,22.333333333333332,>,19.000000000000004,0,0,=,0,80,35,>,45,38.333333333333336,46.0,<,-7.666666666666664,30,38,<,-8,53,51,>,2,278,120,>,158
0,15,22.333333333333332,33.666666666666664,<,-11.333333333333332,0,0,=,0,35,73,<,-38,46.0,37.0,>,9.0,38,33,>,5,51,41,>,10,120,231,<,-111
125,15,33.666666666666664,22.333333333333332,>,11.333333333333332,0,0,=,0,73,35,>,38,37.0,46.0,<,-9.0,33,38,<,-5,41,51,<,-10,231,120,>,111
0,15,22.333333333333332,27.666666666666668,<,-5.333333333333336,0,0,=,0,35,65,<,-30,46.0,49.0,<,-3.0,38,41,<,-3,51,60,<,-9,120,171,<,-51
0,15,27.666666666666668,22.333333333333332,>,5.333333333333336,0,0,=,0,65,35,>,30,49.0,46.0,>,3.0,41,38,>,3,60,51,>,9,171,120,>,51
0,15,22.333333333333332,18.333333333333332,>,4.0,0,0,=,0,35,40,<,-5,46.0,45.666666666666664,>,0.3333333333333357,38,44,<,-6,51,49,>,2,120,274,<,-154
181,15,18.333333333333332,22.333333333333332,<,-4.0,0,0,=,0,40,35,>,5,45.666666666666664,46.0,<,-0.3333333333333357,44,38,>,6,49,51,<,-2,274,120,>,154
0,14,41.666666666666664,32.333333333333336,>,9.333333333333329,14,14,=,0,81,65,>,16,50.333333333333336,49.0,>,1.3333333333333357,35,41,<,-6,58,60,<,-2,108,171,<,-63
0,14,32.333333333333336,41.666666666666664,<,-9.333333333333329,14,14,=,0,65,81,<,-16,49.0,50.333333333333336,<,-1.3333333333333357,41,35,>,6,60,58,>,2,171,108,>,63
0,14,41.666666666666664,35.0,>,6.666666666666664,14,21,<,-7,81,54,>,27,50.333333333333336,40.666666666666664,>,9.666666666666671,35,39,<,-4,58,43,>,15,108,150,<,-42
31,14,35.0,41.666666666666664,<,-6.666666666666664,21,14,>,7,54,81,<,-27,40.666666666666664,50.333333333333336,<,-9.666666666666671,39,35,>,4,43,58,<,-15,150,108,>,42
0,14,41.666666666666664,55.0,<,-13.333333333333336,14,28,<,-14,81,70,>,11,50.333333333333336,53.666666666666664,<,-3.3333333333333286,35,43,<,-8,58,60,<,-2,108,238,<,-130
110,14,55.0,41.666666666666664,>,13.333333333333336,28,14,>,14,70,81,<,-11,53.666666666666664,50.333333333333336,>,3.3333333333333286,43,35,>,8,60,58,>,2,238,108,>,130
0,14,41.666666666666664,22.0,>,19.666666666666664,14,16,<,-2,81,27,>,54,50.333333333333336,50.666666666666664,<,-0.3333333333333286,35,48,<,-13,58,54,>,4,108,243,<,-135
65,14,22.0,41.666666666666664,<,-19.666666666666664,16,14,>,2,27,81,<,-54,50.666666666666664,50.333333333333336,>,0.3333333333333286,48,35,>,13,54,58,<,-4,243,108,>,135
0,14,41.666666666666664,27.0,>,14.666666666666664,14,19,<,-5,81,37,>,44,50.333333333333336,48.666666666666664,>,1.6666666666666714,35,40,<,-5,58,57,>,1,108,128,<,-20
73,14,27.0,41.666666666666664,<,-14.666666666666664,19,14,>,5,37,81,<,-44,48.666666666666664,50.333333333333336,<,-1.6666666666666714,40,35,>,5,57,58,<,-1,128,108,>,20
0,14,41.666666666666664,42.333333333333336,<,-0.6666666666666714,14,20,<,-6,81,69,>,12,50.333333333333336,42.0,>,8.333333333333336,35,32,>,3,58,53,>,5,108,201,<,-93
99,14,42.333333333333336,41.666666666666664,>,0.6666666666666714,20,14,>,6,69,81,<,-12,42.0,50.333333333333336,<,-8.333333333333336,32,35,<,-3,53,58,<,-5,201,108,>,93
0,14,41.666666666666664,25.666666666666668,>,15.999999999999996,14,11,>,3,81,33,>,48,50.333333333333336,43.333333333333336,>,7.0,35,33,>,2,58,50,>,8,108,198,<,-90
0,14,25.666666666666668,41.666666666666664,<,-15.999999999999996,11,14,<,-3,33,81,<,-48,43.333333333333336,50.333333333333336,<,-7.0,33,35,<,-2,50,58,<,-8,198,108,>,90
0,14,41.666666666666664,45.666666666666664,<,-4.0,14,28,<,-14,81,73,>,8,50.333333333333336,37.0,>,13.333333333333336,35,33,>,2,58,41,>,17,108,231,<,-123
125,14,45.666666666666664,41.666666666666664,>,4.0,28,14,>,14,73,81,<,-8,37.0,50.333333333333336,<,-13.333333333333336,33,35,<,-2,41,58,<,-17,231,108,>,123
0,14,41.666666666666664,59.666666666666664,<,-18.0,14,28,<,-14,81,80,>,1,50.333333333333336,52.0,<,-1.6666666666666643,35,45,<,-10,58,56,>,2,108,125,<,-17
75,14,59.666666666666664,41.666666666666664,>,18.0,28,14,>,14,80,81,<,-1,52.0,50.333333333333336,>,1.6666666666666643,45,35,>,10,56,58,<,-2,125,108,>,17
0,14,41.666666666666664,46.666666666666664,<,-5.0,14,19,<,-5,81,71,>,10,50.333333333333336,40.0,>,10.333333333333336,35,35,=,0,58,43,>,15,108,228,<,-120
30,14,46.666666666666664,41.666666666666664,>,5.0,19,14,>,5,71,81,<,-10,40.0,50.333333333333336,<,-10.333333333333336,35,35,=,0,43,58,<,-15,228,108,>,120
0,14,41.666666666666664,59.666666666666664,<,-18.0,14,34,<,-20,81,89,<,-8,50.333333333333336,46.666666666666664,>,3.6666666666666714,35,38,<,-3,58,60,<,-2,108,209,<,-101
121,14,59.666666666666664,41.666666666666664,>,18.0,34,14,>,20,89,81,>,8,46.666666666666664,50.333333333333336,<,-3.6666666666666714,38,35,>,3,60,58,>,2,209,108,>,101
0,14,41.666666666666664,70.33333333333333,<,-28.666666666666664,14,44,<,-30,81,87,<,-6,50.333333333333336,38.333333333333336,>,12.0,35,30,>,5,58,53,>,5,108,278,<,-170
281,14,70.33333333333333,41.666666666666664,>,28.666666666666664,44,14,>,30,87,81,>,6,38.333333333333336,50.333333333333336,<,-12.0,30,35,<,-5,53,58,<,-5,278,108,>,170
0,14,41.666666666666664,31.0,>,10.666666666666664,14,15,<,-1,81,40,>,41,50.333333333333336,45.666666666666664,>,4.666666666666671,35,44,<,-9,58,49,>,9,108,274,<,-166
180,14,31.0,41.666666666666664,<,-10.666666666666664,15,14,>,1,40,81,<,-41,45.666666666666664,50.333333333333336,<,-4.666666666666671,44,35,>,9,49,58,<,-9,274,108,>,166
0,13,40.333333333333336,27.333333333333332,>,13.000000000000004,11,14,<,-3,77,50,>,27,43.333333333333336,49.0,<,-5.666666666666664,33,41,<,-8,50,60,<,-10,198,171,>,27
0,13,27.333333333333332,40.333333333333336,<,-13.000000000000004,14,11,>,3,50,77,<,-27,49.0,43.333333333333336,>,5.666666666666664,41,33,>,8,60,50,>,10,171,198,<,-27
0,13,40.333333333333336,35.0,>,5.333333333333336,11,15,<,-4,77,71,>,6,43.333333333333336,40.0,>,3.3333333333333357,33,35,<,-2,50,43,>,7,198,228,<,-30
30,13,35.0,40.333333333333336,<,-5.333333333333336,15,11,>,4,71,77,<,-6,40.0,43.333333333333336,<,-3.3333333333333357,35,33,>,2,43,50,<,-7,228,198,>,30
0,13,40.333333333333336,24.333333333333332,>,16.000000000000004,11,21,<,-10,77,30,>,47,43.333333333333336,40.666666666666664,>,2.6666666666666714,33,39,<,-6,50,43,>,7,198,150,>,48
31,13,24.333333333333332,40.333333333333336,<,-16.000000000000004,21,11,>,10,30,77,<,-47,40.666666666666664,43.333333333333336,<,-2.6666666666666714,39,33,>,6,43,50,<,-7,150,198,<,-48
0,13,40.333333333333336,20.333333333333332,>,20.000000000000004,11,11,=,0,77,27,>,50,43.333333333333336,50.666666666666664,<,-7.333333333333329,33,48,<,-15,50,54,<,-4,198,243,<,-45
65,13,20.333333333333332,40.333333333333336,<,-20.000000000000004,11,11,=,0,27,77,<,-50,50.666666666666664,43.333333333333336,>,7.333333333333329,48,33,>,15,54,50,>,4,243,198,>,45
0,13,40.333333333333336,46.666666666666664,<,-6.333333333333329,11,25,<,-14,77,78,<,-1,43.333333333333336,48.666666666666664,<,-5.333333333333329,33,40,<,-7,50,57,<,-7,198,128,>,70
73,13,46.666666666666664,40.333333333333336,>,6.333333333333329,25,11,>,14,78,77,>,1,48.666666666666664,43.333333333333336,>,5.333333333333329,40,33,>,7,57,50,>,7,128,198,<,-70
0,13,40.333333333333336,39.333333333333336,>,1.0,11,10,>,1,77,80,<,-3,43.333333333333336,52.0,<,-8.666666666666664,33,45,<,-12,50,56,<,-6,198,125,>,73
0,13,39.333333333333336,40.333333333333336,<,-1.0,10,11,<,-1,80,77,>,3,52.0,43.333333333333336,>,8.666666666666664,45,33,>,12,56,50,>,6,125,198,<,-73
0,13,40.333333333333336,47.0,<,-6.666666666666664,11,20,<,-9,77,83,<,-6,43.333333333333336,42.0,>,1.3333333333333357,33,32,>,1,50,53,<,-3,198,201,<,-3
99,13,47.0,40.333333333333336,>,6.666666666666664,20,11,>,9,83,77,>,6,42.0,43.333333333333336,<,-1.3333333333333357,32,33,<,-1,53,50,>,3,201,198,>,3
0,13,40.333333333333336,53.333333333333336,<,-13.0,11,28,<,-17,77,67,>,10,43.333333333333336,53.666666666666664,<,-10.333333333333329,33,43,<,-10,50,60,<,-10,198,238,<,-40
110,13,53.333333333333336,40.333333333333336,>,13.0,28,11,>,17,67,77,<,-10,53.666666666666664,43.333333333333336,>,10.333333333333329,43,33,>,10,60,50,>,10,238,198,>,40
0,13,40.333333333333336,39.333333333333336,>,1.0,11,28,<,-17,77,56,>,21,43.333333333333336,46.666666666666664,<,-3.3333333333333286,33,38,<,-5,50,60,<,-10,198,209,<,-11
121,13,39.333333333333336,40.333333333333336,<,-1.0,28,11,>,17,56,77,<,-21,46.666666666666664,43.333333333333336,>,3.3333333333333286,38,33,>,5,60,50,>,10,209,198,>,11
0,13,40.333333333333336,41.666666666666664,<,-1.3333333333333286,11,28,<,-17,77,61,>,16,43.333333333333336,37.0,>,6.333333333333336,33,33,=,0,50,41,>,9,198,231,<,-33
125,13,41.666666666666664,40.333333333333336,>,1.3333333333333286,28,11,>,17,61,77,<,-16,37.0,43.333333333333336,<,-6.333333333333336,33,33,=,0,41,50,<,-9,231,198,>,33
0,13,40.333333333333336,32.666666666666664,>,7.666666666666671,11,15,<,-4,77,45,>,32,43.333333333333336,45.666666666666664,<,-2.3333333333333286,33,44,<,-11,50,49,>,1,198,274,<,-76
180,13,32.666666666666664,40.333333333333336,<,-7.666666666666671,15,11,>,4,45,77,<,-32,45.666666666666664,43.333333333333336,>,2.3333333333333286,44,33,>,11,49,50,<,-1,274,198,>,76
0,13,40.333333333333336,61.333333333333336,<,-21.0,11,17,<,-6,77,87,<,-10,43.333333333333336,38.333333333333336,>,5.0,33,30,>,3,50,53,<,-3,198,278,<,-80
114,13,61.333333333333336,40.333333333333336,>,21.0,17,11,>,6,87,77,>,10,38.333333333333336,43.333333333333336,<,-5.0,30,33,<,-3,53,50,>,3,278,198,>,80
0,12,47.333333333333336,43.333333333333336,>,4.0,10,18,<,-8,80,62,>,18,52.0,49.0,>,3.0,45,41,>,4,56,60,<,-4,125,171,<,-46
0,12,43.333333333333336,47.333333333333336,<,-4.0,18,10,>,8,62,80,<,-18,49.0,52.0,<,-3.0,41,45,<,-4,60,56,>,4,171,125,>,46
0,12,47.333333333333336,55.333333333333336,<,-8.0,10,15,<,-5,80,80,=,0,52.0,40.0,>,12.0,45,35,>,10,56,43,>,13,125,228,<,-103
123,12,55.333333333333336,47.333333333333336,>,8.0,15,10,>,5,80,80,=,0,40.0,52.0,<,-12.0,35,45,<,-10,43,56,<,-13,228,125,>,103
0,12,47.333333333333336,24.333333333333332,>,23.000000000000004,10,21,<,-11,80,30,>,50,52.0,40.666666666666664,>,11.333333333333336,45,39,>,6,56,43,>,13,125,150,<,-25
15,12,24.333333333333332,47.333333333333336,<,-23.000000000000004,21,10,>,11,30,80,<,-50,40.666666666666664,52.0,<,-11.333333333333336,39,45,<,-6,43,56,<,-13,150,125,>,25
0,12,47.333333333333336,38.666666666666664,>,8.666666666666671,10,11,<,-1,80,82,<,-2,52.0,50.666666666666664,>,1.3333333333333357,45,48,<,-3,56,54,>,2,125,243,<,-118
133,12,38.666666666666664,47.333333333333336,<,-8.666666666666671,11,10,>,1,82,80,>,2,50.666666666666664,52.0,<,-1.3333333333333357,48,45,>,3,54,56,<,-2,243,125,>,118
0,12,47.333333333333336,52.666666666666664,<,-5.333333333333329,10,25,<,-15,80,78,>,2,52.0,48.666666666666664,>,3.3333333333333357,45,40,>,5,56,57,<,-1,125,128,<,-3
85,12,52.666666666666664,47.333333333333336,>,5.333333333333329,25,10,>,15,78,80,<,-2,48.666666666666664,52.0,<,-3.3333333333333357,40,45,<,-5,57,56,>,1,128,125,>,3
0,12,47.333333333333336,64.33333333333333,<,-16.999999999999993,10,20,<,-10,80,90,<,-10,52.0,42.0,>,10.0,45,32,>,13,56,53,>,3,125,201,<,-76
118,12,64.33333333333333,47.333333333333336,>,16.999999999999993,20,10,>,10,90,80,>,10,42.0,52.0,<,-10.0,32,45,<,-13,53,56,<,-3,201,125,>,76
0,12,47.333333333333336,65.0,<,-17.666666666666664,10,63,<,-53,80,67,>,13,52.0,53.666666666666664,<,-1.6666666666666643,45,43,>,2,56,60,<,-4,125,238,<,-113
163,12,65.0,47.333333333333336,>,17.666666666666664,63,10,>,53,67,80,<,-13,53.666666666666664,52.0,>,1.6666666666666643,43,45,<,-2,60,56,>,4,238,125,>,113
0,12,47.333333333333336,43.0,>,4.333333333333336,10,17,<,-7,80,80,=,0,52.0,38.333333333333336,>,13.666666666666664,45,30,>,15,56,53,>,3,125,278,<,-153
171,12,43.0,47.333333333333336,<,-4.333333333333336,17,10,>,7,80,80,=,0,38.333333333333336,52.0,<,-13.666666666666664,30,45,<,-15,53,56,<,-3,278,125,>,153
0,12,47.333333333333336,32.666666666666664,>,14.666666666666671,10,14,<,-4,80,56,>,24,52.0,46.666666666666664,>,5.333333333333336,45,38,>,7,56,60,<,-4,125,209,<,-84
0,12,32.666666666666664,47.333333333333336,<,-14.666666666666671,14,10,>,4,56,80,<,-24,46.666666666666664,52.0,<,-5.333333333333336,38,45,<,-7,60,56,>,4,209,125,>,84
0,12,47.333333333333336,59.333333333333336,<,-12.0,10,28,<,-18,80,89,<,-9,52.0,37.0,>,15.0,45,33,>,12,56,41,>,15,125,231,<,-106
143,12,59.333333333333336,47.333333333333336,>,12.0,28,10,>,18,89,80,>,9,37.0,52.0,<,-15.0,33,45,<,-12,41,56,<,-15,231,125,>,106
0,12,47.333333333333336,46.0,>,1.3333333333333357,10,15,<,-5,80,78,>,2,52.0,45.666666666666664,>,6.333333333333336,45,44,>,1,56,49,>,7,125,274,<,-149
204,12,46.0,47.333333333333336,<,-1.3333333333333357,15,10,>,5,78,80,<,-2,45.666666666666664,52.0,<,-6.333333333333336,44,45,<,-1,49,56,<,-7,274,125,>,149
0,11,33.0,39.666666666666664,<,-6.666666666666664,14,18,<,-4,56,62,<,-6,46.666666666666664,49.0,<,-2.3333333333333357,38,41,<,-3,60,60,=,0,209,171,>,38
0,11,39.666666666666664,33.0,>,6.666666666666664,18,14,>,4,62,56,>,6,49.0,46.666666666666664,>,2.3333333333333357,41,38,>,3,60,60,=,0,171,209,<,-38
0,11,33.0,41.333333333333336,<,-8.333333333333336,14,21,<,-7,56,73,<,-17,46.666666666666664,40.666666666666664,>,6.0,38,39,<,-1,60,43,>,17,209,150,>,59
15,11,41.333333333333336,33.0,>,8.333333333333336,21,14,>,7,73,56,>,17,40.666666666666664,46.666666666666664,<,-6.0,39,38,>,1,43,60,<,-17,150,209,<,-59
0,11,33.0,34.333333333333336,<,-1.3333333333333357,14,23,<,-9,56,55,>,1,46.666666666666664,48.666666666666664,<,-2.0,38,40,<,-2,60,57,>,3,209,128,>,81
85,11,34.333333333333336,33.0,>,1.3333333333333357,23,14,>,9,55,56,<,-1,48.666666666666664,46.666666666666664,>,2.0,40,38,>,2,57,60,<,-3,128,209,<,-81
0,11,33.0,43.333333333333336,<,-10.333333333333336,14,20,<,-6,56,90,<,-34,46.666666666666664,42.0,>,4.666666666666664,38,32,>,6,60,53,>,7,209,201,>,8
0,11,43.333333333333336,33.0,>,10.333333333333336,20,14,>,6,90,56,>,34,42.0,46.666666666666664,<,-4.666666666666664,32,38,<,-6,53,60,<,-7,201,209,<,-8
0,11,33.0,79.33333333333333,<,-46.33333333333333,14,71,<,-57,56,87,<,-31,46.666666666666664,40.0,>,6.666666666666664,38,35,>,3,60,43,>,17,209,228,<,-19
171,11,79.33333333333333,33.0,>,46.33333333333333,71,14,>,57,87,56,>,31,40.0,46.666666666666664,<,-6.666666666666664,35,38,<,-3,43,60,<,-17,228,209,>,19
0,11,33.0,59.333333333333336,<,-26.333333333333336,14,23,<,-9,56,82,<,-26,46.666666666666664,50.666666666666664,<,-4.0,38,48,<,-10,60,54,>,6,209,243,<,-34
138,11,59.333333333333336,33.0,>,26.333333333333336,23,14,>,9,82,56,>,26,50.666666666666664,46.666666666666664,>,4.0,48,38,>,10,54,60,<,-6,243,209,>,34
0,11,33.0,61.0,<,-28.0,14,28,<,-14,56,89,<,-33,46.666666666666664,37.0,>,9.666666666666664,38,33,>,5,60,41,>,19,209,231,<,-22
143,11,61.0,33.0,>,28.0,28,14,>,14,89,56,>,33,37.0,46.666666666666664,<,-9.666666666666664,33,38,<,-5,41,60,<,-19,231,209,>,22
0,11,33.0,50.333333333333336,<,-17.333333333333336,14,21,<,-7,56,67,<,-11,46.666666666666664,53.666666666666664,<,-7.0,38,43,<,-5,60,60,=,0,209,238,<,-29
40,11,50.333333333333336,33.0,>,17.333333333333336,21,14,>,7,67,56,>,11,53.666666666666664,46.666666666666664,>,7.0,43,38,>,5,60,60,=,0,238,209,>,29
0,11,33.0,51.666666666666664,<,-18.666666666666664,14,32,<,-18,56,80,<,-24,46.666666666666664,38.333333333333336,>,8.333333333333329,38,30,>,8,60,53,>,7,209,278,<,-69
120,11,51.666666666666664,33.0,>,18.666666666666664,32,14,>,18,80,56,>,24,38.333333333333336,46.666666666666664,<,-8.333333333333329,30,38,<,-8,53,60,<,-7,278,209,>,69
0,11,33.0,56.0,<,-23.0,14,15,<,-1,56,78,<,-22,46.666666666666664,45.666666666666664,>,1.0,38,44,<,-6,60,49,>,11,209,274,<,-65
179,11,56.0,33.0,>,23.0,15,14,>,1,78,56,>,22,45.666666666666664,46.666666666666664,<,-1.0,44,38,>,6,49,60,<,-11,274,209,>,65
0,10,25.666666666666668,45.0,<,-19.333333333333332,20,18,>,2,37,78,<,-41,42.0,49.0,<,-7.0,32,41,<,-9,53,60,<,-7,201,171,>,30
0,10,45.0,25.666666666666668,>,19.333333333333332,18,20,<,-2,78,37,>,41,49.0,42.0,>,7.0,41,32,>,9,60,53,>,7,171,201,<,-30
0,10,25.666666666666668,51.0,<,-25.333333333333332,20,21,<,-1,37,73,<,-36,42.0,40.666666666666664,>,1.3333333333333357,32,39,<,-7,53,43,>,10,201,150,>,51
77,10,51.0,25.666666666666668,>,25.333333333333332,21,20,>,1,73,37,>,36,40.666666666666664,42.0,<,-1.3333333333333357,39,32,>,7,43,53,<,-10,150,201,<,-51
0,10,25.666666666666668,59.0,<,-33.33333333333333,20,21,<,-1,37,89,<,-52,42.0,53.666666666666664,<,-11.666666666666664,32,43,<,-11,53,60,<,-7,201,238,<,-37
40,10,59.0,25.666666666666668,>,33.33333333333333,21,20,>,1,89,37,>,52,53.666666666666664,42.0,>,11.666666666666664,43,32,>,11,60,53,>,7,238,201,>,37
0,10,25.666666666666668,30.0,<,-4.333333333333332,20,23,<,-3,37,42,<,-5,42.0,48.666666666666664,<,-6.666666666666664,32,40,<,-8,53,57,<,-4,201,128,>,73
85,10,30.0,25.666666666666668,>,4.333333333333332,23,20,>,3,42,37,>,5,48.666666666666664,42.0,>,6.666666666666664,40,32,>,8,57,53,>,4,128,201,<,-73
0,10,25.666666666666668,65.0,<,-39.33333333333333,20,43,<,-23,37,80,<,-43,42.0,38.333333333333336,>,3.6666666666666643,32,30,>,2,53,53,=,0,201,278,<,-77
120,10,65.0,25.666666666666668,>,39.33333333333333,43,20,>,23,80,37,>,43,38.333333333333336,42.0,<,-3.6666666666666643,30,32,<,-2,53,53,=,0,278,201,>,77
0,10,25.666666666666668,52.0,<,-26.333333333333332,20,23,<,-3,37,73,<,-36,42.0,50.666666666666664,<,-8.666666666666664,32,48,<,-16,53,54,<,-1,201,243,<,-42
122,10,52.0,25.666666666666668,>,26.333333333333332,23,20,>,3,73,37,>,36,50.666666666666664,42.0,>,8.666666666666664,48,32,>,16,54,53,>,1,243,201,>,42
0,10,25.666666666666668,51.0,<,-25.333333333333332,20,28,<,-8,37,66,<,-29,42.0,37.0,>,5.0,32,33,<,-1,53,41,>,12,201,231,<,-30
141,10,51.0,25.666666666666668,>,25.333333333333332,28,20,>,8,66,37,>,29,37.0,42.0,<,-5.0,33,32,>,1,41,53,<,-12,231,201,>,30
0,10,25.666666666666668,56.333333333333336,<,-30.666666666666668,20,11,>,9,37,87,<,-50,42.0,40.0,>,2.0,32,35,<,-3,53,43,>,10,201,228,<,-27
0,10,56.333333333333336,25.666666666666668,>,30.666666666666668,11,20,<,-9,87,37,>,50,40.0,42.0,<,-2.0,35,32,>,3,43,53,<,-10,228,201,>,27
0,10,25.666666666666668,45.666666666666664,<,-19.999999999999996,20,15,>,5,37,75,<,-38,42.0,45.666666666666664,<,-3.6666666666666643,32,44,<,-12,53,49,>,4,201,274,<,-73
103,10,45.666666666666664,25.666666666666668,>,19.999999999999996,15,20,<,-5,75,37,>,38,45.666666666666664,42.0,>,3.6666666666666643,44,32,>,12,49,53,<,-4,274,201,>,73
0,9,48.333333333333336,40.333333333333336,>,8.0,11,18,<,-7,71,78,<,-7,40.0,49.0,<,-9.0,35,41,<,-6,43,60,<,-17,228,171,>,57
0,9,40.333333333333336,48.333333333333336,<,-8.0,18,11,>,7,78,71,>,7,49.0,40.0,>,9.0,41,35,>,6,60,43,>,17,171,228,<,-57
0,9,48.333333333333336,76.0,<,-27.666666666666664,11,67,<,-56,71,89,<,-18,40.0,53.666666666666664,<,-13.666666666666664,35,43,<,-8,43,60,<,-17,228,238,<,-10
89,9,76.0,48.333333333333336,>,27.666666666666664,67,11,>,56,89,71,>,18,53.666666666666664,40.0,>,13.666666666666664,43,35,>,8,60,43,>,17,238,228,>,10
0,9,48.333333333333336,49.0,<,-0.6666666666666643,11,21,<,-10,71,67,>,4,40.0,40.666666666666664,<,-0.6666666666666643,35,39,<,-4,43,43,=,0,228,150,>,78
77,9,49.0,48.333333333333336,>,0.6666666666666643,21,11,>,10,67,71,<,-4,40.666666666666664,40.0,>,0.6666666666666643,39,35,>,4,43,43,=,0,150,228,<,-78
0,9,48.333333333333336,35.0,>,13.333333333333336,11,25,<,-14,71,42,>,29,40.0,48.666666666666664,<,-8.666666666666664,35,40,<,-5,43,57,<,-14,228,128,>,100
85,9,35.0,48.333333333333336,<,-13.333333333333336,25,11,>,14,42,71,<,-29,48.666666666666664,40.0,>,8.666666666666664,40,35,>,5,57,43,>,14,128,228,<,-100
0,9,48.333333333333336,42.0,>,6.333333333333336,11,15,<,-4,71,64,>,7,40.0,45.666666666666664,<,-5.666666666666664,35,44,<,-9,43,49,<,-6,228,274,<,-46
76,9,42.0,48.333333333333336,<,-6.333333333333336,15,11,>,4,64,71,<,-7,45.666666666666664,40.0,>,5.666666666666664,44,35,>,9,49,43,>,6,274,228,>,46
0,9,48.333333333333336,58.666666666666664,<,-10.333333333333329,11,24,<,-13,71,80,<,-9,40.0,38.333333333333336,>,1.6666666666666643,35,30,>,5,43,53,<,-10,228,278,<,-50
0,9,58.666666666666664,48.333333333333336,>,10.333333333333329,24,11,>,13,80,71,>,9,38.333333333333336,40.0,<,-1.6666666666666643,30,35,<,-5,53,43,>,10,278,228,>,50
0,9,48.333333333333336,48.666666666666664,<,-0.3333333333333286,11,23,<,-12,71,63,>,8,40.0,50.666666666666664,<,-10.666666666666664,35,48,<,-13,43,54,<,-11,228,243,<,-15
121,9,48.666666666666664,48.333333333333336,>,0.3333333333333286,23,11,>,12,63,71,<,-8,50.666666666666664,40.0,>,10.666666666666664,48,35,>,13,54,43,>,11,243,228,>,15
0,9,48.333333333333336,45.666666666666664,>,2.6666666666666714,11,28,<,-17,71,59,>,12,40.0,37.0,>,3.0,35,33,>,2,43,41,>,2,228,231,<,-3
141,9,45.666666666666664,48.333333333333336,<,-2.6666666666666714,28,11,>,17,59,71,<,-12,37.0,40.0,<,-3.0,33,35,<,-2,41,43,<,-2,231,228,>,3
0,8,54.666666666666664,44.0,>,10.666666666666664,24,18,>,6,80,89,<,-9,38.333333333333336,49.0,<,-10.666666666666664,30,41,<,-11,53,60,<,-7,278,171,>,107
0,8,44.0,54.666666666666664,<,-10.666666666666664,18,24,<,-6,89,80,>,9,49.0,38.333333333333336,>,10.666666666666664,41,30,>,11,60,53,>,7,171,278,<,-107
0,8,54.666666666666664,53.666666666666664,>,1.0,24,15,>,9,80,82,<,-2,38.333333333333336,45.666666666666664,<,-7.333333333333329,30,44,<,-14,53,49,>,4,278,274,>,4
76,8,53.666666666666664,54.666666666666664,<,-1.0,15,24,<,-9,82,80,>,2,45.666666666666664,38.333333333333336,>,7.333333333333329,44,30,>,14,49,53,<,-4,274,278,<,-4
0,8,54.666666666666664,36.666666666666664,>,18.0,24,21,>,3,80,67,>,13,38.333333333333336,40.666666666666664,<,-2.3333333333333286,30,39,<,-9,53,43,>,10,278,150,>,128
0,8,36.666666666666664,54.666666666666664,<,-18.0,21,24,<,-3,67,80,<,-13,40.666666666666664,38.333333333333336,>,2.3333333333333286,39,30,>,9,43,53,<,-10,150,278,<,-128
0,8,54.666666666666664,47.0,>,7.666666666666664,24,25,<,-1,80,78,>,2,38.333333333333336,48.666666666666664,<,-10.333333333333329,30,40,<,-10,53,57,<,-4,278,128,>,150
85,8,47.0,54.666666666666664,<,-7.666666666666664,25,24,>,1,78,80,<,-2,48.666666666666664,38.333333333333336,>,10.333333333333329,40,30,>,10,57,53,>,4,128,278,<,-150
0,8,54.666666666666664,73.0,<,-18.333333333333336,24,67,<,-43,80,80,=,0,38.333333333333336,53.666666666666664,<,-15.333333333333329,30,43,<,-13,53,60,<,-7,278,238,>,40
60,8,73.0,54.666666666666664,>,18.333333333333336,67,24,>,43,80,80,=,0,53.666666666666664,38.333333333333336,>,15.333333333333329,43,30,>,13,60,53,>,7,238,278,<,-40
0,8,54.666666666666664,48.666666666666664,>,6.0,24,23,>,1,80,63,>,17,38.333333333333336,50.666666666666664,<,-12.333333333333329,30,48,<,-18,53,54,<,-1,278,243,>,35
42,8,48.666666666666664,54.666666666666664,<,-6.0,23,24,<,-1,63,80,<,-17,50.666666666666664,38.333333333333336,>,12.333333333333329,48,30,>,18,54,53,>,1,243,278,<,-35
0,8,54.666666666666664,30.0,>,24.666666666666664,24,12,>,12,80,50,>,30,38.333333333333336,37.0,>,1.3333333333333357,30,33,<,-3,53,41,>,12,278,231,>,47
43,8,30.0,54.666666666666664,<,-24.666666666666664,12,24,<,-12,50,80,<,-30,37.0,38.333333333333336,<,-1.3333333333333357,33,30,>,3,41,53,<,-12,231,278,<,-47
0,7,21.333333333333332,63.333333333333336,<,-42.0,21,18,>,3,22,89,<,-67,40.666666666666664,49.0,<,-8.333333333333336,39,41,<,-2,43,60,<,-17,150,171,<,-21
0,7,63.333333333333336,21.333333333333332,>,42.0,18,21,<,-3,89,22,>,67,49.0,40.666666666666664,>,8.333333333333336,41,39,>,2,60,43,>,17,171,150,>,21
0,7,21.333333333333332,53.0,<,-31.666666666666668,21,23,<,-2,22,76,<,-54,40.666666666666664,50.666666666666664,<,-10.0,39,48,<,-9,43,54,<,-11,150,243,<,-93
42,7,53.0,21.333333333333332,>,31.666666666666668,23,21,>,2,76,22,>,54,50.666666666666664,40.666666666666664,>,10.0,48,39,>,9,54,43,>,11,243,150,>,93
0,7,21.333333333333332,21.666666666666668,<,-0.3333333333333357,21,12,>,9,22,28,<,-6,40.666666666666664,37.0,>,3.6666666666666643,39,33,>,6,43,41,>,2,150,231,<,-81
43,7,21.666666666666668,21.333333333333332,>,0.3333333333333357,12,21,<,-9,28,22,>,6,37.0,40.666666666666664,<,-3.6666666666666643,33,39,<,-6,41,43,<,-2,231,150,>,81
0,7,21.333333333333332,76.33333333333333,<,-55.0,21,67,<,-46,22,82,<,-60,40.666666666666664,53.666666666666664,<,-13.0,39,43,<,-4,43,60,<,-17,150,238,<,-88
54,7,76.33333333333333,21.333333333333332,>,55.0,67,21,>,46,82,22,>,60,53.666666666666664,40.666666666666664,>,13.0,43,39,>,4,60,43,>,17,238,150,>,88
0,7,21.333333333333332,39.0,<,-17.666666666666668,21,15,>,6,22,82,<,-60,40.666666666666664,45.666666666666664,<,-5.0,39,44,<,-5,43,49,<,-6,150,274,<,-124
0,7,39.0,21.333333333333332,>,17.666666666666668,15,21,<,-6,82,22,>,60,45.666666666666664,40.666666666666664,>,5.0,44,39,>,5,49,43,>,6,274,150,>,124
0,7,21.333333333333332,45.666666666666664,<,-24.333333333333332,21,25,<,-4,22,78,<,-56,40.666666666666664,48.666666666666664,<,-8.0,39,40,<,-1,43,57,<,-14,150,128,>,22
85,7,45.666666666666664,21.333333333333332,>,24.333333333333332,25,21,>,4,78,22,>,56,48.666666666666664,40.666666666666664,>,8.0,40,39,>,1,57,43,>,14,128,150,<,-22
0,6,23.333333333333332,48.0,<,-24.666666666666668,15,18,<,-3,35,83,<,-48,45.666666666666664,49.0,<,-3.3333333333333357,44,41,>,3,49,60,<,-11,274,171,>,103
0,6,48.0,23.333333333333332,>,24.666666666666668,18,15,>,3,83,35,>,48,49.0,45.666666666666664,>,3.3333333333333357,41,44,<,-3,60,49,>,11,171,274,<,-103
0,6,23.333333333333332,59.333333333333336,<,-36.0,15,23,<,-8,35,79,<,-44,45.666666666666664,50.666666666666664,<,-5.0,44,48,<,-4,49,54,<,-5,274,243,>,31
65,6,59.333333333333336,23.333333333333332,>,36.0,23,15,>,8,79,35,>,44,50.666666666666664,45.666666666666664,>,5.0,48,44,>,4,54,49,>,5,243,274,<,-31
0,6,23.333333333333332,31.333333333333332,<,-8.0,15,25,<,-10,35,41,<,-6,45.666666666666664,37.0,>,8.666666666666664,44,33,>,11,49,41,>,8,274,231,>,43
100,6,31.333333333333332,23.333333333333332,>,8.0,25,15,>,10,41,35,>,6,37.0,45.666666666666664,<,-8.666666666666664,33,44,<,-11,41,49,<,-8,231,274,<,-43
0,6,23.333333333333332,58.333333333333336,<,-35.0,15,26,<,-11,35,82,<,-47,45.666666666666664,53.666666666666664,<,-8.0,44,43,>,1,49,60,<,-11,274,238,>,36
0,6,58.333333333333336,23.333333333333332,>,35.0,26,15,>,11,82,35,>,47,53.666666666666664,45.666666666666664,>,8.0,43,44,<,-1,60,49,>,11,238,274,<,-36
0,6,23.333333333333332,35.333333333333336,<,-12.000000000000004,15,25,<,-10,35,47,<,-12,45.666666666666664,48.666666666666664,<,-3.0,44,40,>,4,49,57,<,-8,274,128,>,146
85,6,35.333333333333336,23.333333333333332,>,12.000000000000004,25,15,>,10,47,35,>,12,48.666666666666664,45.666666666666664,>,3.0,40,44,<,-4,57,49,>,8,128,274,<,-146
0,5,44.333333333333336,49.333333333333336,<,-5.0,26,18,>,8,67,87,<,-20,53.666666666666664,49.0,>,4.666666666666664,43,41,>,2,60,60,=,0,238,171,>,67
0,5,49.333333333333336,44.333333333333336,>,5.0,18,26,<,-8,87,67,>,20,49.0,53.666666666666664,<,-4.666666666666664,41,43,<,-2,60,60,=,0,171,238,<,-67
0,5,44.333333333333336,39.0,>,5.333333333333336,26,15,>,11,67,79,<,-12,53.666666666666664,50.666666666666664,>,3.0,43,48,<,-5,60,54,>,6,238,243,<,-5
32,5,39.0,44.333333333333336,<,-5.333333333333336,15,26,<,-11,79,67,>,12,50.666666666666664,53.666666666666664,<,-3.0,48,43,>,5,54,60,<,-6,243,238,>,5
0,5,44.333333333333336,27.333333333333332,>,17.000000000000004,26,10,>,16,67,47,>,20,53.666666666666664,48.666666666666664,>,5.0,43,40,>,3,60,57,>,3,238,128,>,110
85,5,27.333333333333332,44.333333333333336,<,-17.000000000000004,10,26,<,-16,47,67,<,-20,48.666666666666664,53.666666666666664,<,-5.0,40,43,<,-3,57,60,<,-3,128,238,<,-110
0,5,44.333333333333336,27.666666666666668,>,16.666666666666668,26,14,>,12,67,41,>,26,53.666666666666664,37.0,>,16.666666666666664,43,33,>,10,60,41,>,19,238,231,>,7
105,5,27.666666666666668,44.333333333333336,<,-16.666666666666668,14,26,<,-12,41,67,<,-26,37.0,53.666666666666664,<,-16.666666666666664,33,43,<,-10,41,60,<,-19,231,238,<,-7
0,4,38.666666666666664,20.666666666666668,>,17.999999999999996,11,15,<,-4,87,24,>,63,49.0,50.666666666666664,<,-1.6666666666666643,41,48,<,-7,60,54,>,6,171,243,<,-72
48,4,20.666666666666668,38.666666666666664,<,-17.999999999999996,15,11,>,4,24,87,<,-63,50.666666666666664,49.0,>,1.6666666666666643,48,41,>,7,54,60,<,-6,243,171,>,72
0,4,38.666666666666664,37.0,>,1.6666666666666643,11,10,>,1,87,76,>,11,49.0,48.666666666666664,>,0.3333333333333357,41,40,>,1,60,57,>,3,171,128,>,43
85,4,37.0,38.666666666666664,<,-1.6666666666666643,10,11,<,-1,76,87,<,-11,48.666666666666664,49.0,<,-0.3333333333333357,40,41,<,-1,57,60,<,-3,128,171,<,-43
0,4,38.666666666666664,19.0,>,19.666666666666664,11,14,<,-3,87,28,>,59,49.0,37.0,>,12.0,41,33,>,8,60,41,>,19,171,231,<,-60
105,4,19.0,38.666666666666664,<,-19.666666666666664,14,11,>,3,28,87,<,-59,37.0,49.0,<,-12.0,33,41,<,-8,41,60,<,-19,231,171,>,60
0,3,32.333333333333336,23.333333333333332,>,9.000000000000004,10,15,<,-5,76,31,>,45,48.666666666666664,50.666666666666664,<,-2.0,40,48,<,-8,57,54,>,3,128,243,<,-115
48,3,23.333333333333332,32.333333333333336,<,-9.000000000000004,15,10,>,5,31,76,<,-45,50.666666666666664,48.666666666666664,>,2.0,48,40,>,8,54,57,<,-3,243,128,>,115
0,3,32.333333333333336,20.0,>,12.333333333333336,10,14,<,-4,76,31,>,45,48.666666666666664,37.0,>,11.666666666666664,40,33,>,7,57,41,>,16,128,231,<,-103
84,3,20.0,32.333333333333336,<,-12.333333333333336,14,10,>,4,31,76,<,-45,37.0,48.666666666666664,<,-11.666666666666664,33,40,<,-7,41,57,<,-16,231,128,>,103
0,2,13.333333333333334,36.0,<,-22.666666666666664,11,15,<,-4,15,69,<,-54,37.0,50.666666666666664,<,-13.666666666666664,33,48,<,-15,41,54,<,-13,231,243,<,-12
48,2,36.0,13.333333333333334,>,22.666666666666664,15,11,>,4,69,15,>,54,50.666666666666664,37.0,>,13.666666666666664,48,33,>,15,54,41,>,13,243,231,>,12
