Regret,NumWaitingJob,STime_A_Avg,STime_B_Avg,STime_A_VS_B_Avg,STime_A_VS_B_Avg_Diff,STime_A_Min,STime_B_Min,STime_A_VS_B_Min,STime_A_VS_B_Min_Diff,STime_A_Max,STime_B_Max,STime_A_VS_B_Max,STime_A_VS_B_Max_Diff,PTime_A_Avg,PTime_B_Avg,PTime_A_VS_B_Avg,PTime_A_VS_B_Avg_Diff,PTime_A_Min,PTime_B_Min,PTime_A_VS_B_Min,PTime_A_VS_B_Min_Diff,PTime_A_Max,PTime_B_Max,PTime_A_VS_B_Max,PTime_A_VS_B_Max_Diff,Due_A,Due_B,Due_A_VS_B,Due_A_VS_B_Diff
0,19,0.0,0.0,=,0.0,0,0,=,0,0,0,=,0,53.333333333333336,49.333333333333336,>,4.0,49,42,>,7,59,57,>,2,110,283,<,-173
65,19,0.0,0.0,=,0.0,0,0,=,0,0,0,=,0,49.333333333333336,53.333333333333336,<,-4.0,42,49,<,-7,57,59,<,-2,283,110,>,173
0,19,0.0,0.0,=,0.0,0,0,=,0,0,0,=,0,53.333333333333336,45.0,>,8.333333333333336,49,33,>,16,59,60,<,-1,110,173,<,-63
49,19,0.0,0.0,=,0.0,0,0,=,0,0,0,=,0,45.0,53.333333333333336,<,-8.333333333333336,33,49,<,-16,60,59,>,1,173,110,>,63
0,19,0.0,0.0,=,0.0,0,0,=,0,0,0,=,0,53.333333333333336,48.333333333333336,>,5.0,49,40,>,9,59,57,>,2,110,217,<,-107
63,19,0.0,0.0,=,0.0,0,0,=,0,0,0,=,0,48.333333333333336,53.333333333333336,<,-5.0,40,49,<,-9,57,59,<,-2,217,110,>,107
0,19,0.0,0.0,=,0.0,0,0,=,0,0,0,=,0,53.333333333333336,36.0,>,17.333333333333336,49,31,>,18,59,45,>,14,110,240,<,-130
51,19,0.0,0.0,=,0.0,0,0,=,0,0,0,=,0,36.0,53.333333333333336,<,-17.333333333333336,31,49,<,-18,45,59,<,-14,240,110,>,130
0,19,0.0,0.0,=,0.0,0,0,=,0,0,0,=,0,53.333333333333336,48.0,>,5.333333333333336,49,41,>,8,59,56,>,3,110,268,<,-158
36,19,0.0,0.0,=,0.0,0,0,=,0,0,0,=,0,48.0,53.333333333333336,<,-5.333333333333336,41,49,<,-8,56,59,<,-3,268,110,>,158
0,19,0.0,0.0,=,0.0,0,0,=,0,0,0,=,0,53.333333333333336,56.0,<,-2.6666666666666643,49,53,<,-4,59,60,<,-1,110,295,<,-185
119,19,0.0,0.0,=,0.0,0,0,=,0,0,0,=,0,56.0,53.333333333333336,>,2.6666666666666643,53,49,>,4,60,59,>,1,295,110,>,185
0,19,0.0,0.0,=,0.0,0,0,=,0,0,0,=,0,53.333333333333336,40.666666666666664,>,12.666666666666671,49,32,>,17,59,49,>,10,110,145,<,-35
65,19,0.0,0.0,=,0.0,0,0,=,0,0,0,=,0,40.666666666666664,53.333333333333336,<,-12.666666666666671,32,49,<,-17,49,59,<,-10,145,110,>,35
0,19,0.0,0.0,=,0.0,0,0,=,0,0,0,=,0,53.333333333333336,32.333333333333336,>,21.0,49,30,>,19,59,36,>,23,110,254,<,-144
31,19,0.0,0.0,=,0.0,0,0,=,0,0,0,=,0,32.333333333333336,53.333333333333336,<,-21.0,30,49,<,-19,36,59,<,-23,254,110,>,144
0,19,0.0,0.0,=,0.0,0,0,=,0,0,0,=,0,53.333333333333336,39.0,>,14.333333333333336,49,30,>,19,59,48,>,11,110,228,<,-118
33,19,0.0,0.0,=,0.0,0,0,=,0,0,0,=,0,39.0,53.333333333333336,<,-14.333333333333336,30,49,<,-19,48,59,<,-11,228,110,>,118
0,19,0.0,0.0,=,0.0,0,0,=,0,0,0,=,0,53.333333333333336,47.666666666666664,>,5.666666666666671,49,39,>,10,59,55,>,4,110,133,<,-23
5,19,0.0,0.0,=,0.0,0,0,=,0,0,0,=,0,47.666666666666664,53.333333333333336,<,-5.666666666666671,39,49,<,-10,55,59,<,-4,133,110,>,23
0,19,0.0,0.0,=,0.0,0,0,=,0,0,0,=,0,53.333333333333336,48.666666666666664,>,4.666666666666671,49,42,>,7,59,59,=,0,110,254,<,-144
48,19,0.0,0.0,=,0.0,0,0,=,0,0,0,=,0,48.666666666666664,53.333333333333336,<,-4.666666666666671,42,49,<,-7,59,59,=,0,254,110,>,144
0,19,0.0,0.0,=,0.0,0,0,=,0,0,0,=,0,53.333333333333336,47.333333333333336,>,6.0,49,42,>,7,59,52,>,7,110,155,<,-45
28,19,0.0,0.0,=,0.0,0,0,=,0,0,0,=,0,47.333333333333336,53.333333333333336,<,-6.0,42,49,<,-7,52,59,<,-7,155,110,>,45
0,19,0.0,0.0,=,0.0,0,0,=,0,0,0,=,0,53.333333333333336,42.0,>,11.333333333333336,49,35,>,14,59,50,>,9,110,118,<,-8
36,19,0.0,0.0,=,0.0,0,0,=,0,0,0,=,0,42.0,53.333333333333336,<,-11.333333333333336,35,49,<,-14,50,59,<,-9,118,110,>,8
0,19,0.0,0.0,=,0.0,0,0,=,0,0,0,=,0,53.333333333333336,45.333333333333336,>,8.0,49,42,>,7,59,49,>,10,110,290,<,-180
128,19,0.0,0.0,=,0.0,0,0,=,0,0,0,=,0,45.333333333333336,53.333333333333336,<,-8.0,42,49,<,-7,49,59,<,-10,290,110,>,180
0,19,0.0,0.0,=,0.0,0,0,=,0,0,0,=,0,53.333333333333336,43.666666666666664,>,9.666666666666671,49,35,>,14,59,51,>,8,110,232,<,-122
20,19,0.0,0.0,=,0.0,0,0,=,0,0,0,=,0,43.666666666666664,53.333333333333336,<,-9.666666666666671,35,49,<,-14,51,59,<,-8,232,110,>,122
0,19,0.0,0.0,=,0.0,0,0,=,0,0,0,=,0,53.333333333333336,39.0,>,14.333333333333336,49,31,>,18,59,48,>,11,110,278,<,-168
110,19,0.0,0.0,=,0.0,0,0,=,0,0,0,=,0,39.0,53.333333333333336,<,-14.333333333333336,31,49,<,-18,48,59,<,-11,278,110,>,168
0,19,0.0,0.0,=,0.0,0,0,=,0,0,0,=,0,53.333333333333336,43.666666666666664,>,9.666666666666671,49,36,>,13,59,50,>,9,110,234,<,-124
52,19,0.0,0.0,=,0.0,0,0,=,0,0,0,=,0,43.666666666666664,53.333333333333336,<,-9.666666666666671,36,49,<,-13,50,59,<,-9,234,110,>,124
0,19,0.0,0.0,=,0.0,0,0,=,0,0,0,=,0,53.333333333333336,40.0,>,13.333333333333336,49,30,>,19,59,47,>,12,110,103,>,7
5,19,0.0,0.0,=,0.0,0,0,=,0,0,0,=,0,40.0,53.333333333333336,<,-13.333333333333336,30,49,<,-19,47,59,<,-12,103,110,<,-7
0,18,12.333333333333334,9.333333333333334,>,3.0,0,0,=,0,37,28,>,9,47.666666666666664,40.0,>,7.666666666666664,39,30,>,9,55,47,>,8,133,103,>,30
66,18,9.333333333333334,12.333333333333334,<,-3.0,0,0,=,0,28,37,<,-9,40.0,47.666666666666664,<,-7.666666666666664,30,39,<,-9,47,55,<,-8,103,133,<,-30
0,18,12.333333333333334,20.333333333333332,<,-7.999999999999998,0,0,=,0,37,61,<,-24,47.666666666666664,43.666666666666664,>,4.0,39,35,>,4,55,51,>,4,133,232,<,-99
48,18,20.333333333333332,12.333333333333334,>,7.999999999999998,0,0,=,0,61,37,>,24,43.666666666666664,47.666666666666664,<,-4.0,35,39,<,-4,51,55,<,-4,232,133,>,99
0,18,12.333333333333334,10.333333333333334,>,2.0,0,0,=,0,37,31,>,6,47.666666666666664,47.333333333333336,>,0.3333333333333286,39,42,<,-3,55,52,>,3,133,155,<,-22
33,18,10.333333333333334,12.333333333333334,<,-2.0,0,0,=,0,31,37,<,-6,47.333333333333336,47.666666666666664,<,-0.3333333333333286,42,39,>,3,52,55,<,-3,155,133,>,22
0,18,12.333333333333334,9.333333333333334,>,3.0,0,0,=,0,37,28,>,9,47.666666666666664,32.333333333333336,>,15.333333333333329,39,30,>,9,55,36,>,19,133,254,<,-121
46,18,9.333333333333334,12.333333333333334,<,-3.0,0,0,=,0,28,37,<,-9,32.333333333333336,47.666666666666664,<,-15.333333333333329,30,39,<,-9,36,55,<,-19,254,133,>,121
0,18,12.333333333333334,6.0,>,6.333333333333334,0,0,=,0,37,18,>,19,47.666666666666664,39.0,>,8.666666666666664,39,30,>,9,55,48,>,7,133,228,<,-95
49,18,6.0,12.333333333333334,<,-6.333333333333334,0,0,=,0,18,37,<,-19,39.0,47.666666666666664,<,-8.666666666666664,30,39,<,-9,48,55,<,-7,228,133,>,95
0,18,12.333333333333334,17.666666666666668,<,-5.333333333333334,0,0,=,0,37,53,<,-16,47.666666666666664,48.0,<,-0.3333333333333357,39,41,<,-2,55,56,<,-1,133,268,<,-135
118,18,17.666666666666668,12.333333333333334,>,5.333333333333334,0,0,=,0,53,37,>,16,48.0,47.666666666666664,>,0.3333333333333357,41,39,>,2,56,55,>,1,268,133,>,135
0,18,12.333333333333334,5.666666666666667,>,6.666666666666667,0,0,=,0,37,17,>,20,47.666666666666664,42.0,>,5.666666666666664,39,35,>,4,55,50,>,5,133,118,>,15
15,18,5.666666666666667,12.333333333333334,<,-6.666666666666667,0,0,=,0,17,37,<,-20,42.0,47.666666666666664,<,-5.666666666666664,35,39,<,-4,50,55,<,-5,118,133,<,-15
0,18,12.333333333333334,9.333333333333334,>,3.0,0,0,=,0,37,28,>,9,47.666666666666664,48.666666666666664,<,-1.0,39,42,<,-3,55,59,<,-4,133,254,<,-121
21,18,9.333333333333334,12.333333333333334,<,-3.0,0,0,=,0,28,37,<,-9,48.666666666666664,47.666666666666664,>,1.0,42,39,>,3,59,55,>,4,254,133,>,121
0,18,12.333333333333334,7.0,>,5.333333333333334,0,0,=,0,37,21,>,16,47.666666666666664,45.0,>,2.6666666666666643,39,33,>,6,55,60,<,-5,133,173,<,-40
47,18,7.0,12.333333333333334,<,-5.333333333333334,0,0,=,0,21,37,<,-16,45.0,47.666666666666664,<,-2.6666666666666643,33,39,<,-6,60,55,>,5,173,133,>,40
0,18,12.333333333333334,13.666666666666666,<,-1.3333333333333321,0,0,=,0,37,41,<,-4,47.666666666666664,36.0,>,11.666666666666664,39,31,>,8,55,45,>,10,133,240,<,-107
75,18,13.666666666666666,12.333333333333334,>,1.3333333333333321,0,0,=,0,41,37,>,4,36.0,47.666666666666664,<,-11.666666666666664,31,39,<,-8,45,55,<,-10,240,133,>,107
0,18,12.333333333333334,15.666666666666666,<,-3.333333333333332,0,0,=,0,37,47,<,-10,47.666666666666664,43.666666666666664,>,4.0,39,36,>,3,55,50,>,5,133,234,<,-101
76,18,15.666666666666666,12.333333333333334,>,3.333333333333332,0,0,=,0,47,37,>,10,43.666666666666664,47.666666666666664,<,-4.0,36,39,<,-3,50,55,<,-5,234,133,>,101
0,18,12.333333333333334,5.333333333333333,>,7.000000000000001,0,0,=,0,37,16,>,21,47.666666666666664,48.333333333333336,<,-0.6666666666666714,39,40,<,-1,55,57,<,-2,133,217,<,-84
17,18,5.333333333333333,12.333333333333334,<,-7.000000000000001,0,0,=,0,16,37,<,-21,48.333333333333336,47.666666666666664,>,0.6666666666666714,40,39,>,1,57,55,>,2,217,133,>,84
0,18,12.333333333333334,19.333333333333332,<,-6.999999999999998,0,0,=,0,37,58,<,-21,47.666666666666664,49.333333333333336,<,-1.6666666666666714,39,42,<,-3,55,57,<,-2,133,283,<,-150
149,18,19.333333333333332,12.333333333333334,>,6.999999999999998,0,0,=,0,58,37,>,21,49.333333333333336,47.666666666666664,>,1.6666666666666714,42,39,>,3,57,55,>,2,283,133,>,150
0,18,12.333333333333334,12.666666666666666,<,-0.33333333333333215,0,0,=,0,37,38,<,-1,47.666666666666664,40.666666666666664,>,7.0,39,32,>,7,55,49,>,6,133,145,<,-12
80,18,12.666666666666666,12.333333333333334,>,0.33333333333333215,0,0,=,0,38,37,>,1,40.666666666666664,47.666666666666664,<,-7.0,32,39,<,-7,49,55,<,-6,145,133,>,12
0,18,12.333333333333334,20.666666666666668,<,-8.333333333333334,0,0,=,0,37,62,<,-25,47.666666666666664,39.0,>,8.666666666666664,39,31,>,8,55,48,>,7,133,278,<,-145
125,18,20.666666666666668,12.333333333333334,>,8.333333333333334,0,0,=,0,62,37,>,25,39.0,47.666666666666664,<,-8.666666666666664,31,39,<,-8,48,55,<,-7,278,133,>,145
0,18,12.333333333333334,27.666666666666668,<,-15.333333333333334,0,0,=,0,37,83,<,-46,47.666666666666664,56.0,<,-8.333333333333336,39,53,<,-14,55,60,<,-5,133,295,<,-162
90,18,27.666666666666668,12.333333333333334,>,15.333333333333334,0,0,=,0,83,37,>,46,56.0,47.666666666666664,>,8.333333333333336,53,39,>,14,60,55,>,5,295,133,>,162
0,18,12.333333333333334,12.666666666666666,<,-0.33333333333333215,0,0,=,0,37,38,<,-1,47.666666666666664,45.333333333333336,>,2.3333333333333286,39,42,<,-3,55,49,>,6,133,290,<,-157
139,18,12.666666666666666,12.333333333333334,>,0.33333333333333215,0,0,=,0,38,37,>,1,45.333333333333336,47.666666666666664,<,-2.3333333333333286,42,39,>,3,49,55,<,-6,290,133,>,157
0,17,11.333333333333334,33.666666666666664,<,-22.33333333333333,0,0,=,0,17,85,<,-68,42.0,48.333333333333336,<,-6.333333333333336,35,40,<,-5,50,57,<,-7,118,217,<,-99
59,17,33.666666666666664,11.333333333333334,>,22.33333333333333,0,0,=,0,85,17,>,68,48.333333333333336,42.0,>,6.333333333333336,40,35,>,5,57,50,>,7,217,118,>,99
0,17,11.333333333333334,38.333333333333336,<,-27.0,0,0,=,0,17,87,<,-70,42.0,48.666666666666664,<,-6.666666666666664,35,42,<,-7,50,59,<,-9,118,254,<,-136
139,17,38.333333333333336,11.333333333333334,>,27.0,0,0,=,0,87,17,>,70,48.666666666666664,42.0,>,6.666666666666664,42,35,>,7,59,50,>,9,254,118,>,136
0,17,11.333333333333334,31.333333333333332,<,-20.0,0,0,=,0,17,63,<,-46,42.0,47.333333333333336,<,-5.333333333333336,35,42,<,-7,50,52,<,-2,118,155,<,-37
96,17,31.333333333333332,11.333333333333334,>,20.0,0,0,=,0,63,17,>,46,47.333333333333336,42.0,>,5.333333333333336,42,35,>,7,52,50,>,2,155,118,>,37
0,17,11.333333333333334,14.333333333333334,<,-3.0,0,0,=,0,17,28,<,-11,42.0,32.333333333333336,>,9.666666666666664,35,30,>,5,50,36,>,14,118,254,<,-136
82,17,14.333333333333334,11.333333333333334,>,3.0,0,0,=,0,28,17,>,11,32.333333333333336,42.0,<,-9.666666666666664,30,35,<,-5,36,50,<,-14,254,118,>,136
0,17,11.333333333333334,25.333333333333332,<,-13.999999999999998,0,0,=,0,17,55,<,-38,42.0,45.0,<,-3.0,35,33,>,2,50,60,<,-10,118,173,<,-55
64,17,25.333333333333332,11.333333333333334,>,13.999999999999998,0,0,=,0,55,17,>,38,45.0,42.0,>,3.0,33,35,<,-2,60,50,>,10,173,118,>,55
0,17,11.333333333333334,46.0,<,-34.666666666666664,0,0,=,0,17,77,<,-60,42.0,43.666666666666664,<,-1.6666666666666643,35,35,=,0,50,51,<,-1,118,232,<,-114
102,17,46.0,11.333333333333334,>,34.666666666666664,0,0,=,0,77,17,>,60,43.666666666666664,42.0,>,1.6666666666666643,35,35,=,0,51,50,>,1,232,118,>,114
0,17,11.333333333333334,10.666666666666666,>,0.6666666666666679,0,0,=,0,17,18,<,-1,42.0,39.0,>,3.0,35,30,>,5,50,48,>,2,118,228,<,-110
73,17,10.666666666666666,11.333333333333334,<,-0.6666666666666679,0,0,=,0,18,17,>,1,39.0,42.0,<,-3.0,30,35,<,-5,48,50,<,-2,228,118,>,110
0,17,11.333333333333334,15.333333333333334,<,-4.0,0,0,=,0,17,28,<,-11,42.0,40.0,>,2.0,35,30,>,5,50,47,>,3,118,103,>,15
64,17,15.333333333333334,11.333333333333334,>,4.0,0,0,=,0,28,17,>,11,40.0,42.0,<,-2.0,30,35,<,-5,47,50,<,-3,103,118,<,-15
0,17,11.333333333333334,21.333333333333332,<,-9.999999999999998,0,0,=,0,17,41,<,-24,42.0,36.0,>,6.0,35,31,>,4,50,45,>,5,118,240,<,-122
127,17,21.333333333333332,11.333333333333334,>,9.999999999999998,0,0,=,0,41,17,>,24,36.0,42.0,<,-6.0,31,35,<,-4,45,50,<,-5,240,118,>,122
0,17,11.333333333333334,29.0,<,-17.666666666666664,0,0,=,0,17,47,<,-30,42.0,43.666666666666664,<,-1.6666666666666643,35,36,<,-1,50,50,=,0,118,234,<,-116
143,17,29.0,11.333333333333334,>,17.666666666666664,0,0,=,0,47,17,>,30,43.666666666666664,42.0,>,1.6666666666666643,36,35,>,1,50,50,=,0,234,118,>,116
0,17,11.333333333333334,21.0,<,-9.666666666666666,0,0,=,0,17,38,<,-21,42.0,40.666666666666664,>,1.3333333333333357,35,32,>,3,50,49,>,1,118,145,<,-27
0,17,21.0,11.333333333333334,>,9.666666666666666,0,0,=,0,38,17,>,21,40.666666666666664,42.0,<,-1.3333333333333357,32,35,<,-3,49,50,<,-1,145,118,>,27
0,17,11.333333333333334,45.0,<,-33.666666666666664,0,0,=,0,17,83,<,-66,42.0,56.0,<,-14.0,35,53,<,-18,50,60,<,-10,118,295,<,-177
229,17,45.0,11.333333333333334,>,33.666666666666664,0,0,=,0,83,17,>,66,56.0,42.0,>,14.0,53,35,>,18,60,50,>,10,295,118,>,177
0,17,11.333333333333334,24.0,<,-12.666666666666666,0,0,=,0,17,53,<,-36,42.0,48.0,<,-6.0,35,41,<,-6,50,56,<,-6,118,268,<,-150
71,17,24.0,11.333333333333334,>,12.666666666666666,0,0,=,0,53,17,>,36,48.0,42.0,>,6.0,41,35,>,6,56,50,>,6,268,118,>,150
0,17,11.333333333333334,25.666666666666668,<,-14.333333333333334,0,0,=,0,17,62,<,-45,42.0,39.0,>,3.0,35,31,>,4,50,48,>,2,118,278,<,-160
148,17,25.666666666666668,11.333333333333334,>,14.333333333333334,0,0,=,0,62,17,>,45,39.0,42.0,<,-3.0,31,35,<,-4,48,50,<,-2,278,118,>,160
0,17,11.333333333333334,31.0,<,-19.666666666666664,0,0,=,0,17,55,<,-38,42.0,45.333333333333336,<,-3.3333333333333357,35,42,<,-7,50,49,>,1,118,290,<,-172
139,17,31.0,11.333333333333334,>,19.666666666666664,0,0,=,0,55,17,>,38,45.333333333333336,42.0,>,3.3333333333333357,42,35,>,7,49,50,<,-1,290,118,>,172
0,17,11.333333333333334,40.0,<,-28.666666666666664,0,0,=,0,17,62,<,-45,42.0,49.333333333333336,<,-7.333333333333336,35,42,<,-7,50,57,<,-7,118,283,<,-165
189,17,40.0,11.333333333333334,>,28.666666666666664,0,0,=,0,62,17,>,45,49.333333333333336,42.0,>,7.333333333333336,42,35,>,7,57,50,>,7,283,118,>,165
0,16,34.333333333333336,45.333333333333336,<,-11.0,0,0,=,0,78,85,<,-7,40.666666666666664,48.333333333333336,<,-7.666666666666671,32,40,<,-8,49,57,<,-8,145,217,<,-72
89,16,45.333333333333336,34.333333333333336,>,11.0,0,0,=,0,85,78,>,7,48.333333333333336,40.666666666666664,>,7.666666666666671,40,32,>,8,57,49,>,8,217,145,>,72
0,16,34.333333333333336,38.333333333333336,<,-4.0,0,0,=,0,78,60,>,18,40.666666666666664,45.0,<,-4.333333333333336,32,33,<,-1,49,60,<,-11,145,173,<,-28
124,16,38.333333333333336,34.333333333333336,>,4.0,0,0,=,0,60,78,<,-18,45.0,40.666666666666664,>,4.333333333333336,33,32,>,1,60,49,>,11,173,145,>,28
0,16,34.333333333333336,12.333333333333334,>,22.0,0,0,=,0,78,19,>,59,40.666666666666664,40.0,>,0.6666666666666643,32,30,>,2,49,47,>,2,145,103,>,42
64,16,12.333333333333334,34.333333333333336,<,-22.0,0,0,=,0,19,78,<,-59,40.0,40.666666666666664,<,-0.6666666666666643,30,32,<,-2,47,49,<,-2,103,145,<,-42
0,16,34.333333333333336,33.333333333333336,>,1.0,0,0,=,0,78,81,<,-3,40.666666666666664,48.0,<,-7.333333333333336,32,41,<,-9,49,56,<,-7,145,268,<,-123
111,16,33.333333333333336,34.333333333333336,<,-1.0,0,0,=,0,81,78,>,3,48.0,40.666666666666664,>,7.333333333333336,41,32,>,9,56,49,>,7,268,145,>,123
0,16,34.333333333333336,27.333333333333332,>,7.0000000000000036,0,0,=,0,78,68,>,10,40.666666666666664,39.0,>,1.6666666666666643,32,30,>,2,49,48,>,1,145,228,<,-83
91,16,27.333333333333332,34.333333333333336,<,-7.0000000000000036,0,0,=,0,68,78,<,-10,39.0,40.666666666666664,<,-1.6666666666666643,30,32,<,-2,48,49,<,-1,228,145,>,83
0,16,34.333333333333336,30.333333333333332,>,4.0000000000000036,0,0,=,0,78,76,>,2,40.666666666666664,32.333333333333336,>,8.333333333333329,32,30,>,2,49,36,>,13,145,254,<,-109
82,16,30.333333333333332,34.333333333333336,<,-4.0000000000000036,0,0,=,0,76,78,<,-2,32.333333333333336,40.666666666666664,<,-8.333333333333329,30,32,<,-2,36,49,<,-13,254,145,>,109
0,16,34.333333333333336,46.666666666666664,<,-12.333333333333329,0,0,=,0,78,77,>,1,40.666666666666664,47.333333333333336,<,-6.666666666666671,32,42,<,-10,49,52,<,-3,145,155,<,-10
116,16,46.666666666666664,34.333333333333336,>,12.333333333333329,0,0,=,0,77,78,<,-1,47.333333333333336,40.666666666666664,>,6.666666666666671,42,32,>,10,52,49,>,3,155,145,>,10
0,16,34.333333333333336,38.0,<,-3.6666666666666643,0,0,=,0,78,77,>,1,40.666666666666664,43.666666666666664,<,-3.0,32,35,<,-3,49,51,<,-2,145,232,<,-87
72,16,38.0,34.333333333333336,>,3.6666666666666643,0,0,=,0,77,78,<,-1,43.666666666666664,40.666666666666664,>,3.0,35,32,>,3,51,49,>,2,232,145,>,87
0,16,34.333333333333336,27.333333333333332,>,7.0000000000000036,0,0,=,0,78,59,>,19,40.666666666666664,36.0,>,4.666666666666664,32,31,>,1,49,45,>,4,145,240,<,-95
114,16,27.333333333333332,34.333333333333336,<,-7.0000000000000036,0,0,=,0,59,78,<,-19,36.0,40.666666666666664,<,-4.666666666666664,31,32,<,-1,45,49,<,-4,240,145,>,95
0,16,34.333333333333336,56.0,<,-21.666666666666664,0,0,=,0,78,87,<,-9,40.666666666666664,48.666666666666664,<,-8.0,32,42,<,-10,49,59,<,-10,145,254,<,-109
188,16,56.0,34.333333333333336,>,21.666666666666664,0,0,=,0,87,78,>,9,48.666666666666664,40.666666666666664,>,8.0,42,32,>,10,59,49,>,10,254,145,>,109
0,16,34.333333333333336,34.333333333333336,=,0.0,0,0,=,0,78,55,>,23,40.666666666666664,45.333333333333336,<,-4.666666666666671,32,42,<,-10,49,49,=,0,145,290,<,-145
137,16,34.333333333333336,34.333333333333336,=,0.0,0,0,=,0,55,78,<,-23,45.333333333333336,40.666666666666664,>,4.666666666666671,42,32,>,10,49,49,=,0,290,145,>,145
0,16,34.333333333333336,40.0,<,-5.666666666666664,0,0,=,0,78,80,<,-2,40.666666666666664,43.666666666666664,<,-3.0,32,36,<,-4,49,50,<,-1,145,234,<,-89
143,16,40.0,34.333333333333336,>,5.666666666666664,0,0,=,0,80,78,>,2,43.666666666666664,40.666666666666664,>,3.0,36,32,>,4,50,49,>,1,234,145,>,89
0,16,34.333333333333336,13.666666666666666,>,20.66666666666667,0,0,=,0,78,26,>,52,40.666666666666664,39.0,>,1.6666666666666643,32,31,>,1,49,48,>,1,145,278,<,-133
0,16,13.666666666666666,34.333333333333336,<,-20.66666666666667,0,0,=,0,26,78,<,-52,39.0,40.666666666666664,<,-1.6666666666666643,31,32,<,-1,48,49,<,-1,278,145,>,133
0,16,34.333333333333336,50.0,<,-15.666666666666664,0,0,=,0,78,88,<,-10,40.666666666666664,49.333333333333336,<,-8.666666666666671,32,42,<,-10,49,57,<,-8,145,283,<,-138
189,16,50.0,34.333333333333336,>,15.666666666666664,0,0,=,0,88,78,>,10,49.333333333333336,40.666666666666664,>,8.666666666666671,42,32,>,10,57,49,>,8,283,145,>,138
0,16,34.333333333333336,33.333333333333336,>,1.0,0,0,=,0,78,52,>,26,40.666666666666664,56.0,<,-15.333333333333336,32,53,<,-21,49,60,<,-11,145,295,<,-150
208,16,33.333333333333336,34.333333333333336,<,-1.0,0,0,=,0,52,78,<,-26,56.0,40.666666666666664,>,15.333333333333336,53,32,>,21,60,49,>,11,295,145,>,150
0,15,42.333333333333336,36.666666666666664,>,5.666666666666671,18,15,>,3,90,69,>,21,40.0,39.0,>,1.0,30,31,<,-1,47,48,<,-1,103,278,<,-175
80,15,36.666666666666664,42.333333333333336,<,-5.666666666666671,15,18,<,-3,69,90,<,-21,39.0,40.0,<,-1.0,31,30,>,1,48,47,>,1,278,103,>,175
0,15,42.333333333333336,54.0,<,-11.666666666666664,18,37,<,-19,90,77,>,13,40.0,43.666666666666664,<,-3.6666666666666643,30,35,<,-5,47,51,<,-4,103,232,<,-129
71,15,54.0,42.333333333333336,>,11.666666666666664,37,18,>,19,77,90,<,-13,43.666666666666664,40.0,>,3.6666666666666643,35,30,>,5,51,47,>,4,232,103,>,129
0,15,42.333333333333336,41.0,>,1.3333333333333357,18,15,>,3,90,76,>,14,40.0,32.333333333333336,>,7.666666666666664,30,30,=,0,47,36,>,11,103,254,<,-151
90,15,41.0,42.333333333333336,<,-1.3333333333333357,15,18,<,-3,76,90,<,-14,32.333333333333336,40.0,<,-7.666666666666664,30,30,=,0,36,47,<,-11,254,103,>,151
0,15,42.333333333333336,64.33333333333333,<,-21.999999999999993,18,51,<,-33,90,85,>,5,40.0,48.333333333333336,<,-8.333333333333336,30,40,<,-10,47,57,<,-10,103,217,<,-114
100,15,64.33333333333333,42.333333333333336,>,21.999999999999993,51,18,>,33,85,90,<,-5,48.333333333333336,40.0,>,8.333333333333336,40,30,>,10,57,47,>,10,217,103,>,114
0,15,42.333333333333336,55.666666666666664,<,-13.333333333333329,18,14,>,4,90,85,>,5,40.0,39.0,>,1.0,30,30,=,0,47,48,<,-1,103,228,<,-125
140,15,55.666666666666664,42.333333333333336,>,13.333333333333329,14,18,<,-4,85,90,<,-5,39.0,40.0,<,-1.0,30,30,=,0,48,47,>,1,228,103,>,125
0,15,42.333333333333336,38.333333333333336,>,4.0,18,15,>,3,90,81,>,9,40.0,48.0,<,-8.0,30,41,<,-11,47,56,<,-9,103,268,<,-165
80,15,38.333333333333336,42.333333333333336,<,-4.0,15,18,<,-3,81,90,<,-9,48.0,40.0,>,8.0,41,30,>,11,56,47,>,9,268,103,>,165
0,15,42.333333333333336,49.0,<,-6.666666666666664,18,23,<,-5,90,65,>,25,40.0,36.0,>,4.0,30,31,<,-1,47,45,>,2,103,240,<,-137
114,15,49.0,42.333333333333336,>,6.666666666666664,23,18,>,5,65,90,<,-25,36.0,40.0,<,-4.0,31,30,>,1,45,47,<,-2,240,103,>,137
0,15,42.333333333333336,52.666666666666664,<,-10.333333333333329,18,18,=,0,90,77,>,13,40.0,47.333333333333336,<,-7.333333333333336,30,42,<,-12,47,52,<,-5,103,155,<,-52
0,15,52.666666666666664,42.333333333333336,>,10.333333333333329,18,18,=,0,77,90,<,-13,47.333333333333336,40.0,>,7.333333333333336,42,30,>,12,52,47,>,5,155,103,>,52
0,15,42.333333333333336,48.333333333333336,<,-6.0,18,30,<,-12,90,60,>,30,40.0,45.0,<,-5.0,30,33,<,-3,47,60,<,-13,103,173,<,-70
82,15,48.333333333333336,42.333333333333336,>,6.0,30,18,>,12,60,90,<,-30,45.0,40.0,>,5.0,33,30,>,3,60,47,>,13,173,103,>,70
0,15,42.333333333333336,52.666666666666664,<,-10.333333333333329,18,48,<,-30,90,55,>,35,40.0,45.333333333333336,<,-5.333333333333336,30,42,<,-12,47,49,<,-2,103,290,<,-187
138,15,52.666666666666664,42.333333333333336,>,10.333333333333329,48,18,>,30,55,90,<,-35,45.333333333333336,40.0,>,5.333333333333336,42,30,>,12,49,47,>,2,290,103,>,187
0,15,42.333333333333336,67.66666666666667,<,-25.333333333333336,18,40,<,-22,90,83,>,7,40.0,43.666666666666664,<,-3.6666666666666643,30,36,<,-6,47,50,<,-3,103,234,<,-131
183,15,67.66666666666667,42.333333333333336,>,25.333333333333336,40,18,>,22,83,90,<,-7,43.666666666666664,40.0,>,3.6666666666666643,36,30,>,6,50,47,>,3,234,103,>,131
0,15,42.333333333333336,75.33333333333333,<,-32.99999999999999,18,58,<,-40,90,87,>,3,40.0,48.666666666666664,<,-8.666666666666664,30,42,<,-12,47,59,<,-12,103,254,<,-151
246,15,75.33333333333333,42.333333333333336,>,32.99999999999999,58,18,>,40,87,90,<,-3,48.666666666666664,40.0,>,8.666666666666664,42,30,>,12,59,47,>,12,254,103,>,151
0,15,42.333333333333336,79.66666666666667,<,-37.333333333333336,18,62,<,-44,90,89,>,1,40.0,49.333333333333336,<,-9.333333333333336,30,42,<,-12,47,57,<,-10,103,283,<,-180
293,15,79.66666666666667,42.333333333333336,>,37.333333333333336,62,18,>,44,89,90,<,-1,49.333333333333336,40.0,>,9.333333333333336,42,30,>,12,57,47,>,10,283,103,>,180
0,15,42.333333333333336,44.333333333333336,<,-2.0,18,33,<,-15,90,52,>,38,40.0,56.0,<,-16.0,30,53,<,-23,47,60,<,-13,103,295,<,-192
191,15,44.333333333333336,42.333333333333336,>,2.0,33,18,>,15,52,90,<,-38,56.0,40.0,>,16.0,53,30,>,23,60,47,>,13,295,103,>,192
0,14,54.333333333333336,40.333333333333336,>,14.0,18,36,<,-18,77,48,>,29,47.333333333333336,43.666666666666664,>,3.6666666666666714,42,35,>,7,52,51,>,1,155,232,<,-77
86,14,40.333333333333336,54.333333333333336,<,-14.0,36,18,>,18,48,77,<,-29,43.666666666666664,47.333333333333336,<,-3.6666666666666714,35,42,<,-7,51,52,<,-1,232,155,>,77
0,14,54.333333333333336,44.666666666666664,>,9.666666666666671,18,15,>,3,77,81,<,-4,47.333333333333336,48.0,<,-0.6666666666666643,42,41,>,1,52,56,<,-4,155,268,<,-113
80,14,44.666666666666664,54.333333333333336,<,-9.666666666666671,15,18,<,-3,81,77,>,4,48.0,47.333333333333336,>,0.6666666666666643,41,42,<,-1,56,52,>,4,268,155,>,113
0,14,54.333333333333336,45.333333333333336,>,9.0,18,26,<,-8,77,69,>,8,47.333333333333336,39.0,>,8.333333333333336,42,31,>,11,52,48,>,4,155,278,<,-123
67,14,45.333333333333336,54.333333333333336,<,-9.0,26,18,>,8,69,77,<,-8,39.0,47.333333333333336,<,-8.333333333333336,31,42,<,-11,48,52,<,-4,278,155,>,123
0,14,54.333333333333336,50.666666666666664,>,3.6666666666666714,18,30,<,-12,77,62,>,15,47.333333333333336,45.0,>,2.3333333333333357,42,33,>,9,52,60,<,-8,155,173,<,-18
72,14,50.666666666666664,54.333333333333336,<,-3.6666666666666714,30,18,>,12,62,77,<,-15,45.0,47.333333333333336,<,-2.3333333333333357,33,42,<,-9,60,52,>,8,173,155,>,18
0,14,54.333333333333336,43.333333333333336,>,11.0,18,22,<,-4,77,76,>,1,47.333333333333336,32.333333333333336,>,15.0,42,30,>,12,52,36,>,16,155,254,<,-99
67,14,43.333333333333336,54.333333333333336,<,-11.0,22,18,>,4,76,77,<,-1,32.333333333333336,47.333333333333336,<,-15.0,30,42,<,-12,36,52,<,-16,254,155,>,99
0,14,54.333333333333336,60.0,<,-5.666666666666664,18,51,<,-33,77,72,>,5,47.333333333333336,48.333333333333336,<,-1.0,42,40,>,2,52,57,<,-5,155,217,<,-62
63,14,60.0,54.333333333333336,>,5.666666666666664,51,18,>,33,72,77,<,-5,48.333333333333336,47.333333333333336,>,1.0,40,42,<,-2,57,52,>,5,217,155,>,62
0,14,54.333333333333336,67.33333333333333,<,-12.999999999999993,18,59,<,-41,77,78,<,-1,47.333333333333336,36.0,>,11.333333333333336,42,31,>,11,52,45,>,7,155,240,<,-85
114,14,67.33333333333333,54.333333333333336,>,12.999999999999993,59,18,>,41,78,77,>,1,36.0,47.333333333333336,<,-11.333333333333336,31,42,<,-11,45,52,<,-7,240,155,>,85
0,14,54.333333333333336,38.333333333333336,>,16.0,18,12,>,6,77,55,>,22,47.333333333333336,45.333333333333336,>,2.0,42,42,=,0,52,49,>,3,155,290,<,-135
120,14,38.333333333333336,54.333333333333336,<,-16.0,12,18,<,-6,55,77,<,-22,45.333333333333336,47.333333333333336,<,-2.0,42,42,=,0,49,52,<,-3,290,155,>,135
0,14,54.333333333333336,66.66666666666667,<,-12.333333333333336,18,47,<,-29,77,85,<,-8,47.333333333333336,39.0,>,8.333333333333336,42,30,>,12,52,48,>,4,155,228,<,-73
141,14,66.66666666666667,54.333333333333336,>,12.333333333333336,47,18,>,29,85,77,>,8,39.0,47.333333333333336,<,-8.333333333333336,30,42,<,-12,48,52,<,-4,228,155,>,73
0,14,54.333333333333336,60.333333333333336,<,-6.0,18,18,=,0,77,83,<,-6,47.333333333333336,43.666666666666664,>,3.6666666666666714,42,36,>,6,52,50,>,2,155,234,<,-79
0,14,60.333333333333336,54.333333333333336,>,6.0,18,18,=,0,83,77,>,6,43.666666666666664,47.333333333333336,<,-3.6666666666666714,36,42,<,-6,50,52,<,-2,234,155,>,79
0,14,54.333333333333336,50.333333333333336,>,4.0,18,33,<,-15,77,70,>,7,47.333333333333336,56.0,<,-8.666666666666664,42,53,<,-11,52,60,<,-8,155,295,<,-140
191,14,50.333333333333336,54.333333333333336,<,-4.0,33,18,>,15,70,77,<,-7,56.0,47.333333333333336,>,8.666666666666664,53,42,>,11,60,52,>,8,295,155,>,140
0,14,54.333333333333336,53.333333333333336,>,1.0,18,21,<,-3,77,81,<,-4,47.333333333333336,48.666666666666664,<,-1.3333333333333286,42,42,=,0,52,59,<,-7,155,254,<,-99
41,14,53.333333333333336,54.333333333333336,<,-1.0,21,18,>,3,81,77,>,4,48.666666666666664,47.333333333333336,>,1.3333333333333286,42,42,=,0,59,52,>,7,254,155,>,99
0,14,54.333333333333336,80.33333333333333,<,-25.999999999999993,18,64,<,-46,77,89,<,-12,47.333333333333336,49.333333333333336,<,-2.0,42,42,=,0,52,57,<,-5,155,283,<,-128
194,14,80.33333333333333,54.333333333333336,>,25.999999999999993,64,18,>,46,89,77,>,12,49.333333333333336,47.333333333333336,>,2.0,42,42,=,0,57,52,>,5,283,155,>,128
0,13,53.0,46.666666666666664,>,6.333333333333336,18,21,<,-3,80,81,<,-1,43.666666666666664,48.666666666666664,<,-5.0,36,42,<,-6,50,59,<,-9,234,254,<,-20
41,13,46.666666666666664,53.0,<,-6.333333333333336,21,18,>,3,81,80,>,1,48.666666666666664,43.666666666666664,>,5.0,42,36,>,6,59,50,>,9,254,234,>,20
0,13,53.0,54.333333333333336,<,-1.3333333333333357,18,40,<,-22,80,72,>,8,43.666666666666664,48.333333333333336,<,-4.666666666666671,36,40,<,-4,50,57,<,-7,234,217,>,17
0,13,54.333333333333336,53.0,>,1.3333333333333357,40,18,>,22,72,80,<,-8,48.333333333333336,43.666666666666664,>,4.666666666666671,40,36,>,4,57,50,>,7,217,234,<,-17
0,13,53.0,46.333333333333336,>,6.666666666666664,18,22,<,-4,80,76,>,4,43.666666666666664,32.333333333333336,>,11.333333333333329,36,30,>,6,50,36,>,14,234,254,<,-20
48,13,46.333333333333336,53.0,<,-6.666666666666664,22,18,>,4,76,80,<,-4,32.333333333333336,43.666666666666664,<,-11.333333333333329,30,36,<,-6,36,50,<,-14,254,234,>,20
0,13,53.0,34.333333333333336,>,18.666666666666664,18,26,<,-8,80,41,>,39,43.666666666666664,39.0,>,4.666666666666664,36,31,>,5,50,48,>,2,234,278,<,-44
0,13,34.333333333333336,53.0,<,-18.666666666666664,26,18,>,8,41,80,<,-39,39.0,43.666666666666664,<,-4.666666666666664,31,36,<,-5,48,50,<,-2,278,234,>,44
0,13,53.0,66.33333333333333,<,-13.333333333333329,18,60,<,-42,80,77,>,3,43.666666666666664,45.0,<,-1.3333333333333357,36,33,>,3,50,60,<,-10,234,173,>,61
117,13,66.33333333333333,53.0,>,13.333333333333329,60,18,>,42,77,80,<,-3,45.0,43.666666666666664,>,1.3333333333333357,33,36,<,-3,60,50,>,10,173,234,<,-61
0,13,53.0,57.333333333333336,<,-4.333333333333336,18,38,<,-20,80,81,<,-1,43.666666666666664,48.0,<,-4.333333333333336,36,41,<,-5,50,56,<,-6,234,268,<,-34
105,13,57.333333333333336,53.0,>,4.333333333333336,38,18,>,20,81,80,>,1,48.0,43.666666666666664,>,4.333333333333336,41,36,>,5,56,50,>,6,268,234,>,34
0,13,53.0,52.666666666666664,>,0.3333333333333357,18,36,<,-18,80,85,<,-5,43.666666666666664,43.666666666666664,=,0.0,36,35,>,1,50,51,<,-1,234,232,>,2
71,13,52.666666666666664,53.0,<,-0.3333333333333357,36,18,>,18,85,80,>,5,43.666666666666664,43.666666666666664,=,0.0,35,36,<,-1,51,50,>,1,232,234,<,-2
0,13,53.0,58.333333333333336,<,-5.333333333333336,18,38,<,-20,80,78,>,2,43.666666666666664,36.0,>,7.666666666666664,36,31,>,5,50,45,>,5,234,240,<,-6
114,13,58.333333333333336,53.0,>,5.333333333333336,38,18,>,20,78,80,<,-2,36.0,43.666666666666664,<,-7.666666666666664,31,36,<,-5,45,50,<,-5,240,234,>,6
0,13,53.0,41.333333333333336,>,11.666666666666664,18,12,>,6,80,64,>,16,43.666666666666664,45.333333333333336,<,-1.6666666666666714,36,42,<,-6,50,49,>,1,234,290,<,-56
138,13,41.333333333333336,53.0,<,-11.666666666666664,12,18,<,-6,64,80,<,-16,45.333333333333336,43.666666666666664,>,1.6666666666666714,42,36,>,6,49,50,<,-1,290,234,>,56
0,13,53.0,58.333333333333336,<,-5.333333333333336,18,47,<,-29,80,68,>,12,43.666666666666664,39.0,>,4.666666666666664,36,30,>,6,50,48,>,2,234,228,>,6
154,13,58.333333333333336,53.0,>,5.333333333333336,47,18,>,29,68,80,<,-12,39.0,43.666666666666664,<,-4.666666666666664,30,36,<,-6,48,50,<,-2,228,234,<,-6
0,13,53.0,50.333333333333336,>,2.6666666666666643,18,33,<,-15,80,70,>,10,43.666666666666664,56.0,<,-12.333333333333336,36,53,<,-17,50,60,<,-10,234,295,<,-61
111,13,50.333333333333336,53.0,<,-2.6666666666666643,33,18,>,15,70,80,<,-10,56.0,43.666666666666664,>,12.333333333333336,53,36,>,17,60,50,>,10,295,234,>,61
0,13,53.0,79.66666666666667,<,-26.66666666666667,18,64,<,-46,80,88,<,-8,43.666666666666664,49.333333333333336,<,-5.666666666666671,36,42,<,-6,50,57,<,-7,234,283,<,-49
223,13,79.66666666666667,53.0,>,26.66666666666667,64,18,>,46,88,80,>,8,49.333333333333336,43.666666666666664,>,5.666666666666671,42,36,>,6,57,50,>,7,283,234,>,49
0,12,42.333333333333336,32.666666666666664,>,9.666666666666671,36,26,>,10,51,36,>,15,48.333333333333336,39.0,>,9.333333333333336,40,31,>,9,57,48,>,9,217,278,<,-61
0,12,32.666666666666664,42.333333333333336,<,-9.666666666666671,26,36,<,-10,36,51,<,-15,39.0,48.333333333333336,<,-9.333333333333336,31,40,<,-9,48,57,<,-9,278,217,>,61
0,12,42.333333333333336,44.666666666666664,<,-2.3333333333333286,36,15,>,21,51,81,<,-30,48.333333333333336,48.666666666666664,<,-0.3333333333333286,40,42,<,-2,57,59,<,-2,217,254,<,-37
66,12,44.666666666666664,42.333333333333336,>,2.3333333333333286,15,36,<,-21,81,51,>,30,48.666666666666664,48.333333333333336,>,0.3333333333333286,42,40,>,2,59,57,>,2,254,217,>,37
0,12,42.333333333333336,53.333333333333336,<,-11.0,36,41,<,-5,51,76,<,-25,48.333333333333336,32.333333333333336,>,16.0,40,30,>,10,57,36,>,21,217,254,<,-37
48,12,53.333333333333336,42.333333333333336,>,11.0,41,36,>,5,76,51,>,25,32.333333333333336,48.333333333333336,<,-16.0,30,40,<,-10,36,57,<,-21,254,217,>,37
0,12,42.333333333333336,55.666666666666664,<,-13.333333333333329,36,37,<,-1,51,85,<,-34,48.333333333333336,43.666666666666664,>,4.666666666666671,40,35,>,5,57,51,>,6,217,232,<,-15
71,12,55.666666666666664,42.333333333333336,>,13.333333333333329,37,36,>,1,85,51,>,34,43.666666666666664,48.333333333333336,<,-4.666666666666671,35,40,<,-5,51,57,<,-6,232,217,>,15
0,12,42.333333333333336,51.333333333333336,<,-9.0,36,20,>,16,51,81,<,-30,48.333333333333336,48.0,>,0.3333333333333357,40,41,<,-1,57,56,>,1,217,268,<,-51
152,12,51.333333333333336,42.333333333333336,>,9.0,20,36,<,-16,81,51,>,30,48.0,48.333333333333336,<,-0.3333333333333357,41,40,>,1,56,57,<,-1,268,217,>,51
0,12,42.333333333333336,51.0,<,-8.666666666666664,36,33,>,3,51,72,<,-21,48.333333333333336,56.0,<,-7.666666666666664,40,53,<,-13,57,60,<,-3,217,295,<,-78
111,12,51.0,42.333333333333336,>,8.666666666666664,33,36,<,-3,72,51,>,21,56.0,48.333333333333336,>,7.666666666666664,53,40,>,13,60,57,>,3,295,217,>,78
0,12,42.333333333333336,52.666666666666664,<,-10.333333333333329,36,38,<,-2,51,61,<,-10,48.333333333333336,36.0,>,12.333333333333336,40,31,>,9,57,45,>,12,217,240,<,-23
114,12,52.666666666666664,42.333333333333336,>,10.333333333333329,38,36,>,2,61,51,>,10,36.0,48.333333333333336,<,-12.333333333333336,31,40,<,-9,45,57,<,-12,240,217,>,23
0,12,42.333333333333336,49.666666666666664,<,-7.333333333333329,36,12,>,24,51,77,<,-26,48.333333333333336,45.0,>,3.3333333333333357,40,33,>,7,57,60,<,-3,217,173,>,44
0,12,49.666666666666664,42.333333333333336,>,7.333333333333329,12,36,<,-24,77,51,>,26,45.0,48.333333333333336,<,-3.3333333333333357,33,40,<,-7,60,57,>,3,173,217,<,-44
0,12,42.333333333333336,67.0,<,-24.666666666666664,36,48,<,-12,51,89,<,-38,48.333333333333336,45.333333333333336,>,3.0,40,42,<,-2,57,49,>,8,217,290,<,-73
138,12,67.0,42.333333333333336,>,24.666666666666664,48,36,>,12,89,51,>,38,45.333333333333336,48.333333333333336,<,-3.0,42,40,>,2,49,57,<,-8,290,217,>,73
0,12,42.333333333333336,55.666666666666664,<,-13.333333333333329,36,39,<,-3,51,68,<,-17,48.333333333333336,39.0,>,9.333333333333336,40,30,>,10,57,48,>,9,217,228,<,-11
159,12,55.666666666666664,42.333333333333336,>,13.333333333333329,39,36,>,3,68,51,>,17,39.0,48.333333333333336,<,-9.333333333333336,30,40,<,-10,48,57,<,-9,228,217,>,11
0,12,42.333333333333336,67.33333333333333,<,-24.999999999999993,36,27,>,9,51,88,<,-37,48.333333333333336,49.333333333333336,<,-1.0,40,42,<,-2,57,57,=,0,217,283,<,-66
113,12,67.33333333333333,42.333333333333336,>,24.999999999999993,27,36,<,-9,88,51,>,37,49.333333333333336,48.333333333333336,>,1.0,42,40,>,2,57,57,=,0,283,217,>,66
0,11,47.0,45.0,>,2.0,12,26,<,-14,69,73,<,-4,45.0,39.0,>,6.0,33,31,>,2,60,48,>,12,173,278,<,-105
0,11,45.0,47.0,<,-2.0,26,12,>,14,73,69,>,4,39.0,45.0,<,-6.0,31,33,<,-2,48,60,<,-12,278,173,>,105
0,11,47.0,52.333333333333336,<,-5.333333333333336,12,38,<,-26,69,76,<,-7,45.0,32.333333333333336,>,12.666666666666664,33,30,>,3,60,36,>,24,173,254,<,-81
81,11,52.333333333333336,47.0,>,5.333333333333336,38,12,>,26,76,69,>,7,32.333333333333336,45.0,<,-12.666666666666664,30,33,<,-3,36,60,<,-24,254,173,>,81
0,11,47.0,36.666666666666664,>,10.333333333333336,12,14,<,-2,69,81,<,-12,45.0,48.666666666666664,<,-3.6666666666666643,33,42,<,-9,60,59,>,1,173,254,<,-81
66,11,36.666666666666664,47.0,<,-10.333333333333336,14,12,>,2,81,69,>,12,48.666666666666664,45.0,>,3.6666666666666643,42,33,>,9,59,60,<,-1,254,173,>,81
0,11,47.0,30.666666666666668,>,16.333333333333332,12,10,>,2,69,45,>,24,45.0,43.666666666666664,>,1.3333333333333357,33,35,<,-2,60,51,>,9,173,232,<,-59
0,11,30.666666666666668,47.0,<,-16.333333333333332,10,12,<,-2,45,69,<,-24,43.666666666666664,45.0,<,-1.3333333333333357,35,33,>,2,51,60,<,-9,232,173,>,59
0,11,47.0,62.0,<,-15.0,12,48,<,-36,69,72,<,-3,45.0,56.0,<,-11.0,33,53,<,-20,60,60,=,0,173,295,<,-122
171,11,62.0,47.0,>,15.0,48,12,>,36,72,69,>,3,56.0,45.0,>,11.0,53,33,>,20,60,60,=,0,295,173,>,122
0,11,47.0,57.666666666666664,<,-10.666666666666664,12,27,<,-15,69,88,<,-19,45.0,49.333333333333336,<,-4.333333333333336,33,42,<,-9,60,57,>,3,173,283,<,-110
113,11,57.666666666666664,47.0,>,10.666666666666664,27,12,>,15,88,69,>,19,49.333333333333336,45.0,>,4.333333333333336,42,33,>,9,57,60,<,-3,283,173,>,110
0,11,47.0,59.0,<,-12.0,12,57,<,-45,69,61,>,8,45.0,36.0,>,9.0,33,31,>,2,60,45,>,15,173,240,<,-67
114,11,59.0,47.0,>,12.0,57,12,>,45,61,69,<,-8,36.0,45.0,<,-9.0,31,33,<,-2,45,60,<,-15,240,173,>,67
0,11,47.0,69.33333333333333,<,-22.33333333333333,12,48,<,-36,69,89,<,-20,45.0,45.333333333333336,<,-0.3333333333333357,33,42,<,-9,60,49,>,11,173,290,<,-117
138,11,69.33333333333333,47.0,>,22.33333333333333,48,12,>,36,89,69,>,20,45.333333333333336,45.0,>,0.3333333333333357,42,33,>,9,49,60,<,-11,290,173,>,117
0,11,47.0,41.333333333333336,>,5.666666666666664,12,20,<,-8,69,81,<,-12,45.0,48.0,<,-3.0,33,41,<,-8,60,56,>,4,173,268,<,-95
68,11,41.333333333333336,47.0,<,-5.666666666666664,20,12,>,8,81,69,>,12,48.0,45.0,>,3.0,41,33,>,8,56,60,<,-4,268,173,>,95
0,11,47.0,43.666666666666664,>,3.3333333333333357,12,24,<,-12,69,68,>,1,45.0,39.0,>,6.0,33,30,>,3,60,48,>,12,173,228,<,-55
83,11,43.666666666666664,47.0,<,-3.3333333333333357,24,12,>,12,68,69,<,-1,39.0,45.0,<,-6.0,30,33,<,-3,48,60,<,-12,228,173,>,55
0,10,25.666666666666668,40.666666666666664,<,-14.999999999999996,10,23,<,-13,37,73,<,-36,43.666666666666664,39.0,>,4.666666666666664,35,31,>,4,51,48,>,3,232,278,<,-46
0,10,40.666666666666664,25.666666666666668,>,14.999999999999996,23,10,>,13,73,37,>,36,39.0,43.666666666666664,<,-4.666666666666664,31,35,<,-4,48,51,<,-3,278,232,>,46
0,10,25.666666666666668,37.333333333333336,<,-11.666666666666668,10,14,<,-4,37,81,<,-44,43.666666666666664,48.666666666666664,<,-5.0,35,42,<,-7,51,59,<,-8,232,254,<,-22
24,10,37.333333333333336,25.666666666666668,>,11.666666666666668,14,10,>,4,81,37,>,44,48.666666666666664,43.666666666666664,>,5.0,42,35,>,7,59,51,>,8,254,232,>,22
0,10,25.666666666666668,39.333333333333336,<,-13.666666666666668,10,14,<,-4,37,81,<,-44,43.666666666666664,48.0,<,-4.333333333333336,35,41,<,-6,51,56,<,-5,232,268,<,-36
68,10,39.333333333333336,25.666666666666668,>,13.666666666666668,14,10,>,4,81,37,>,44,48.0,43.666666666666664,>,4.333333333333336,41,35,>,6,56,51,>,5,268,232,>,36
0,10,25.666666666666668,64.66666666666667,<,-39.0,10,38,<,-28,37,80,<,-43,43.666666666666664,32.333333333333336,>,11.333333333333329,35,30,>,5,51,36,>,15,232,254,<,-22
81,10,64.66666666666667,25.666666666666668,>,39.0,38,10,>,28,80,37,>,43,32.333333333333336,43.666666666666664,<,-11.333333333333329,30,35,<,-5,36,51,<,-15,254,232,>,22
0,10,25.666666666666668,35.666666666666664,<,-9.999999999999996,10,15,<,-5,37,68,<,-31,43.666666666666664,39.0,>,4.666666666666664,35,30,>,5,51,48,>,3,232,228,>,4
0,10,35.666666666666664,25.666666666666668,>,9.999999999999996,15,10,>,5,68,37,>,31,39.0,43.666666666666664,<,-4.666666666666664,30,35,<,-5,48,51,<,-3,228,232,<,-4
0,10,25.666666666666668,76.0,<,-50.33333333333333,10,58,<,-48,37,88,<,-51,43.666666666666664,49.333333333333336,<,-5.666666666666671,35,42,<,-7,51,57,<,-6,232,283,<,-51
178,10,76.0,25.666666666666668,>,50.33333333333333,58,10,>,48,88,37,>,51,49.333333333333336,43.666666666666664,>,5.666666666666671,42,35,>,7,57,51,>,6,283,232,>,51
0,10,25.666666666666668,49.666666666666664,<,-23.999999999999996,10,33,<,-23,37,59,<,-22,43.666666666666664,36.0,>,7.666666666666664,35,31,>,4,51,45,>,6,232,240,<,-8
112,10,49.666666666666664,25.666666666666668,>,23.999999999999996,33,10,>,23,59,37,>,22,36.0,43.666666666666664,<,-7.666666666666664,31,35,<,-4,45,51,<,-6,240,232,>,8
0,10,25.666666666666668,62.333333333333336,<,-36.66666666666667,10,48,<,-38,37,71,<,-34,43.666666666666664,45.333333333333336,<,-1.6666666666666714,35,42,<,-7,51,49,>,2,232,290,<,-58
138,10,62.333333333333336,25.666666666666668,>,36.66666666666667,48,10,>,38,71,37,>,34,45.333333333333336,43.666666666666664,>,1.6666666666666714,42,35,>,7,49,51,<,-2,290,232,>,58
0,10,25.666666666666668,55.666666666666664,<,-29.999999999999996,10,48,<,-38,37,66,<,-29,43.666666666666664,56.0,<,-12.333333333333336,35,53,<,-18,51,60,<,-9,232,295,<,-63
146,10,55.666666666666664,25.666666666666668,>,29.999999999999996,48,10,>,38,66,37,>,29,56.0,43.666666666666664,>,12.333333333333336,53,35,>,18,60,51,>,9,295,232,>,63
0,9,54.333333333333336,34.333333333333336,>,20.0,15,23,<,-8,80,54,>,26,39.0,39.0,=,0.0,30,31,<,-1,48,48,=,0,228,278,<,-50
0,9,34.333333333333336,54.333333333333336,<,-20.0,23,15,>,8,54,80,<,-26,39.0,39.0,=,0.0,31,30,>,1,48,48,=,0,278,228,>,50
0,9,54.333333333333336,54.0,>,0.3333333333333357,15,17,<,-2,80,81,<,-1,39.0,48.666666666666664,<,-9.666666666666664,30,42,<,-12,48,59,<,-11,228,254,<,-26
24,9,54.0,54.333333333333336,<,-0.3333333333333357,17,15,>,2,81,80,>,1,48.666666666666664,39.0,>,9.666666666666664,42,30,>,12,59,48,>,11,254,228,>,26
0,9,54.333333333333336,39.666666666666664,>,14.666666666666671,15,14,>,1,80,81,<,-1,39.0,48.0,<,-9.0,30,41,<,-11,48,56,<,-8,228,268,<,-40
0,9,39.666666666666664,54.333333333333336,<,-14.666666666666671,14,15,<,-1,81,80,>,1,48.0,39.0,>,9.0,41,30,>,11,56,48,>,8,268,228,>,40
0,9,54.333333333333336,70.0,<,-15.666666666666664,15,54,<,-39,80,80,=,0,39.0,32.333333333333336,>,6.666666666666664,30,30,=,0,48,36,>,12,228,254,<,-26
98,9,70.0,54.333333333333336,>,15.666666666666664,54,15,>,39,80,80,=,0,32.333333333333336,39.0,<,-6.666666666666664,30,30,=,0,36,48,<,-12,254,228,>,26
0,9,54.333333333333336,37.0,>,17.333333333333336,15,19,<,-4,80,59,>,21,39.0,36.0,>,3.0,30,31,<,-1,48,45,>,3,228,240,<,-12
114,9,37.0,54.333333333333336,<,-17.333333333333336,19,15,>,4,59,80,<,-21,36.0,39.0,<,-3.0,31,30,>,1,45,48,<,-3,240,228,>,12
0,9,54.333333333333336,52.666666666666664,>,1.6666666666666714,15,42,<,-27,80,68,>,12,39.0,45.333333333333336,<,-6.333333333333336,30,42,<,-12,48,49,<,-1,228,290,<,-62
111,9,52.666666666666664,54.333333333333336,<,-1.6666666666666714,42,15,>,27,68,80,<,-12,45.333333333333336,39.0,>,6.333333333333336,42,30,>,12,49,48,>,1,290,228,>,62
0,9,54.333333333333336,51.333333333333336,>,3.0,15,48,<,-33,80,53,>,27,39.0,56.0,<,-17.0,30,53,<,-23,48,60,<,-12,228,295,<,-67
101,9,51.333333333333336,54.333333333333336,<,-3.0,48,15,>,33,53,80,<,-27,56.0,39.0,>,17.0,53,30,>,23,60,48,>,12,295,228,>,67
0,9,54.333333333333336,71.0,<,-16.666666666666664,15,43,<,-28,80,88,<,-8,39.0,49.333333333333336,<,-10.333333333333336,30,42,<,-12,48,57,<,-9,228,283,<,-55
128,9,71.0,54.333333333333336,>,16.666666666666664,43,15,>,28,88,80,>,8,49.333333333333336,39.0,>,10.333333333333336,42,30,>,12,57,48,>,9,283,228,>,55
0,8,51.333333333333336,48.0,>,3.3333333333333357,24,26,<,-2,81,64,>,17,48.0,39.0,>,9.0,41,31,>,10,56,48,>,8,268,278,<,-10
0,8,48.0,51.333333333333336,<,-3.3333333333333357,26,24,>,2,64,81,<,-17,39.0,48.0,<,-9.0,31,41,<,-10,48,56,<,-8,278,268,>,10
0,8,51.333333333333336,58.666666666666664,<,-7.333333333333329,24,31,<,-7,81,81,=,0,48.0,48.666666666666664,<,-0.6666666666666643,41,42,<,-1,56,59,<,-3,268,254,>,14
39,8,58.666666666666664,51.333333333333336,>,7.333333333333329,31,24,>,7,81,81,=,0,48.666666666666664,48.0,>,0.6666666666666643,42,41,>,1,59,56,>,3,254,268,<,-14
0,8,51.333333333333336,73.0,<,-21.666666666666664,24,54,<,-30,81,89,<,-8,48.0,32.333333333333336,>,15.666666666666664,41,30,>,11,56,36,>,20,268,254,>,14
98,8,73.0,51.333333333333336,>,21.666666666666664,54,24,>,30,89,81,>,8,32.333333333333336,48.0,<,-15.666666666666664,30,41,<,-11,36,56,<,-20,254,268,<,-14
0,8,51.333333333333336,42.333333333333336,>,9.0,24,26,<,-2,81,53,>,28,48.0,56.0,<,-8.0,41,53,<,-12,56,60,<,-4,268,295,<,-27
41,8,42.333333333333336,51.333333333333336,<,-9.0,26,24,>,2,53,81,<,-28,56.0,48.0,>,8.0,53,41,>,12,60,56,>,4,295,268,>,27
0,8,51.333333333333336,52.0,<,-0.6666666666666643,24,42,<,-18,81,66,>,15,48.0,45.333333333333336,>,2.6666666666666643,41,42,<,-1,56,49,>,7,268,290,<,-22
111,8,52.0,51.333333333333336,>,0.6666666666666643,42,24,>,18,66,81,<,-15,45.333333333333336,48.0,<,-2.6666666666666643,42,41,>,1,49,56,<,-7,290,268,>,22
0,8,51.333333333333336,39.0,>,12.333333333333336,24,19,>,5,81,59,>,22,48.0,36.0,>,12.0,41,31,>,10,56,45,>,11,268,240,>,28
114,8,39.0,51.333333333333336,<,-12.333333333333336,19,24,<,-5,59,81,<,-22,36.0,48.0,<,-12.0,31,41,<,-10,45,56,<,-11,240,268,<,-28
0,8,51.333333333333336,50.666666666666664,>,0.6666666666666714,24,21,>,3,81,88,<,-7,48.0,49.333333333333336,<,-1.3333333333333357,41,42,<,-1,56,57,<,-1,268,283,<,-15
0,8,50.666666666666664,51.333333333333336,<,-0.6666666666666714,21,24,<,-3,88,81,>,7,49.333333333333336,48.0,>,1.3333333333333357,42,41,>,1,57,56,>,1,283,268,>,15
0,7,57.333333333333336,60.0,<,-2.6666666666666643,21,26,<,-5,88,90,<,-2,49.333333333333336,39.0,>,10.333333333333336,42,31,>,11,57,48,>,9,283,278,>,5
0,7,60.0,57.333333333333336,>,2.6666666666666643,26,21,>,5,90,88,>,2,39.0,49.333333333333336,<,-10.333333333333336,31,42,<,-11,48,57,<,-9,278,283,<,-5
0,7,57.333333333333336,50.666666666666664,>,6.666666666666671,21,31,<,-10,88,81,>,7,49.333333333333336,48.666666666666664,>,0.6666666666666714,42,42,=,0,57,59,<,-2,283,254,>,29
25,7,50.666666666666664,57.333333333333336,<,-6.666666666666671,31,21,>,10,81,88,<,-7,48.666666666666664,49.333333333333336,<,-0.6666666666666714,42,42,=,0,59,57,>,2,254,283,<,-29
0,7,57.333333333333336,30.0,>,27.333333333333336,21,16,>,5,88,48,>,40,49.333333333333336,56.0,<,-6.666666666666664,42,53,<,-11,57,60,<,-3,283,295,<,-12
0,7,30.0,57.333333333333336,<,-27.333333333333336,16,21,<,-5,48,88,<,-40,56.0,49.333333333333336,>,6.666666666666664,53,42,>,11,60,57,>,3,295,283,>,12
0,7,57.333333333333336,70.0,<,-12.666666666666664,21,45,<,-24,88,89,<,-1,49.333333333333336,32.333333333333336,>,17.0,42,30,>,12,57,36,>,21,283,254,>,29
40,7,70.0,57.333333333333336,>,12.666666666666664,45,21,>,24,89,88,>,1,32.333333333333336,49.333333333333336,<,-17.0,30,42,<,-12,36,57,<,-21,254,283,<,-29
0,7,57.333333333333336,54.666666666666664,>,2.6666666666666714,21,48,<,-27,88,66,>,22,49.333333333333336,45.333333333333336,>,4.0,42,42,=,0,57,49,>,8,283,290,<,-7
92,7,54.666666666666664,57.333333333333336,<,-2.6666666666666714,48,21,>,27,66,88,<,-22,45.333333333333336,49.333333333333336,<,-4.0,42,42,=,0,49,57,<,-8,290,283,>,7
0,7,57.333333333333336,37.333333333333336,>,20.0,21,14,>,7,88,59,>,29,49.333333333333336,36.0,>,13.333333333333336,42,31,>,11,57,45,>,12,283,240,>,43
114,7,37.333333333333336,57.333333333333336,<,-20.0,14,21,<,-7,59,88,<,-29,36.0,49.333333333333336,<,-13.333333333333336,31,42,<,-11,45,57,<,-12,240,283,<,-43
0,6,28.666666666666668,56.0,<,-27.333333333333332,16,26,<,-10,48,90,<,-42,56.0,39.0,>,17.0,53,31,>,22,60,48,>,12,295,278,>,17
0,6,56.0,28.666666666666668,>,27.333333333333332,26,16,>,10,90,48,>,42,39.0,56.0,<,-17.0,31,53,<,-22,48,60,<,-12,278,295,<,-17
0,6,28.666666666666668,51.0,<,-22.333333333333332,16,32,<,-16,48,81,<,-33,56.0,48.666666666666664,>,7.333333333333336,53,42,>,11,60,59,>,1,295,254,>,41
16,6,51.0,28.666666666666668,>,22.333333333333332,32,16,>,16,81,48,>,33,48.666666666666664,56.0,<,-7.333333333333336,42,53,<,-11,59,60,<,-1,254,295,<,-41
0,6,28.666666666666668,43.666666666666664,<,-14.999999999999996,16,10,>,6,48,76,<,-28,56.0,32.333333333333336,>,23.666666666666664,53,30,>,23,60,36,>,24,295,254,>,41
0,6,43.666666666666664,28.666666666666668,>,14.999999999999996,10,16,<,-6,76,48,>,28,32.333333333333336,56.0,<,-23.666666666666664,30,53,<,-23,36,60,<,-24,254,295,<,-41
0,6,28.666666666666668,41.333333333333336,<,-12.666666666666668,16,26,<,-10,48,50,<,-2,56.0,45.333333333333336,>,10.666666666666664,53,42,>,11,60,49,>,11,295,290,>,5
69,6,41.333333333333336,28.666666666666668,>,12.666666666666668,26,16,>,10,50,48,>,2,45.333333333333336,56.0,<,-10.666666666666664,42,53,<,-11,49,60,<,-11,290,295,<,-5
0,6,28.666666666666668,46.0,<,-17.333333333333332,16,14,>,2,48,65,<,-17,56.0,36.0,>,20.0,53,31,>,22,60,45,>,15,295,240,>,55
114,6,46.0,28.666666666666668,>,17.333333333333332,14,16,<,-2,65,48,>,17,36.0,56.0,<,-20.0,31,53,<,-22,45,60,<,-15,240,295,<,-55
0,5,35.666666666666664,45.666666666666664,<,-10.0,10,26,<,-16,76,59,>,17,32.333333333333336,39.0,<,-6.666666666666664,30,31,<,-1,36,48,<,-12,254,278,<,-24
0,5,45.666666666666664,35.666666666666664,>,10.0,26,10,>,16,59,76,<,-17,39.0,32.333333333333336,>,6.666666666666664,31,30,>,1,48,36,>,12,278,254,>,24
0,5,35.666666666666664,43.0,<,-7.333333333333336,10,16,<,-6,76,81,<,-5,32.333333333333336,48.666666666666664,<,-16.33333333333333,30,42,<,-12,36,59,<,-23,254,254,=,0
16,5,43.0,35.666666666666664,>,7.333333333333336,16,10,>,6,81,76,>,5,48.666666666666664,32.333333333333336,>,16.33333333333333,42,30,>,12,59,36,>,23,254,254,=,0
0,5,35.666666666666664,49.333333333333336,<,-13.666666666666671,10,26,<,-16,76,74,>,2,32.333333333333336,45.333333333333336,<,-13.0,30,42,<,-12,36,49,<,-13,254,290,<,-36
96,5,49.333333333333336,35.666666666666664,>,13.666666666666671,26,10,>,16,74,76,<,-2,45.333333333333336,32.333333333333336,>,13.0,42,30,>,12,49,36,>,13,290,254,>,36
0,5,35.666666666666664,67.66666666666667,<,-32.00000000000001,10,59,<,-49,76,79,<,-3,32.333333333333336,36.0,<,-3.6666666666666643,30,31,<,-1,36,45,<,-9,254,240,>,14
114,5,67.66666666666667,35.666666666666664,>,32.00000000000001,59,10,>,49,79,76,>,3,36.0,32.333333333333336,>,3.6666666666666643,31,30,>,1,45,36,>,9,240,254,<,-14
0,4,48.0,52.666666666666664,<,-4.666666666666664,26,16,>,10,59,81,<,-22,39.0,48.666666666666664,<,-9.666666666666664,31,42,<,-11,48,59,<,-11,278,254,>,24
66,4,52.666666666666664,48.0,>,4.666666666666664,16,26,<,-10,81,59,>,22,48.666666666666664,39.0,>,9.666666666666664,42,31,>,11,59,48,>,11,254,278,<,-24
0,4,48.0,66.66666666666667,<,-18.66666666666667,26,48,<,-22,59,78,<,-19,39.0,45.333333333333336,<,-6.333333333333336,31,42,<,-11,48,49,<,-1,278,290,<,-12
140,4,66.66666666666667,48.0,>,18.66666666666667,48,26,>,22,78,59,>,19,45.333333333333336,39.0,>,6.333333333333336,42,31,>,11,49,48,>,1,290,278,>,12
0,4,48.0,54.333333333333336,<,-6.333333333333336,26,25,>,1,59,79,<,-20,39.0,36.0,>,3.0,31,31,=,0,48,45,>,3,278,240,>,38
114,4,54.333333333333336,48.0,>,6.333333333333336,25,26,<,-1,79,59,>,20,36.0,39.0,<,-3.0,31,31,=,0,45,48,<,-3,240,278,<,-38
0,3,41.666666666666664,46.666666666666664,<,-5.0,21,16,>,5,79,63,>,16,36.0,48.666666666666664,<,-12.666666666666664,31,42,<,-11,45,59,<,-14,240,254,<,-14
66,3,46.666666666666664,41.666666666666664,>,5.0,16,21,<,-5,63,79,<,-16,48.666666666666664,36.0,>,12.666666666666664,42,31,>,11,59,45,>,14,254,240,>,14
0,3,41.666666666666664,63.0,<,-21.333333333333336,21,37,<,-16,79,78,>,1,36.0,45.333333333333336,<,-9.333333333333336,31,42,<,-11,45,49,<,-4,240,290,<,-50
142,3,63.0,41.666666666666664,>,21.333333333333336,37,21,>,16,78,79,<,-1,45.333333333333336,36.0,>,9.333333333333336,42,31,>,11,49,45,>,4,290,240,>,50
0,2,58.0,50.666666666666664,>,7.333333333333336,22,16,>,6,78,75,>,3,45.333333333333336,48.666666666666664,<,-3.3333333333333286,42,42,=,0,49,59,<,-10,290,254,>,36
66,2,50.666666666666664,58.0,<,-7.333333333333336,16,22,<,-6,75,78,<,-3,48.666666666666664,45.333333333333336,>,3.3333333333333286,42,42,=,0,59,49,>,10,254,290,<,-36
0,11,0.0,0.0,=,0.0,0,0,=,0,0,0,=,0,45.666666666666664,37.0,>,8.666666666666664,33,32,>,1,59,46,>,13,66,159,<,-93
38,11,0.0,0.0,=,0.0,0,0,=,0,0,0,=,0,37.0,45.666666666666664,<,-8.666666666666664,32,33,<,-1,46,59,<,-13,159,66,>,93
0,11,0.0,0.0,=,0.0,0,0,=,0,0,0,=,0,45.666666666666664,56.0,<,-10.333333333333336,33,50,<,-17,59,60,<,-1,66,146,<,-80
54,11,0.0,0.0,=,0.0,0,0,=,0,0,0,=,0,56.0,45.666666666666664,>,10.333333333333336,50,33,>,17,60,59,>,1,146,66,>,80
0,11,0.0,0.0,=,0.0,0,0,=,0,0,0,=,0,45.666666666666664,51.666666666666664,<,-6.0,33,38,<,-5,59,60,<,-1,66,168,<,-102
27,11,0.0,0.0,=,0.0,0,0,=,0,0,0,=,0,51.666666666666664,45.666666666666664,>,6.0,38,33,>,5,60,59,>,1,168,66,>,102
0,11,0.0,0.0,=,0.0,0,0,=,0,0,0,=,0,45.666666666666664,48.0,<,-2.3333333333333357,33,41,<,-8,59,54,>,5,66,170,<,-104
44,11,0.0,0.0,=,0.0,0,0,=,0,0,0,=,0,48.0,45.666666666666664,>,2.3333333333333357,41,33,>,8,54,59,<,-5,170,66,>,104
0,11,0.0,0.0,=,0.0,0,0,=,0,0,0,=,0,45.666666666666664,50.0,<,-4.333333333333336,33,40,<,-7,59,56,>,3,66,88,<,-22
0,11,0.0,0.0,=,0.0,0,0,=,0,0,0,=,0,50.0,45.666666666666664,>,4.333333333333336,40,33,>,7,56,59,<,-3,88,66,>,22
0,11,0.0,0.0,=,0.0,0,0,=,0,0,0,=,0,45.666666666666664,40.333333333333336,>,5.333333333333329,33,38,<,-5,59,42,>,17,66,165,<,-99
21,11,0.0,0.0,=,0.0,0,0,=,0,0,0,=,0,40.333333333333336,45.666666666666664,<,-5.333333333333329,38,33,>,5,42,59,<,-17,165,66,>,99
0,11,0.0,0.0,=,0.0,0,0,=,0,0,0,=,0,45.666666666666664,46.0,<,-0.3333333333333357,33,42,<,-9,59,49,>,10,66,96,<,-30
20,11,0.0,0.0,=,0.0,0,0,=,0,0,0,=,0,46.0,45.666666666666664,>,0.3333333333333357,42,33,>,9,49,59,<,-10,96,66,>,30
0,11,0.0,0.0,=,0.0,0,0,=,0,0,0,=,0,45.666666666666664,36.333333333333336,>,9.333333333333329,33,33,=,0,59,39,>,20,66,168,<,-102
41,11,0.0,0.0,=,0.0,0,0,=,0,0,0,=,0,36.333333333333336,45.666666666666664,<,-9.333333333333329,33,33,=,0,39,59,<,-20,168,66,>,102
0,11,0.0,0.0,=,0.0,0,0,=,0,0,0,=,0,45.666666666666664,49.0,<,-3.3333333333333357,33,40,<,-7,59,55,>,4,66,130,<,-64
28,11,0.0,0.0,=,0.0,0,0,=,0,0,0,=,0,49.0,45.666666666666664,>,3.3333333333333357,40,33,>,7,55,59,<,-4,130,66,>,64
0,11,0.0,0.0,=,0.0,0,0,=,0,0,0,=,0,45.666666666666664,49.666666666666664,<,-4.0,33,45,<,-12,59,53,>,6,66,88,<,-22
0,11,0.0,0.0,=,0.0,0,0,=,0,0,0,=,0,49.666666666666664,45.666666666666664,>,4.0,45,33,>,12,53,59,<,-6,88,66,>,22
0,10,22.0,16.0,>,6.0,0,0,=,0,66,48,>,18,50.0,49.666666666666664,>,0.3333333333333357,40,45,<,-5,56,53,>,3,88,88,=,0
0,10,16.0,22.0,<,-6.0,0,0,=,0,48,66,<,-18,49.666666666666664,50.0,<,-0.3333333333333357,45,40,>,5,53,56,<,-3,88,88,=,0
0,10,22.0,15.333333333333334,>,6.666666666666666,0,0,=,0,66,46,>,20,50.0,46.0,>,4.0,40,42,<,-2,56,49,>,7,88,96,<,-8
60,10,15.333333333333334,22.0,<,-6.666666666666666,0,0,=,0,46,66,<,-20,46.0,50.0,<,-4.0,42,40,>,2,49,56,<,-7,96,88,>,8
0,10,22.0,8.0,>,14.0,0,0,=,0,66,24,>,42,50.0,40.333333333333336,>,9.666666666666664,40,38,>,2,56,42,>,14,88,165,<,-77
21,10,8.0,22.0,<,-14.0,0,0,=,0,24,66,<,-42,40.333333333333336,50.0,<,-9.666666666666664,38,40,<,-2,42,56,<,-14,165,88,>,77
0,10,22.0,10.333333333333334,>,11.666666666666666,0,0,=,0,66,31,>,35,50.0,51.666666666666664,<,-1.6666666666666643,40,38,>,2,56,60,<,-4,88,168,<,-80
0,10,10.333333333333334,22.0,<,-11.666666666666666,0,0,=,0,31,66,<,-35,51.666666666666664,50.0,>,1.6666666666666643,38,40,<,-2,60,56,>,4,168,88,>,80
0,10,22.0,13.0,>,9.0,0,0,=,0,66,39,>,27,50.0,49.0,>,1.0,40,40,=,0,56,55,>,1,88,130,<,-42
23,10,13.0,22.0,<,-9.0,0,0,=,0,39,66,<,-27,49.0,50.0,<,-1.0,40,40,=,0,55,56,<,-1,130,88,>,42
0,10,22.0,25.0,<,-3.0,0,0,=,0,66,75,<,-9,50.0,37.0,>,13.0,40,32,>,8,56,46,>,10,88,159,<,-71
42,10,25.0,22.0,>,3.0,0,0,=,0,75,66,>,9,37.0,50.0,<,-13.0,32,40,<,-8,46,56,<,-10,159,88,>,71
0,10,22.0,3.3333333333333335,>,18.666666666666668,0,0,=,0,66,10,>,56,50.0,36.333333333333336,>,13.666666666666664,40,33,>,7,56,39,>,17,88,168,<,-80
35,10,3.3333333333333335,22.0,<,-18.666666666666668,0,0,=,0,10,66,<,-56,36.333333333333336,50.0,<,-13.666666666666664,33,40,<,-7,39,56,<,-17,168,88,>,80
0,10,22.0,6.0,>,16.0,0,0,=,0,66,18,>,48,50.0,48.0,>,2.0,40,41,<,-1,56,54,>,2,88,170,<,-82
42,10,6.0,22.0,<,-16.0,0,0,=,0,18,66,<,-48,48.0,50.0,<,-2.0,41,40,>,1,54,56,<,-2,170,88,>,82
0,10,22.0,22.0,=,0.0,0,0,=,0,66,66,=,0,50.0,56.0,<,-6.0,40,50,<,-10,56,60,<,-4,88,146,<,-58
91,10,22.0,22.0,=,0.0,0,0,=,0,66,66,=,0,56.0,50.0,>,6.0,50,40,>,10,60,56,>,4,146,88,>,58
0,9,36.333333333333336,43.333333333333336,<,-7.0,0,0,=,0,78,82,<,-4,51.666666666666664,49.666666666666664,>,2.0,38,45,<,-7,60,53,>,7,168,88,>,80
0,9,43.333333333333336,36.333333333333336,>,7.0,0,0,=,0,82,78,>,4,49.666666666666664,51.666666666666664,<,-2.0,45,38,>,7,53,60,<,-7,88,168,<,-80
0,9,36.333333333333336,19.333333333333332,>,17.000000000000004,0,0,=,0,78,34,>,44,51.666666666666664,40.333333333333336,>,11.333333333333329,38,38,=,0,60,42,>,18,168,165,>,3
30,9,19.333333333333332,36.333333333333336,<,-17.000000000000004,0,0,=,0,34,78,<,-44,40.333333333333336,51.666666666666664,<,-11.333333333333329,38,38,=,0,42,60,<,-18,165,168,<,-3
0,9,36.333333333333336,20.333333333333332,>,16.000000000000004,0,0,=,0,78,39,>,39,51.666666666666664,49.0,>,2.6666666666666643,38,40,<,-2,60,55,>,5,168,130,>,38
23,9,20.333333333333332,36.333333333333336,<,-16.000000000000004,0,0,=,0,39,78,<,-39,49.0,51.666666666666664,<,-2.6666666666666643,40,38,>,2,55,60,<,-5,130,168,<,-38
0,9,36.333333333333336,24.333333333333332,>,12.000000000000004,0,0,=,0,78,63,>,15,51.666666666666664,36.333333333333336,>,15.333333333333329,38,33,>,5,60,39,>,21,168,168,=,0
35,9,24.333333333333332,36.333333333333336,<,-12.000000000000004,0,0,=,0,63,78,<,-15,36.333333333333336,51.666666666666664,<,-15.333333333333329,33,38,<,-5,39,60,<,-21,168,168,=,0
0,9,36.333333333333336,46.666666666666664,<,-10.333333333333329,0,0,=,0,78,75,>,3,51.666666666666664,37.0,>,14.666666666666664,38,32,>,6,60,46,>,14,168,159,>,9
102,9,46.666666666666664,36.333333333333336,>,10.333333333333329,0,0,=,0,75,78,<,-3,37.0,51.666666666666664,<,-14.666666666666664,32,38,<,-6,46,60,<,-14,159,168,<,-9
0,9,36.333333333333336,10.333333333333334,>,26.0,0,0,=,0,78,18,>,60,51.666666666666664,48.0,>,3.6666666666666643,38,41,<,-3,60,54,>,6,168,170,<,-2
0,9,10.333333333333334,36.333333333333336,<,-26.0,0,0,=,0,18,78,<,-60,48.0,51.666666666666664,<,-3.6666666666666643,41,38,>,3,54,60,<,-6,170,168,>,2
0,9,36.333333333333336,40.666666666666664,<,-4.333333333333329,0,0,=,0,78,76,>,2,51.666666666666664,46.0,>,5.666666666666664,38,42,<,-4,60,49,>,11,168,96,>,72
86,9,40.666666666666664,36.333333333333336,>,4.333333333333329,0,0,=,0,76,78,<,-2,46.0,51.666666666666664,<,-5.666666666666664,42,38,>,4,49,60,<,-11,96,168,<,-72
0,9,36.333333333333336,44.666666666666664,<,-8.333333333333329,0,0,=,0,78,68,>,10,51.666666666666664,56.0,<,-4.333333333333336,38,50,<,-12,60,60,=,0,168,146,>,22
134,9,44.666666666666664,36.333333333333336,>,8.333333333333329,0,0,=,0,68,78,<,-10,56.0,51.666666666666664,>,4.333333333333336,50,38,>,12,60,60,=,0,146,168,<,-22
0,8,19.0,32.666666666666664,<,-13.666666666666664,0,0,=,0,44,82,<,-38,48.0,49.666666666666664,<,-1.6666666666666643,41,45,<,-4,54,53,>,1,170,88,>,82
0,8,32.666666666666664,19.0,>,13.666666666666664,0,0,=,0,82,44,>,38,49.666666666666664,48.0,>,1.6666666666666643,45,41,>,4,53,54,<,-1,88,170,<,-82
0,8,19.0,17.666666666666668,>,1.3333333333333321,0,0,=,0,44,31,>,13,48.0,49.0,<,-1.0,41,40,>,1,54,55,<,-1,170,130,>,40
0,8,17.666666666666668,19.0,<,-1.3333333333333321,0,0,=,0,31,44,<,-13,49.0,48.0,>,1.0,40,41,<,-1,55,54,>,1,130,170,<,-40
0,8,19.0,17.666666666666668,>,1.3333333333333321,0,0,=,0,44,34,>,10,48.0,40.333333333333336,>,7.666666666666664,41,38,>,3,54,42,>,12,170,165,>,5
14,8,17.666666666666668,19.0,<,-1.3333333333333321,0,0,=,0,34,44,<,-10,40.333333333333336,48.0,<,-7.666666666666664,38,41,<,-3,42,54,<,-12,165,170,<,-5
0,8,19.0,36.666666666666664,<,-17.666666666666664,0,0,=,0,44,63,<,-19,48.0,36.333333333333336,>,11.666666666666664,41,33,>,8,54,39,>,15,170,168,>,2
45,8,36.666666666666664,19.0,>,17.666666666666664,0,0,=,0,63,44,>,19,36.333333333333336,48.0,<,-11.666666666666664,33,41,<,-8,39,54,<,-15,168,170,<,-2
0,8,19.0,49.333333333333336,<,-30.333333333333336,0,0,=,0,44,76,<,-32,48.0,46.0,>,2.0,41,42,<,-1,54,49,>,5,170,96,>,74
86,8,49.333333333333336,19.0,>,30.333333333333336,0,0,=,0,76,44,>,32,46.0,48.0,<,-2.0,42,41,>,1,49,54,<,-5,96,170,<,-74
0,8,19.0,47.333333333333336,<,-28.333333333333336,0,0,=,0,44,77,<,-33,48.0,37.0,>,11.0,41,32,>,9,54,46,>,8,170,159,>,11
114,8,47.333333333333336,19.0,>,28.333333333333336,0,0,=,0,77,44,>,33,37.0,48.0,<,-11.0,32,41,<,-9,46,54,<,-8,159,170,<,-11
0,8,19.0,50.666666666666664,<,-31.666666666666664,0,0,=,0,44,84,<,-40,48.0,56.0,<,-8.0,41,50,<,-9,54,60,<,-6,170,146,>,24
134,8,50.666666666666664,19.0,>,31.666666666666664,0,0,=,0,84,44,>,40,56.0,48.0,>,8.0,50,41,>,9,60,54,>,6,146,170,<,-24
0,7,23.333333333333332,19.0,>,4.333333333333332,0,0,=,0,39,41,<,-2,49.0,49.666666666666664,<,-0.6666666666666643,40,45,<,-5,55,53,>,2,130,88,>,42
0,7,19.0,23.333333333333332,<,-4.333333333333332,0,0,=,0,41,39,>,2,49.666666666666664,49.0,>,0.6666666666666643,45,40,>,5,53,55,<,-2,88,130,<,-42
0,7,23.333333333333332,14.333333333333334,>,8.999999999999998,0,0,=,0,39,24,>,15,49.0,40.333333333333336,>,8.666666666666664,40,38,>,2,55,42,>,13,130,165,<,-35
14,7,14.333333333333334,23.333333333333332,<,-8.999999999999998,0,0,=,0,24,39,<,-15,40.333333333333336,49.0,<,-8.666666666666664,38,40,<,-2,42,55,<,-13,165,130,>,35
0,7,23.333333333333332,44.666666666666664,<,-21.333333333333332,0,0,=,0,39,87,<,-48,49.0,36.333333333333336,>,12.666666666666664,40,33,>,7,55,39,>,16,130,168,<,-38
45,7,44.666666666666664,23.333333333333332,>,21.333333333333332,0,0,=,0,87,39,>,48,36.333333333333336,49.0,<,-12.666666666666664,33,40,<,-7,39,55,<,-16,168,130,>,38
0,7,23.333333333333332,28.666666666666668,<,-5.333333333333336,0,0,=,0,39,72,<,-33,49.0,46.0,>,3.0,40,42,<,-2,55,49,>,6,130,96,>,34
86,7,28.666666666666668,23.333333333333332,>,5.333333333333336,0,0,=,0,72,39,>,33,46.0,49.0,<,-3.0,42,40,>,2,49,55,<,-6,96,130,<,-34
0,7,23.333333333333332,31.333333333333332,<,-8.0,0,0,=,0,39,77,<,-38,49.0,37.0,>,12.0,40,32,>,8,55,46,>,9,130,159,<,-29
0,7,31.333333333333332,23.333333333333332,>,8.0,0,0,=,0,77,39,>,38,37.0,49.0,<,-12.0,32,40,<,-8,46,55,<,-9,159,130,>,29
0,7,23.333333333333332,32.333333333333336,<,-9.000000000000004,0,0,=,0,39,84,<,-45,49.0,56.0,<,-7.0,40,50,<,-10,55,60,<,-5,130,146,<,-16
112,7,32.333333333333336,23.333333333333332,>,9.000000000000004,0,0,=,0,84,39,>,45,56.0,49.0,>,7.0,50,40,>,10,60,55,>,5,146,130,>,16
0,6,27.666666666666668,35.666666666666664,<,-7.9999999999999964,0,0,=,0,66,66,=,0,37.0,49.666666666666664,<,-12.666666666666664,32,45,<,-13,46,53,<,-7,159,88,>,71
0,6,35.666666666666664,27.666666666666668,>,7.9999999999999964,0,0,=,0,66,66,=,0,49.666666666666664,37.0,>,12.666666666666664,45,32,>,13,53,46,>,7,88,159,<,-71
0,6,27.666666666666668,30.333333333333332,<,-2.6666666666666643,0,0,=,0,66,67,<,-1,37.0,40.333333333333336,<,-3.3333333333333357,32,38,<,-6,46,42,>,4,159,165,<,-6
27,6,30.333333333333332,27.666666666666668,>,2.6666666666666643,0,0,=,0,67,66,>,1,40.333333333333336,37.0,>,3.3333333333333357,38,32,>,6,42,46,<,-4,165,159,>,6
0,6,27.666666666666668,40.333333333333336,<,-12.666666666666668,0,0,=,0,66,87,<,-21,37.0,36.333333333333336,>,0.6666666666666643,32,33,<,-1,46,39,>,7,159,168,<,-9
62,6,40.333333333333336,27.666666666666668,>,12.666666666666668,0,0,=,0,87,66,>,21,36.333333333333336,37.0,<,-0.6666666666666643,33,32,>,1,39,46,<,-7,168,159,>,9
0,6,27.666666666666668,30.0,<,-2.333333333333332,0,0,=,0,66,76,<,-10,37.0,46.0,<,-9.0,32,42,<,-10,46,49,<,-3,159,96,>,63
86,6,30.0,27.666666666666668,>,2.333333333333332,0,0,=,0,76,66,>,10,46.0,37.0,>,9.0,42,32,>,10,49,46,>,3,96,159,<,-63
0,6,27.666666666666668,12.0,>,15.666666666666668,0,0,=,0,66,23,>,43,37.0,56.0,<,-19.0,32,50,<,-18,46,60,<,-14,159,146,>,13
87,6,12.0,27.666666666666668,<,-15.666666666666668,0,0,=,0,23,66,<,-43,56.0,37.0,>,19.0,50,32,>,18,60,46,>,14,146,159,<,-13
0,5,38.666666666666664,36.333333333333336,>,2.3333333333333286,0,0,=,0,66,67,<,-1,49.666666666666664,40.333333333333336,>,9.333333333333329,45,38,>,7,53,42,>,11,88,165,<,-77
28,5,36.333333333333336,38.666666666666664,<,-2.3333333333333286,0,0,=,0,67,66,>,1,40.333333333333336,49.666666666666664,<,-9.333333333333329,38,45,<,-7,42,53,<,-11,165,88,>,77
0,5,38.666666666666664,14.666666666666666,>,24.0,0,0,=,0,66,34,>,32,49.666666666666664,36.333333333333336,>,13.333333333333329,45,33,>,12,53,39,>,14,88,168,<,-80
0,5,14.666666666666666,38.666666666666664,<,-24.0,0,0,=,0,34,66,<,-32,36.333333333333336,49.666666666666664,<,-13.333333333333329,33,45,<,-12,39,53,<,-14,168,88,>,80
0,5,38.666666666666664,44.0,<,-5.333333333333336,0,0,=,0,66,76,<,-10,49.666666666666664,46.0,>,3.6666666666666643,45,42,>,3,53,49,>,4,88,96,<,-8
86,5,44.0,38.666666666666664,>,5.333333333333336,0,0,=,0,76,66,>,10,46.0,49.666666666666664,<,-3.6666666666666643,42,45,<,-3,49,53,<,-4,96,88,>,8
0,5,38.666666666666664,22.333333333333332,>,16.333333333333332,0,0,=,0,66,44,>,22,49.666666666666664,56.0,<,-6.333333333333336,45,50,<,-5,53,60,<,-7,88,146,<,-58
87,5,22.333333333333332,38.666666666666664,<,-16.333333333333332,0,0,=,0,44,66,<,-22,56.0,49.666666666666664,>,6.333333333333336,50,45,>,5,60,53,>,7,146,88,>,58
0,4,42.666666666666664,61.333333333333336,<,-18.66666666666667,10,42,<,-32,84,75,>,9,36.333333333333336,40.333333333333336,<,-4.0,33,38,<,-5,39,42,<,-3,168,165,>,3
28,4,61.333333333333336,42.666666666666664,>,18.66666666666667,42,10,>,32,75,84,<,-9,40.333333333333336,36.333333333333336,>,4.0,38,33,>,5,42,39,>,3,165,168,<,-3
0,4,42.666666666666664,49.0,<,-6.333333333333336,10,15,<,-5,84,76,>,8,36.333333333333336,46.0,<,-9.666666666666664,33,42,<,-9,39,49,<,-10,168,96,>,72
0,4,49.0,42.666666666666664,>,6.333333333333336,15,10,>,5,76,84,<,-8,46.0,36.333333333333336,>,9.666666666666664,42,33,>,9,49,39,>,10,96,168,<,-72
0,4,42.666666666666664,39.0,>,3.6666666666666643,10,23,<,-13,84,50,>,34,36.333333333333336,56.0,<,-19.666666666666664,33,50,<,-17,39,60,<,-21,168,146,>,22
87,4,39.0,42.666666666666664,<,-3.6666666666666643,23,10,>,13,50,84,<,-34,56.0,36.333333333333336,>,19.666666666666664,50,33,>,17,60,39,>,21,146,168,<,-22
0,3,59.666666666666664,52.0,>,7.666666666666664,15,14,>,1,88,75,>,13,46.0,40.333333333333336,>,5.666666666666664,42,38,>,4,49,42,>,7,96,165,<,-69
35,3,52.0,59.666666666666664,<,-7.666666666666664,14,15,<,-1,75,88,<,-13,40.333333333333336,46.0,<,-5.666666666666664,38,42,<,-4,42,49,<,-7,165,96,>,69
0,3,59.666666666666664,38.666666666666664,>,21.0,15,23,<,-8,88,50,>,38,46.0,56.0,<,-10.0,42,50,<,-8,49,60,<,-11,96,146,<,-50
87,3,38.666666666666664,59.666666666666664,<,-21.0,23,15,>,8,50,88,<,-38,56.0,46.0,>,10.0,50,42,>,8,60,49,>,11,146,96,>,50
0,2,26.0,43.333333333333336,<,-17.333333333333336,12,14,<,-2,43,67,<,-24,56.0,40.333333333333336,>,15.666666666666664,50,38,>,12,60,42,>,18,146,165,<,-19
35,2,43.333333333333336,26.0,>,17.333333333333336,14,12,>,2,67,43,>,24,40.333333333333336,56.0,<,-15.666666666666664,38,50,<,-12,42,60,<,-18,165,146,>,19
0,19,0.0,0.0,=,0.0,0,0,=,0,0,0,=,0,57.0,46.0,>,11.0,53,38,>,15,60,58,>,2,121,153,<,-32
102,19,0.0,0.0,=,0.0,0,0,=,0,0,0,=,0,46.0,57.0,<,-11.0,38,53,<,-15,58,60,<,-2,153,121,>,32
0,19,0.0,0.0,=,0.0,0,0,=,0,0,0,=,0,57.0,37.333333333333336,>,19.666666666666664,53,35,>,18,60,40,>,20,121,101,>,20
27,19,0.0,0.0,=,0.0,0,0,=,0,0,0,=,0,37.333333333333336,57.0,<,-19.666666666666664,35,53,<,-18,40,60,<,-20,101,121,<,-20
0,19,0.0,0.0,=,0.0,0,0,=,0,0,0,=,0,57.0,43.333333333333336,>,13.666666666666664,53,37,>,16,60,54,>,6,121,182,<,-61
70,19,0.0,0.0,=,0.0,0,0,=,0,0,0,=,0,43.333333333333336,57.0,<,-13.666666666666664,37,53,<,-16,54,60,<,-6,182,121,>,61
0,19,0.0,0.0,=,0.0,0,0,=,0,0,0,=,0,57.0,40.333333333333336,>,16.666666666666664,53,30,>,23,60,52,>,8,121,244,<,-123
126,19,0.0,0.0,=,0.0,0,0,=,0,0,0,=,0,40.333333333333336,57.0,<,-16.666666666666664,30,53,<,-23,52,60,<,-8,244,121,>,123
0,19,0.0,0.0,=,0.0,0,0,=,0,0,0,=,0,57.0,50.333333333333336,>,6.666666666666664,53,48,>,5,60,53,>,7,121,152,<,-31
51,19,0.0,0.0,=,0.0,0,0,=,0,0,0,=,0,50.333333333333336,57.0,<,-6.666666666666664,48,53,<,-5,53,60,<,-7,152,121,>,31
0,19,0.0,0.0,=,0.0,0,0,=,0,0,0,=,0,57.0,40.666666666666664,>,16.333333333333336,53,32,>,21,60,56,>,4,121,271,<,-150
114,19,0.0,0.0,=,0.0,0,0,=,0,0,0,=,0,40.666666666666664,57.0,<,-16.333333333333336,32,53,<,-21,56,60,<,-4,271,121,>,150
0,19,0.0,0.0,=,0.0,0,0,=,0,0,0,=,0,57.0,47.333333333333336,>,9.666666666666664,53,41,>,12,60,53,>,7,121,235,<,-114
113,19,0.0,0.0,=,0.0,0,0,=,0,0,0,=,0,47.333333333333336,57.0,<,-9.666666666666664,41,53,<,-12,53,60,<,-7,235,121,>,114
0,19,0.0,0.0,=,0.0,0,0,=,0,0,0,=,0,57.0,47.666666666666664,>,9.333333333333336,53,34,>,19,60,58,>,2,121,108,>,13
46,19,0.0,0.0,=,0.0,0,0,=,0,0,0,=,0,47.666666666666664,57.0,<,-9.333333333333336,34,53,<,-19,58,60,<,-2,108,121,<,-13
0,19,0.0,0.0,=,0.0,0,0,=,0,0,0,=,0,57.0,38.0,>,19.0,53,33,>,20,60,47,>,13,121,181,<,-60
50,19,0.0,0.0,=,0.0,0,0,=,0,0,0,=,0,38.0,57.0,<,-19.0,33,53,<,-20,47,60,<,-13,181,121,>,60
0,19,0.0,0.0,=,0.0,0,0,=,0,0,0,=,0,57.0,39.666666666666664,>,17.333333333333336,53,31,>,22,60,48,>,12,121,206,<,-85
74,19,0.0,0.0,=,0.0,0,0,=,0,0,0,=,0,39.666666666666664,57.0,<,-17.333333333333336,31,53,<,-22,48,60,<,-12,206,121,>,85
0,19,0.0,0.0,=,0.0,0,0,=,0,0,0,=,0,57.0,40.666666666666664,>,16.333333333333336,53,35,>,18,60,48,>,12,121,202,<,-81
98,19,0.0,0.0,=,0.0,0,0,=,0,0,0,=,0,40.666666666666664,57.0,<,-16.333333333333336,35,53,<,-18,48,60,<,-12,202,121,>,81
0,19,0.0,0.0,=,0.0,0,0,=,0,0,0,=,0,57.0,40.666666666666664,>,16.333333333333336,53,30,>,23,60,58,>,2,121,114,>,7
27,19,0.0,0.0,=,0.0,0,0,=,0,0,0,=,0,40.666666666666664,57.0,<,-16.333333333333336,30,53,<,-23,58,60,<,-2,114,121,<,-7
0,19,0.0,0.0,=,0.0,0,0,=,0,0,0,=,0,57.0,43.666666666666664,>,13.333333333333336,53,30,>,23,60,51,>,9,121,113,>,8
30,19,0.0,0.0,=,0.0,0,0,=,0,0,0,=,0,43.666666666666664,57.0,<,-13.333333333333336,30,53,<,-23,51,60,<,-9,113,121,<,-8
0,19,0.0,0.0,=,0.0,0,0,=,0,0,0,=,0,57.0,39.666666666666664,>,17.333333333333336,53,30,>,23,60,49,>,11,121,102,>,19
33,19,0.0,0.0,=,0.0,0,0,=,0,0,0,=,0,39.666666666666664,57.0,<,-17.333333333333336,30,53,<,-23,49,60,<,-11,102,121,<,-19
0,19,0.0,0.0,=,0.0,0,0,=,0,0,0,=,0,57.0,47.0,>,10.0,53,42,>,11,60,52,>,8,121,107,>,14
33,19,0.0,0.0,=,0.0,0,0,=,0,0,0,=,0,47.0,57.0,<,-10.0,42,53,<,-11,52,60,<,-8,107,121,<,-14
0,19,0.0,0.0,=,0.0,0,0,=,0,0,0,=,0,57.0,45.666666666666664,>,11.333333333333336,53,41,>,12,60,50,>,10,121,106,>,15
27,19,0.0,0.0,=,0.0,0,0,=,0,0,0,=,0,45.666666666666664,57.0,<,-11.333333333333336,41,53,<,-12,50,60,<,-10,106,121,<,-15
0,19,0.0,0.0,=,0.0,0,0,=,0,0,0,=,0,57.0,44.0,>,13.0,53,32,>,21,60,56,>,4,121,135,<,-14
57,19,0.0,0.0,=,0.0,0,0,=,0,0,0,=,0,44.0,57.0,<,-13.0,32,53,<,-21,56,60,<,-4,135,121,>,14
0,19,0.0,0.0,=,0.0,0,0,=,0,0,0,=,0,57.0,36.666666666666664,>,20.333333333333336,53,33,>,20,60,39,>,21,121,242,<,-121
139,19,0.0,0.0,=,0.0,0,0,=,0,0,0,=,0,36.666666666666664,57.0,<,-20.333333333333336,33,53,<,-20,39,60,<,-21,242,121,>,121
0,18,5.666666666666667,4.0,>,1.666666666666667,0,0,=,0,17,12,>,5,40.666666666666664,37.333333333333336,>,3.3333333333333286,30,35,<,-5,58,40,>,18,114,101,>,13
73,18,4.0,5.666666666666667,<,-1.666666666666667,0,0,=,0,12,17,<,-5,37.333333333333336,40.666666666666664,<,-3.3333333333333286,35,30,>,5,40,58,<,-18,101,114,<,-13
0,18,5.666666666666667,11.333333333333334,<,-5.666666666666667,0,0,=,0,17,34,<,-17,40.666666666666664,45.666666666666664,<,-5.0,30,41,<,-11,58,50,>,8,114,106,>,8
0,18,11.333333333333334,5.666666666666667,>,5.666666666666667,0,0,=,0,34,17,>,17,45.666666666666664,40.666666666666664,>,5.0,41,30,>,11,50,58,<,-8,106,114,<,-8
0,18,5.666666666666667,7.0,<,-1.333333333333333,0,0,=,0,17,21,<,-4,40.666666666666664,43.666666666666664,<,-3.0,30,30,=,0,58,51,>,7,114,113,>,1
111,18,7.0,5.666666666666667,>,1.333333333333333,0,0,=,0,21,17,>,4,43.666666666666664,40.666666666666664,>,3.0,30,30,=,0,51,58,<,-7,113,114,<,-1
0,18,5.666666666666667,7.333333333333333,<,-1.666666666666666,0,0,=,0,17,22,<,-5,40.666666666666664,39.666666666666664,>,1.0,30,30,=,0,58,49,>,9,114,102,>,12
25,18,7.333333333333333,5.666666666666667,>,1.666666666666666,0,0,=,0,22,17,>,5,39.666666666666664,40.666666666666664,<,-1.0,30,30,=,0,49,58,<,-9,102,114,<,-12
0,18,5.666666666666667,3.3333333333333335,>,2.3333333333333335,0,0,=,0,17,10,>,7,40.666666666666664,47.0,<,-6.333333333333336,30,42,<,-12,58,52,>,6,114,107,>,7
66,18,3.3333333333333335,5.666666666666667,<,-2.3333333333333335,0,0,=,0,10,17,<,-7,47.0,40.666666666666664,>,6.333333333333336,42,30,>,12,52,58,<,-6,107,114,<,-7
0,18,5.666666666666667,11.0,<,-5.333333333333333,0,0,=,0,17,33,<,-16,40.666666666666664,47.666666666666664,<,-7.0,30,34,<,-4,58,58,=,0,114,108,>,6
67,18,11.0,5.666666666666667,>,5.333333333333333,0,0,=,0,33,17,>,16,47.666666666666664,40.666666666666664,>,7.0,34,30,>,4,58,58,=,0,108,114,<,-6
0,18,5.666666666666667,28.333333333333332,<,-22.666666666666664,0,0,=,0,17,85,<,-68,40.666666666666664,38.0,>,2.6666666666666643,30,33,<,-3,58,47,>,11,114,181,<,-67
46,18,28.333333333333332,5.666666666666667,>,22.666666666666664,0,0,=,0,85,17,>,68,38.0,40.666666666666664,<,-2.6666666666666643,33,30,>,3,47,58,<,-11,181,114,>,67
0,18,5.666666666666667,5.0,>,0.666666666666667,0,0,=,0,17,15,>,2,40.666666666666664,50.333333333333336,<,-9.666666666666671,30,48,<,-18,58,53,>,5,114,152,<,-38
72,18,5.0,5.666666666666667,<,-0.666666666666667,0,0,=,0,15,17,<,-2,50.333333333333336,40.666666666666664,>,9.666666666666671,48,30,>,18,53,58,<,-5,152,114,>,38
0,18,5.666666666666667,3.6666666666666665,>,2.0000000000000004,0,0,=,0,17,11,>,6,40.666666666666664,44.0,<,-3.3333333333333357,30,32,<,-2,58,56,>,2,114,135,<,-21
0,18,3.6666666666666665,5.666666666666667,<,-2.0000000000000004,0,0,=,0,11,17,<,-6,44.0,40.666666666666664,>,3.3333333333333357,32,30,>,2,56,58,<,-2,135,114,>,21
0,18,5.666666666666667,29.0,<,-23.333333333333332,0,0,=,0,17,87,<,-70,40.666666666666664,43.333333333333336,<,-2.6666666666666714,30,37,<,-7,58,54,>,4,114,182,<,-68
93,18,29.0,5.666666666666667,>,23.333333333333332,0,0,=,0,87,17,>,70,43.333333333333336,40.666666666666664,>,2.6666666666666714,37,30,>,7,54,58,<,-4,182,114,>,68
0,18,5.666666666666667,8.0,<,-2.333333333333333,0,0,=,0,17,24,<,-7,40.666666666666664,39.666666666666664,>,1.0,30,31,<,-1,58,48,>,10,114,206,<,-92
95,18,8.0,5.666666666666667,>,2.333333333333333,0,0,=,0,24,17,>,7,39.666666666666664,40.666666666666664,<,-1.0,31,30,>,1,48,58,<,-10,206,114,>,92
0,18,5.666666666666667,27.666666666666668,<,-22.0,0,0,=,0,17,83,<,-66,40.666666666666664,40.666666666666664,=,0.0,30,35,<,-5,58,48,>,10,114,202,<,-88
125,18,27.666666666666668,5.666666666666667,>,22.0,0,0,=,0,83,17,>,66,40.666666666666664,40.666666666666664,=,0.0,35,30,>,5,48,58,<,-10,202,114,>,88
0,18,5.666666666666667,17.0,<,-11.333333333333332,0,0,=,0,17,51,<,-34,40.666666666666664,46.0,<,-5.333333333333336,30,38,<,-8,58,58,=,0,114,153,<,-39
112,18,17.0,5.666666666666667,>,11.333333333333332,0,0,=,0,51,17,>,34,46.0,40.666666666666664,>,5.333333333333336,38,30,>,8,58,58,=,0,153,114,>,39
0,18,5.666666666666667,25.333333333333332,<,-19.666666666666664,0,0,=,0,17,76,<,-59,40.666666666666664,47.333333333333336,<,-6.666666666666671,30,41,<,-11,58,53,>,5,114,235,<,-121
172,18,25.333333333333332,5.666666666666667,>,19.666666666666664,0,0,=,0,76,17,>,59,47.333333333333336,40.666666666666664,>,6.666666666666671,41,30,>,11,53,58,<,-5,235,114,>,121
0,18,5.666666666666667,7.666666666666667,<,-2.0,0,0,=,0,17,23,<,-6,40.666666666666664,40.666666666666664,=,0.0,30,32,<,-2,58,56,>,2,114,271,<,-157
156,18,7.666666666666667,5.666666666666667,>,2.0,0,0,=,0,23,17,>,6,40.666666666666664,40.666666666666664,=,0.0,32,30,>,2,56,58,<,-2,271,114,>,157
0,18,5.666666666666667,7.0,<,-1.333333333333333,0,0,=,0,17,21,<,-4,40.666666666666664,40.333333333333336,>,0.3333333333333286,30,30,=,0,58,52,>,6,114,244,<,-130
160,18,7.0,5.666666666666667,>,1.333333333333333,0,0,=,0,21,17,>,4,40.333333333333336,40.666666666666664,<,-0.3333333333333286,30,30,=,0,52,58,<,-6,244,114,>,130
0,18,5.666666666666667,26.0,<,-20.333333333333332,0,0,=,0,17,78,<,-61,40.666666666666664,36.666666666666664,>,4.0,30,33,<,-3,58,39,>,19,114,242,<,-128
216,18,26.0,5.666666666666667,>,20.333333333333332,0,0,=,0,78,17,>,61,36.666666666666664,40.666666666666664,<,-4.0,33,30,>,3,39,58,<,-19,242,114,>,128
0,17,32.333333333333336,16.333333333333332,>,16.000000000000004,0,0,=,0,63,38,>,25,45.666666666666664,44.0,>,1.6666666666666643,41,32,>,9,50,56,<,-6,106,135,<,-29
0,17,16.333333333333332,32.333333333333336,<,-16.000000000000004,0,0,=,0,38,63,<,-25,44.0,45.666666666666664,<,-1.6666666666666643,32,41,<,-9,56,50,>,6,135,106,>,29
0,17,32.333333333333336,13.0,>,19.333333333333336,0,0,=,0,63,22,>,41,45.666666666666664,39.666666666666664,>,6.0,41,30,>,11,50,49,>,1,106,102,>,4
0,17,13.0,32.333333333333336,<,-19.333333333333336,0,0,=,0,22,63,<,-41,39.666666666666664,45.666666666666664,<,-6.0,30,41,<,-11,49,50,<,-1,102,106,<,-4
0,17,32.333333333333336,41.666666666666664,<,-9.333333333333329,0,0,=,0,63,85,<,-22,45.666666666666664,38.0,>,7.666666666666664,41,33,>,8,50,47,>,3,106,181,<,-75
88,17,41.666666666666664,32.333333333333336,>,9.333333333333329,0,0,=,0,85,63,>,22,38.0,45.666666666666664,<,-7.666666666666664,33,41,<,-8,47,50,<,-3,181,106,>,75
0,17,32.333333333333336,17.666666666666668,>,14.666666666666668,0,0,=,0,63,43,>,20,45.666666666666664,47.0,<,-1.3333333333333357,41,42,<,-1,50,52,<,-2,106,107,<,-1
120,17,17.666666666666668,32.333333333333336,<,-14.666666666666668,0,0,=,0,43,63,<,-20,47.0,45.666666666666664,>,1.3333333333333357,42,41,>,1,52,50,>,2,107,106,>,1
0,17,32.333333333333336,27.0,>,5.333333333333336,0,0,=,0,63,48,>,15,45.666666666666664,47.666666666666664,<,-2.0,41,34,>,7,50,58,<,-8,106,108,<,-2
127,17,27.0,32.333333333333336,<,-5.333333333333336,0,0,=,0,48,63,<,-15,47.666666666666664,45.666666666666664,>,2.0,34,41,<,-7,58,50,>,8,108,106,>,2
0,17,32.333333333333336,11.0,>,21.333333333333336,0,0,=,0,63,18,>,45,45.666666666666664,50.333333333333336,<,-4.666666666666671,41,48,<,-7,50,53,<,-3,106,152,<,-46
84,17,11.0,32.333333333333336,<,-21.333333333333336,0,0,=,0,18,63,<,-45,50.333333333333336,45.666666666666664,>,4.666666666666671,48,41,>,7,53,50,>,3,152,106,>,46
0,17,32.333333333333336,15.333333333333334,>,17.0,0,0,=,0,63,34,>,29,45.666666666666664,37.333333333333336,>,8.333333333333329,41,35,>,6,50,40,>,10,106,101,>,5
73,17,15.333333333333334,32.333333333333336,<,-17.0,0,0,=,0,34,63,<,-29,37.333333333333336,45.666666666666664,<,-8.333333333333329,35,41,<,-6,40,50,<,-10,101,106,<,-5
0,17,32.333333333333336,35.0,<,-2.6666666666666643,0,0,=,0,63,87,<,-24,45.666666666666664,43.333333333333336,>,2.3333333333333286,41,37,>,4,50,54,<,-4,106,182,<,-76
86,17,35.0,32.333333333333336,>,2.6666666666666643,0,0,=,0,87,63,>,24,43.333333333333336,45.666666666666664,<,-2.3333333333333286,37,41,<,-4,54,50,>,4,182,106,>,76
0,17,32.333333333333336,28.333333333333332,>,4.0000000000000036,0,0,=,0,63,61,>,2,45.666666666666664,39.666666666666664,>,6.0,41,31,>,10,50,48,>,2,106,206,<,-100
174,17,28.333333333333332,32.333333333333336,<,-4.0000000000000036,0,0,=,0,61,63,<,-2,39.666666666666664,45.666666666666664,<,-6.0,31,41,<,-10,48,50,<,-2,206,106,>,100
0,17,32.333333333333336,35.0,<,-2.6666666666666643,0,0,=,0,63,84,<,-21,45.666666666666664,43.666666666666664,>,2.0,41,30,>,11,50,51,<,-1,106,113,<,-7
111,17,35.0,32.333333333333336,>,2.6666666666666643,0,0,=,0,84,63,>,21,43.666666666666664,45.666666666666664,<,-2.0,30,41,<,-11,51,50,>,1,113,106,>,7
0,17,32.333333333333336,46.666666666666664,<,-14.333333333333329,0,0,=,0,63,89,<,-26,45.666666666666664,46.0,<,-0.3333333333333357,41,38,>,3,50,58,<,-8,106,153,<,-47
149,17,46.666666666666664,32.333333333333336,>,14.333333333333329,0,0,=,0,89,63,>,26,46.0,45.666666666666664,>,0.3333333333333357,38,41,<,-3,58,50,>,8,153,106,>,47
0,17,32.333333333333336,38.0,<,-5.666666666666664,0,0,=,0,63,83,<,-20,45.666666666666664,40.666666666666664,>,5.0,41,35,>,6,50,48,>,2,106,202,<,-96
156,17,38.0,32.333333333333336,>,5.666666666666664,0,0,=,0,83,63,>,20,40.666666666666664,45.666666666666664,<,-5.0,35,41,<,-6,48,50,<,-2,202,106,>,96
0,17,32.333333333333336,16.666666666666668,>,15.666666666666668,0,0,=,0,63,27,>,36,45.666666666666664,40.666666666666664,>,5.0,41,32,>,9,50,56,<,-6,106,271,<,-165
156,17,16.666666666666668,32.333333333333336,<,-15.666666666666668,0,0,=,0,27,63,<,-36,40.666666666666664,45.666666666666664,<,-5.0,32,41,<,-9,56,50,>,6,271,106,>,165
0,17,32.333333333333336,29.0,>,3.3333333333333357,0,0,=,0,63,66,<,-3,45.666666666666664,40.333333333333336,>,5.333333333333329,41,30,>,11,50,52,<,-2,106,244,<,-138
177,17,29.0,32.333333333333336,<,-3.3333333333333357,0,0,=,0,66,63,>,3,40.333333333333336,45.666666666666664,<,-5.333333333333329,30,41,<,-11,52,50,>,2,244,106,>,138
0,17,32.333333333333336,45.0,<,-12.666666666666664,0,0,=,0,63,76,<,-13,45.666666666666664,47.333333333333336,<,-1.6666666666666714,41,41,=,0,50,53,<,-3,106,235,<,-129
184,17,45.0,32.333333333333336,>,12.666666666666664,0,0,=,0,76,63,>,13,47.333333333333336,45.666666666666664,>,1.6666666666666714,41,41,=,0,53,50,>,3,235,106,>,129
0,17,32.333333333333336,48.666666666666664,<,-16.33333333333333,0,0,=,0,63,78,<,-15,45.666666666666664,36.666666666666664,>,9.0,41,33,>,8,50,39,>,11,106,242,<,-136
192,17,48.666666666666664,32.333333333333336,>,16.33333333333333,0,0,=,0,78,63,>,15,36.666666666666664,45.666666666666664,<,-9.0,33,41,<,-8,39,50,<,-11,242,106,>,136
0,16,19.333333333333332,22.333333333333332,<,-3.0,17,11,>,6,22,38,<,-16,39.666666666666664,44.0,<,-4.333333333333336,30,32,<,-2,49,56,<,-7,102,135,<,-33
0,16,22.333333333333332,19.333333333333332,>,3.0,11,17,<,-6,38,22,>,16,44.0,39.666666666666664,>,4.333333333333336,32,30,>,2,56,49,>,7,135,102,>,33
0,16,19.333333333333332,20.333333333333332,<,-1.0,17,12,>,5,22,34,<,-12,39.666666666666664,37.333333333333336,>,2.3333333333333286,30,35,<,-5,49,40,>,9,102,101,>,1
0,16,20.333333333333332,19.333333333333332,>,1.0,12,17,<,-5,34,22,>,12,37.333333333333336,39.666666666666664,<,-2.3333333333333286,35,30,>,5,40,49,<,-9,101,102,<,-1
0,16,19.333333333333332,39.666666666666664,<,-20.333333333333332,17,15,>,2,22,86,<,-64,39.666666666666664,50.333333333333336,<,-10.666666666666671,30,48,<,-18,49,53,<,-4,102,152,<,-50
90,16,39.666666666666664,19.333333333333332,>,20.333333333333332,15,17,<,-2,86,22,>,64,50.333333333333336,39.666666666666664,>,10.666666666666671,48,30,>,18,53,49,>,4,152,102,>,50
0,16,19.333333333333332,51.0,<,-31.666666666666668,17,18,<,-1,22,87,<,-65,39.666666666666664,43.333333333333336,<,-3.6666666666666714,30,37,<,-7,49,54,<,-5,102,182,<,-80
86,16,51.0,19.333333333333332,>,31.666666666666668,18,17,>,1,87,22,>,65,43.333333333333336,39.666666666666664,>,3.6666666666666714,37,30,>,7,54,49,>,5,182,102,>,80
0,16,19.333333333333332,66.0,<,-46.66666666666667,17,40,<,-23,22,85,<,-63,39.666666666666664,38.0,>,1.6666666666666643,30,33,<,-3,49,47,>,2,102,181,<,-79
88,16,66.0,19.333333333333332,>,46.66666666666667,40,17,>,23,85,22,>,63,38.0,39.666666666666664,<,-1.6666666666666643,33,30,>,3,47,49,<,-2,181,102,>,79
0,16,19.333333333333332,61.0,<,-41.66666666666667,17,21,<,-4,22,84,<,-62,39.666666666666664,43.666666666666664,<,-4.0,30,30,=,0,49,51,<,-2,102,113,<,-11
190,16,61.0,19.333333333333332,>,41.66666666666667,21,17,>,4,84,22,>,62,43.666666666666664,39.666666666666664,>,4.0,30,30,=,0,51,49,>,2,113,102,>,11
0,16,19.333333333333332,25.0,<,-5.666666666666668,17,10,>,7,22,43,<,-21,39.666666666666664,47.0,<,-7.333333333333336,30,42,<,-12,49,52,<,-3,102,107,<,-5
98,16,25.0,19.333333333333332,>,5.666666666666668,10,17,<,-7,43,22,>,21,47.0,39.666666666666664,>,7.333333333333336,42,30,>,12,52,49,>,3,107,102,>,5
0,16,19.333333333333332,55.666666666666664,<,-36.33333333333333,17,33,<,-16,22,86,<,-64,39.666666666666664,47.666666666666664,<,-8.0,30,34,<,-4,49,58,<,-9,102,108,<,-6
156,16,55.666666666666664,19.333333333333332,>,36.33333333333333,33,17,>,16,86,22,>,64,47.666666666666664,39.666666666666664,>,8.0,34,30,>,4,58,49,>,9,108,102,>,6
0,16,19.333333333333332,68.66666666666667,<,-49.33333333333334,17,51,<,-34,22,89,<,-67,39.666666666666664,46.0,<,-6.333333333333336,30,38,<,-8,49,58,<,-9,102,153,<,-51
199,16,68.66666666666667,19.333333333333332,>,49.33333333333334,51,17,>,34,89,22,>,67,46.0,39.666666666666664,>,6.333333333333336,38,30,>,8,58,49,>,9,153,102,>,51
0,16,19.333333333333332,34.666666666666664,<,-15.333333333333332,17,23,<,-6,22,54,<,-32,39.666666666666664,40.666666666666664,<,-1.0,30,32,<,-2,49,56,<,-7,102,271,<,-169
156,16,34.666666666666664,19.333333333333332,>,15.333333333333332,23,17,>,6,54,22,>,32,40.666666666666664,39.666666666666664,>,1.0,32,30,>,2,56,49,>,7,271,102,>,169
0,16,19.333333333333332,61.333333333333336,<,-42.0,17,31,<,-14,22,83,<,-61,39.666666666666664,40.666666666666664,<,-1.0,30,35,<,-5,49,48,>,1,102,202,<,-100
193,16,61.333333333333336,19.333333333333332,>,42.0,31,17,>,14,83,22,>,61,40.666666666666664,39.666666666666664,>,1.0,35,30,>,5,48,49,<,-1,202,102,>,100
0,16,19.333333333333332,32.666666666666664,<,-13.333333333333332,17,13,>,4,22,61,<,-39,39.666666666666664,39.666666666666664,=,0.0,30,31,<,-1,49,48,>,1,102,206,<,-104
159,16,32.666666666666664,19.333333333333332,>,13.333333333333332,13,17,<,-4,61,22,>,39,39.666666666666664,39.666666666666664,=,0.0,31,30,>,1,48,49,<,-1,206,102,>,104
0,16,19.333333333333332,46.333333333333336,<,-27.000000000000004,17,21,<,-4,22,66,<,-44,39.666666666666664,40.333333333333336,<,-0.6666666666666714,30,30,=,0,49,52,<,-3,102,244,<,-142
208,16,46.333333333333336,19.333333333333332,>,27.000000000000004,21,17,>,4,66,22,>,44,40.333333333333336,39.666666666666664,>,0.6666666666666714,30,30,=,0,52,49,>,3,244,102,>,142
0,16,19.333333333333332,55.333333333333336,<,-36.0,17,31,<,-14,22,76,<,-54,39.666666666666664,47.333333333333336,<,-7.666666666666671,30,41,<,-11,49,53,<,-4,102,235,<,-133
187,16,55.333333333333336,19.333333333333332,>,36.0,31,17,>,14,76,22,>,54,47.333333333333336,39.666666666666664,>,7.666666666666671,41,30,>,11,53,49,>,4,235,102,>,133
0,16,19.333333333333332,63.333333333333336,<,-44.0,17,44,<,-27,22,78,<,-56,39.666666666666664,36.666666666666664,>,3.0,30,33,<,-3,49,39,>,10,102,242,<,-140
233,16,63.333333333333336,19.333333333333332,>,44.0,44,17,>,27,78,22,>,56,36.666666666666664,39.666666666666664,<,-3.0,33,30,>,3,39,49,<,-10,242,102,>,140
0,15,32.0,20.0,>,12.0,12,11,>,1,69,31,>,38,37.333333333333336,44.0,<,-6.666666666666664,35,32,>,3,40,56,<,-16,101,135,<,-34
0,15,20.0,32.0,<,-12.0,11,12,<,-1,31,69,<,-38,44.0,37.333333333333336,>,6.666666666666664,32,35,<,-3,56,40,>,16,135,101,>,34
0,15,32.0,56.0,<,-24.0,12,33,<,-21,69,87,<,-18,37.333333333333336,43.333333333333336,<,-6.0,35,37,<,-2,40,54,<,-14,101,182,<,-81
105,15,56.0,32.0,>,24.0,33,12,>,21,87,69,>,18,43.333333333333336,37.333333333333336,>,6.0,37,35,>,2,54,40,>,14,182,101,>,81
0,15,32.0,57.333333333333336,<,-25.333333333333336,12,14,<,-2,69,85,<,-16,37.333333333333336,38.0,<,-0.6666666666666643,35,33,>,2,40,47,<,-7,101,181,<,-80
23,15,57.333333333333336,32.0,>,25.333333333333336,14,12,>,2,85,69,>,16,38.0,37.333333333333336,>,0.6666666666666643,33,35,<,-2,47,40,>,7,181,101,>,80
0,15,32.0,58.0,<,-26.0,12,15,<,-3,69,86,<,-17,37.333333333333336,50.333333333333336,<,-13.0,35,48,<,-13,40,53,<,-13,101,152,<,-51
117,15,58.0,32.0,>,26.0,15,12,>,3,86,69,>,17,50.333333333333336,37.333333333333336,>,13.0,48,35,>,13,53,40,>,13,152,101,>,51
0,15,32.0,15.333333333333334,>,16.666666666666664,12,10,>,2,69,22,>,47,37.333333333333336,47.0,<,-9.666666666666664,35,42,<,-7,40,52,<,-12,101,107,<,-6
0,15,15.333333333333334,32.0,<,-16.666666666666664,10,12,<,-2,22,69,<,-47,47.0,37.333333333333336,>,9.666666666666664,42,35,>,7,52,40,>,12,107,101,>,6
0,15,32.0,53.333333333333336,<,-21.333333333333336,12,23,<,-11,69,83,<,-14,37.333333333333336,40.666666666666664,<,-3.3333333333333286,35,32,>,3,40,56,<,-16,101,271,<,-170
156,15,53.333333333333336,32.0,>,21.333333333333336,23,12,>,11,83,69,>,14,40.666666666666664,37.333333333333336,>,3.3333333333333286,32,35,<,-3,56,40,>,16,271,101,>,170
0,15,32.0,54.333333333333336,<,-22.333333333333336,12,33,<,-21,69,86,<,-17,37.333333333333336,47.666666666666664,<,-10.333333333333329,35,34,>,1,40,58,<,-18,101,108,<,-7
154,15,54.333333333333336,32.0,>,22.333333333333336,33,12,>,21,86,69,>,17,47.666666666666664,37.333333333333336,>,10.333333333333329,34,35,<,-1,58,40,>,18,108,101,>,7
0,15,32.0,22.0,>,10.0,12,13,<,-1,69,29,>,40,37.333333333333336,39.666666666666664,<,-2.3333333333333286,35,31,>,4,40,48,<,-8,101,206,<,-105
125,15,22.0,32.0,<,-10.0,13,12,>,1,29,69,<,-40,39.666666666666664,37.333333333333336,>,2.3333333333333286,31,35,<,-4,48,40,>,8,206,101,>,105
0,15,32.0,65.66666666666667,<,-33.66666666666667,12,31,<,-19,69,90,<,-21,37.333333333333336,47.333333333333336,<,-10.0,35,41,<,-6,40,53,<,-13,101,235,<,-134
187,15,65.66666666666667,32.0,>,33.66666666666667,31,12,>,19,90,69,>,21,47.333333333333336,37.333333333333336,>,10.0,41,35,>,6,53,40,>,13,235,101,>,134
0,15,32.0,37.0,<,-5.0,12,12,=,0,69,78,<,-9,37.333333333333336,43.666666666666664,<,-6.333333333333329,35,30,>,5,40,51,<,-11,101,113,<,-12
173,15,37.0,32.0,>,5.0,12,12,=,0,78,69,>,9,43.666666666666664,37.333333333333336,>,6.333333333333329,30,35,<,-5,51,40,>,11,113,101,>,12
0,15,32.0,75.33333333333333,<,-43.33333333333333,12,70,<,-58,69,83,<,-14,37.333333333333336,40.666666666666664,<,-3.3333333333333286,35,35,=,0,40,48,<,-8,101,202,<,-101
268,15,75.33333333333333,32.0,>,43.33333333333333,70,12,>,58,83,69,>,14,40.666666666666664,37.333333333333336,>,3.3333333333333286,35,35,=,0,48,40,>,8,202,101,>,101
0,15,32.0,59.666666666666664,<,-27.666666666666664,12,51,<,-39,69,66,>,3,37.333333333333336,46.0,<,-8.666666666666664,35,38,<,-3,40,58,<,-18,101,153,<,-52
199,15,59.666666666666664,32.0,>,27.666666666666664,51,12,>,39,66,69,<,-3,46.0,37.333333333333336,>,8.666666666666664,38,35,>,3,58,40,>,18,153,101,>,52
0,15,32.0,38.333333333333336,<,-6.333333333333336,12,21,<,-9,69,52,>,17,37.333333333333336,40.333333333333336,<,-3.0,35,30,>,5,40,52,<,-12,101,244,<,-143
198,15,38.333333333333336,32.0,>,6.333333333333336,21,12,>,9,52,69,<,-17,40.333333333333336,37.333333333333336,>,3.0,30,35,<,-5,52,40,>,12,244,101,>,143
0,15,32.0,49.666666666666664,<,-17.666666666666664,12,27,<,-15,69,78,<,-9,37.333333333333336,36.666666666666664,>,0.6666666666666714,35,33,>,2,40,39,>,1,101,242,<,-141
175,15,49.666666666666664,32.0,>,17.666666666666664,27,12,>,15,78,69,>,9,36.666666666666664,37.333333333333336,<,-0.6666666666666714,33,35,<,-2,39,40,<,-1,242,101,>,141
0,14,15.666666666666666,41.333333333333336,<,-25.66666666666667,10,11,<,-1,23,82,<,-59,47.0,44.0,>,3.0,42,32,>,10,52,56,<,-4,107,135,<,-28
0,14,41.333333333333336,15.666666666666666,>,25.66666666666667,11,10,>,1,82,23,>,59,44.0,47.0,<,-3.0,32,42,<,-10,56,52,>,4,135,107,>,28
0,14,15.666666666666666,62.666666666666664,<,-47.0,10,14,<,-4,23,89,<,-66,47.0,38.0,>,9.0,42,33,>,9,52,47,>,5,107,181,<,-74
23,14,62.666666666666664,15.666666666666666,>,47.0,14,10,>,4,89,23,>,66,38.0,47.0,<,-9.0,33,42,<,-9,47,52,<,-5,181,107,>,74
0,14,15.666666666666666,66.0,<,-50.333333333333336,10,33,<,-23,23,87,<,-64,47.0,43.333333333333336,>,3.6666666666666643,42,37,>,5,52,54,<,-2,107,182,<,-75
105,14,66.0,15.666666666666666,>,50.333333333333336,33,10,>,23,87,23,>,64,43.333333333333336,47.0,<,-3.6666666666666643,37,42,<,-5,54,52,>,2,182,107,>,75
0,14,15.666666666666666,40.666666666666664,<,-25.0,10,15,<,-5,23,73,<,-50,47.0,50.333333333333336,<,-3.3333333333333357,42,48,<,-6,52,53,<,-1,107,152,<,-45
117,14,40.666666666666664,15.666666666666666,>,25.0,15,10,>,5,73,23,>,50,50.333333333333336,47.0,>,3.3333333333333357,48,42,>,6,53,52,>,1,152,107,>,45
0,14,15.666666666666666,32.666666666666664,<,-17.0,10,24,<,-14,23,45,<,-22,47.0,39.666666666666664,>,7.333333333333336,42,31,>,11,52,48,>,4,107,206,<,-99
125,14,32.666666666666664,15.666666666666666,>,17.0,24,10,>,14,45,23,>,22,39.666666666666664,47.0,<,-7.333333333333336,31,42,<,-11,48,52,<,-4,206,107,>,99
0,14,15.666666666666666,52.666666666666664,<,-37.0,10,33,<,-23,23,81,<,-58,47.0,47.666666666666664,<,-0.6666666666666643,42,34,>,8,52,58,<,-6,107,108,<,-1
165,14,52.666666666666664,15.666666666666666,>,37.0,33,10,>,23,81,23,>,58,47.666666666666664,47.0,>,0.6666666666666643,34,42,<,-8,58,52,>,6,108,107,>,1
0,14,15.666666666666666,54.666666666666664,<,-39.0,10,23,<,-13,23,83,<,-60,47.0,40.666666666666664,>,6.333333333333336,42,32,>,10,52,56,<,-4,107,271,<,-164
156,14,54.666666666666664,15.666666666666666,>,39.0,23,10,>,13,83,23,>,60,40.666666666666664,47.0,<,-6.333333333333336,32,42,<,-10,56,52,>,4,271,107,>,164
0,14,15.666666666666666,15.0,>,0.6666666666666661,10,12,<,-2,23,21,>,2,47.0,43.666666666666664,>,3.3333333333333357,42,30,>,12,52,51,>,1,107,113,<,-6
0,14,15.0,15.666666666666666,<,-0.6666666666666661,12,10,>,2,21,23,<,-2,43.666666666666664,47.0,<,-3.3333333333333357,30,42,<,-12,51,52,<,-1,113,107,>,6
0,14,15.666666666666666,55.333333333333336,<,-39.66666666666667,10,27,<,-17,23,78,<,-55,47.0,36.666666666666664,>,10.333333333333336,42,33,>,9,52,39,>,13,107,242,<,-135
175,14,55.333333333333336,15.666666666666666,>,39.66666666666667,27,10,>,17,78,23,>,55,36.666666666666664,47.0,<,-10.333333333333336,33,42,<,-9,39,52,<,-13,242,107,>,135
0,14,15.666666666666666,64.33333333333333,<,-48.666666666666664,10,27,<,-17,23,90,<,-67,47.0,47.333333333333336,<,-0.3333333333333357,42,41,>,1,52,53,<,-1,107,235,<,-128
121,14,64.33333333333333,15.666666666666666,>,48.666666666666664,27,10,>,17,90,23,>,67,47.333333333333336,47.0,>,0.3333333333333357,41,42,<,-1,53,52,>,1,235,107,>,128
0,14,15.666666666666666,25.0,<,-9.333333333333334,10,12,<,-2,23,42,<,-19,47.0,40.333333333333336,>,6.666666666666664,42,30,>,12,52,52,=,0,107,244,<,-137
141,14,25.0,15.666666666666666,>,9.333333333333334,12,10,>,2,42,23,>,19,40.333333333333336,47.0,<,-6.666666666666664,30,42,<,-12,52,52,=,0,244,107,>,137
0,14,15.666666666666666,49.666666666666664,<,-34.0,10,36,<,-26,23,62,<,-39,47.0,46.0,>,1.0,42,38,>,4,52,58,<,-6,107,153,<,-46
86,14,49.666666666666664,15.666666666666666,>,34.0,36,10,>,26,62,23,>,39,46.0,47.0,<,-1.0,38,42,<,-4,58,52,>,6,153,107,>,46
0,14,15.666666666666666,69.66666666666667,<,-54.00000000000001,10,53,<,-43,23,83,<,-60,47.0,40.666666666666664,>,6.333333333333336,42,35,>,7,52,48,>,4,107,202,<,-95
236,14,69.66666666666667,15.666666666666666,>,54.00000000000001,53,10,>,43,83,23,>,60,40.666666666666664,47.0,<,-6.333333333333336,35,42,<,-7,48,52,<,-4,202,107,>,95
0,13,39.333333333333336,55.666666666666664,<,-16.33333333333333,12,11,>,1,85,82,>,3,43.666666666666664,44.0,<,-0.3333333333333357,30,32,<,-2,51,56,<,-5,113,135,<,-22
0,13,55.666666666666664,39.333333333333336,>,16.33333333333333,11,12,<,-1,82,85,<,-3,44.0,43.666666666666664,>,0.3333333333333357,32,30,>,2,56,51,>,5,135,113,>,22
0,13,39.333333333333336,80.33333333333333,<,-40.99999999999999,12,67,<,-55,85,89,<,-4,43.666666666666664,38.0,>,5.666666666666664,30,33,<,-3,51,47,>,4,113,181,<,-68
166,13,80.33333333333333,39.333333333333336,>,40.99999999999999,67,12,>,55,89,85,>,4,38.0,43.666666666666664,<,-5.666666666666664,33,30,>,3,47,51,<,-4,181,113,>,68
0,13,39.333333333333336,58.333333333333336,<,-19.0,12,36,<,-24,85,88,<,-3,43.666666666666664,46.0,<,-2.3333333333333357,30,38,<,-8,51,58,<,-7,113,153,<,-40
108,13,58.333333333333336,39.333333333333336,>,19.0,36,12,>,24,88,85,>,3,46.0,43.666666666666664,>,2.3333333333333357,38,30,>,8,58,51,>,7,153,113,>,40
0,13,39.333333333333336,70.66666666666667,<,-31.333333333333336,12,47,<,-35,85,87,<,-2,43.666666666666664,43.333333333333336,>,0.3333333333333286,30,37,<,-7,51,54,<,-3,113,182,<,-69
120,13,70.66666666666667,39.333333333333336,>,31.333333333333336,47,12,>,35,87,85,>,2,43.333333333333336,43.666666666666664,<,-0.3333333333333286,37,30,>,7,54,51,>,3,182,113,>,69
0,13,39.333333333333336,28.0,>,11.333333333333336,12,15,<,-3,85,35,>,50,43.666666666666664,50.333333333333336,<,-6.666666666666671,30,48,<,-18,51,53,<,-2,113,152,<,-39
141,13,28.0,39.333333333333336,<,-11.333333333333336,15,12,>,3,35,85,<,-50,50.333333333333336,43.666666666666664,>,6.666666666666671,48,30,>,18,53,51,>,2,152,113,>,39
0,13,39.333333333333336,42.0,<,-2.6666666666666643,12,23,<,-11,85,76,>,9,43.666666666666664,47.333333333333336,<,-3.6666666666666714,30,41,<,-11,51,53,<,-2,113,235,<,-122
89,13,42.0,39.333333333333336,>,2.6666666666666643,23,12,>,11,76,85,<,-9,47.333333333333336,43.666666666666664,>,3.6666666666666714,41,30,>,11,53,51,>,2,235,113,>,122
0,13,39.333333333333336,26.666666666666668,>,12.666666666666668,12,11,>,1,85,45,>,40,43.666666666666664,39.666666666666664,>,4.0,30,31,<,-1,51,48,>,3,113,206,<,-93
0,13,26.666666666666668,39.333333333333336,<,-12.666666666666668,11,12,<,-1,45,85,<,-40,39.666666666666664,43.666666666666664,<,-4.0,31,30,>,1,48,51,<,-3,206,113,>,93
0,13,39.333333333333336,31.666666666666668,>,7.666666666666668,12,12,=,0,85,62,>,23,43.666666666666664,40.333333333333336,>,3.3333333333333286,30,30,=,0,51,52,<,-1,113,244,<,-131
143,13,31.666666666666668,39.333333333333336,<,-7.666666666666668,12,12,=,0,62,85,<,-23,40.333333333333336,43.666666666666664,<,-3.3333333333333286,30,30,=,0,52,51,>,1,244,113,>,131
0,13,39.333333333333336,35.666666666666664,>,3.6666666666666714,12,23,<,-11,85,58,>,27,43.666666666666664,40.666666666666664,>,3.0,30,32,<,-2,51,56,<,-5,113,271,<,-158
131,13,35.666666666666664,39.333333333333336,<,-3.6666666666666714,23,12,>,11,58,85,<,-27,40.666666666666664,43.666666666666664,<,-3.0,32,30,>,2,56,51,>,5,271,113,>,158
0,13,39.333333333333336,55.333333333333336,<,-16.0,12,33,<,-21,85,81,>,4,43.666666666666664,47.666666666666664,<,-4.0,30,34,<,-4,51,58,<,-7,113,108,>,5
154,13,55.333333333333336,39.333333333333336,>,16.0,33,12,>,21,81,85,<,-4,47.666666666666664,43.666666666666664,>,4.0,34,30,>,4,58,51,>,7,108,113,<,-5
0,13,39.333333333333336,64.33333333333333,<,-24.999999999999993,12,54,<,-42,85,78,>,7,43.666666666666664,36.666666666666664,>,7.0,30,33,<,-3,51,39,>,12,113,242,<,-129
165,13,64.33333333333333,39.333333333333336,>,24.999999999999993,54,12,>,42,78,85,<,-7,36.666666666666664,43.666666666666664,<,-7.0,33,30,>,3,39,51,<,-12,242,113,>,129
0,13,39.333333333333336,72.0,<,-32.666666666666664,12,53,<,-41,85,83,>,2,43.666666666666664,40.666666666666664,>,3.0,30,35,<,-5,51,48,>,3,113,202,<,-89
227,13,72.0,39.333333333333336,>,32.666666666666664,53,12,>,41,83,85,<,-2,40.666666666666664,43.666666666666664,<,-3.0,35,30,>,5,48,51,<,-3,202,113,>,89
0,12,31.666666666666668,40.333333333333336,<,-8.666666666666668,11,11,=,0,60,74,<,-14,39.666666666666664,44.0,<,-4.333333333333336,31,32,<,-1,48,56,<,-8,206,135,>,71
0,12,40.333333333333336,31.666666666666668,>,8.666666666666668,11,11,=,0,74,60,>,14,44.0,39.666666666666664,>,4.333333333333336,32,31,>,1,56,48,>,8,135,206,<,-71
0,12,31.666666666666668,46.0,<,-14.333333333333332,11,23,<,-12,60,76,<,-16,39.666666666666664,47.333333333333336,<,-7.666666666666671,31,41,<,-10,48,53,<,-5,206,235,<,-29
57,12,46.0,31.666666666666668,>,14.333333333333332,23,11,>,12,76,60,>,16,47.333333333333336,39.666666666666664,>,7.666666666666671,41,31,>,10,53,48,>,5,235,206,>,29
0,12,31.666666666666668,68.66666666666667,<,-37.0,11,51,<,-40,60,88,<,-28,39.666666666666664,46.0,<,-6.333333333333336,31,38,<,-7,48,58,<,-10,206,153,>,53
133,12,68.66666666666667,31.666666666666668,>,37.0,51,11,>,40,88,60,>,28,46.0,39.666666666666664,>,6.333333333333336,38,31,>,7,58,48,>,10,153,206,<,-53
0,12,31.666666666666668,56.333333333333336,<,-24.666666666666668,11,35,<,-24,60,87,<,-27,39.666666666666664,43.333333333333336,<,-3.6666666666666714,31,37,<,-6,48,54,<,-6,206,182,>,24
70,12,56.333333333333336,31.666666666666668,>,24.666666666666668,35,11,>,24,87,60,>,27,43.333333333333336,39.666666666666664,>,3.6666666666666714,37,31,>,6,54,48,>,6,182,206,<,-24
0,12,31.666666666666668,30.333333333333332,>,1.3333333333333357,11,23,<,-12,60,42,>,18,39.666666666666664,40.666666666666664,<,-1.0,31,32,<,-1,48,56,<,-8,206,271,<,-65
89,12,30.333333333333332,31.666666666666668,<,-1.3333333333333357,23,11,>,12,42,60,<,-18,40.666666666666664,39.666666666666664,>,1.0,32,31,>,1,56,48,>,8,271,206,>,65
0,12,31.666666666666668,21.333333333333332,>,10.333333333333336,11,14,<,-3,60,35,>,25,39.666666666666664,50.333333333333336,<,-10.666666666666671,31,48,<,-17,48,53,<,-5,206,152,>,54
0,12,21.333333333333332,31.666666666666668,<,-10.333333333333336,14,11,>,3,35,60,<,-25,50.333333333333336,39.666666666666664,>,10.666666666666671,48,31,>,17,53,48,>,5,152,206,<,-54
0,12,31.666666666666668,36.0,<,-4.333333333333332,11,21,<,-10,60,62,<,-2,39.666666666666664,40.333333333333336,<,-0.6666666666666714,31,30,>,1,48,52,<,-4,206,244,<,-38
69,12,36.0,31.666666666666668,>,4.333333333333332,21,11,>,10,62,60,>,2,40.333333333333336,39.666666666666664,>,0.6666666666666714,30,31,<,-1,52,48,>,4,244,206,>,38
0,12,31.666666666666668,51.666666666666664,<,-19.999999999999996,11,33,<,-22,60,70,<,-10,39.666666666666664,47.666666666666664,<,-8.0,31,34,<,-3,48,58,<,-10,206,108,>,98
130,12,51.666666666666664,31.666666666666668,>,19.999999999999996,33,11,>,22,70,60,>,10,47.666666666666664,39.666666666666664,>,8.0,34,31,>,3,58,48,>,10,108,206,<,-98
0,12,31.666666666666668,53.333333333333336,<,-21.666666666666668,11,28,<,-17,60,78,<,-18,39.666666666666664,36.666666666666664,>,3.0,31,33,<,-2,48,39,>,9,206,242,<,-36
66,12,53.333333333333336,31.666666666666668,>,21.666666666666668,28,11,>,17,78,60,>,18,36.666666666666664,39.666666666666664,<,-3.0,33,31,>,2,39,48,<,-9,242,206,>,36
0,12,31.666666666666668,75.66666666666667,<,-44.0,11,67,<,-56,60,85,<,-25,39.666666666666664,38.0,>,1.6666666666666643,31,33,<,-2,48,47,>,1,206,181,>,25
166,12,75.66666666666667,31.666666666666668,>,44.0,67,11,>,56,85,60,>,25,38.0,39.666666666666664,<,-1.6666666666666643,33,31,>,2,47,48,<,-1,181,206,<,-25
0,12,31.666666666666668,62.0,<,-30.333333333333332,11,23,<,-12,60,83,<,-23,39.666666666666664,40.666666666666664,<,-1.0,31,35,<,-4,48,48,=,0,206,202,>,4
50,12,62.0,31.666666666666668,>,30.333333333333332,23,11,>,12,83,60,>,23,40.666666666666664,39.666666666666664,>,1.0,35,31,>,4,48,48,=,0,202,206,<,-4
0,11,33.666666666666664,27.333333333333332,>,6.333333333333332,14,11,>,3,72,36,>,36,50.333333333333336,44.0,>,6.333333333333336,48,32,>,16,53,56,<,-3,152,135,>,17
0,11,27.333333333333332,33.666666666666664,<,-6.333333333333332,11,14,<,-3,36,72,<,-36,44.0,50.333333333333336,<,-6.333333333333336,32,48,<,-16,56,53,>,3,135,152,<,-17
0,11,33.666666666666664,42.333333333333336,<,-8.666666666666671,14,21,<,-7,72,83,<,-11,50.333333333333336,40.666666666666664,>,9.666666666666671,48,35,>,13,53,48,>,5,152,202,<,-50
0,11,42.333333333333336,33.666666666666664,>,8.666666666666671,21,14,>,7,83,72,>,11,40.666666666666664,50.333333333333336,<,-9.666666666666671,35,48,<,-13,48,53,<,-5,202,152,>,50
0,11,33.666666666666664,62.666666666666664,<,-29.0,14,39,<,-25,72,76,<,-4,50.333333333333336,47.333333333333336,>,3.0,48,41,>,7,53,53,=,0,152,235,<,-83
57,11,62.666666666666664,33.666666666666664,>,29.0,39,14,>,25,76,72,>,4,47.333333333333336,50.333333333333336,<,-3.0,41,48,<,-7,53,53,=,0,235,152,>,83
0,11,33.666666666666664,57.0,<,-23.333333333333336,14,28,<,-14,72,78,<,-6,50.333333333333336,36.666666666666664,>,13.666666666666671,48,33,>,15,53,39,>,14,152,242,<,-90
66,11,57.0,33.666666666666664,>,23.333333333333336,28,14,>,14,78,72,>,6,36.666666666666664,50.333333333333336,<,-13.666666666666671,33,48,<,-15,39,53,<,-14,242,152,>,90
0,11,33.666666666666664,35.0,<,-1.3333333333333357,14,21,<,-7,72,59,>,13,50.333333333333336,40.333333333333336,>,10.0,48,30,>,18,53,52,>,1,152,244,<,-92
69,11,35.0,33.666666666666664,>,1.3333333333333357,21,14,>,7,59,72,<,-13,40.333333333333336,50.333333333333336,<,-10.0,30,48,<,-18,52,53,<,-1,244,152,>,92
0,11,33.666666666666664,56.666666666666664,<,-23.0,14,35,<,-21,72,87,<,-15,50.333333333333336,43.333333333333336,>,7.0,48,37,>,11,53,54,<,-1,152,182,<,-30
70,11,56.666666666666664,33.666666666666664,>,23.0,35,14,>,21,87,72,>,15,43.333333333333336,50.333333333333336,<,-7.0,37,48,<,-11,54,53,>,1,182,152,>,30
0,11,33.666666666666664,31.0,>,2.6666666666666643,14,23,<,-9,72,42,>,30,50.333333333333336,40.666666666666664,>,9.666666666666671,48,32,>,16,53,56,<,-3,152,271,<,-119
60,11,31.0,33.666666666666664,<,-2.6666666666666643,23,14,>,9,42,72,<,-30,40.666666666666664,50.333333333333336,<,-9.666666666666671,32,48,<,-16,56,53,>,3,271,152,>,119
0,11,33.666666666666664,39.666666666666664,<,-6.0,14,16,<,-2,72,70,>,2,50.333333333333336,47.666666666666664,>,2.6666666666666714,48,34,>,14,53,58,<,-5,152,108,>,44
32,11,39.666666666666664,33.666666666666664,>,6.0,16,14,>,2,70,72,<,-2,47.666666666666664,50.333333333333336,<,-2.6666666666666714,34,48,<,-14,58,53,>,5,108,152,<,-44
0,11,33.666666666666664,47.666666666666664,<,-14.0,14,25,<,-11,72,67,>,5,50.333333333333336,46.0,>,4.333333333333336,48,38,>,10,53,58,<,-5,152,153,<,-1
96,11,47.666666666666664,33.666666666666664,>,14.0,25,14,>,11,67,72,<,-5,46.0,50.333333333333336,<,-4.333333333333336,38,48,<,-10,58,53,>,5,153,152,>,1
0,11,33.666666666666664,79.66666666666667,<,-46.00000000000001,14,75,<,-61,72,85,<,-13,50.333333333333336,38.0,>,12.333333333333336,48,33,>,15,53,47,>,6,152,181,<,-29
120,11,79.66666666666667,33.666666666666664,>,46.00000000000001,75,14,>,61,85,72,>,13,38.0,50.333333333333336,<,-12.333333333333336,33,48,<,-15,47,53,<,-6,181,152,>,29
0,10,58.333333333333336,27.333333333333332,>,31.000000000000004,21,11,>,10,83,36,>,47,40.666666666666664,44.0,<,-3.3333333333333357,35,32,>,3,48,56,<,-8,202,135,>,67
0,10,27.333333333333332,58.333333333333336,<,-31.000000000000004,11,21,<,-10,36,83,<,-47,44.0,40.666666666666664,>,3.3333333333333357,32,35,<,-3,56,48,>,8,135,202,<,-67
0,10,58.333333333333336,29.333333333333332,>,29.000000000000004,21,16,>,5,83,39,>,44,40.666666666666664,47.666666666666664,<,-7.0,35,34,>,1,48,58,<,-10,202,108,>,94
28,10,29.333333333333332,58.333333333333336,<,-29.000000000000004,16,21,<,-5,39,83,<,-44,47.666666666666664,40.666666666666664,>,7.0,34,35,<,-1,58,48,>,10,108,202,<,-94
0,10,58.333333333333336,66.0,<,-7.666666666666664,21,49,<,-28,83,76,>,7,40.666666666666664,47.333333333333336,<,-6.666666666666671,35,41,<,-6,48,53,<,-5,202,235,<,-33
45,10,66.0,58.333333333333336,>,7.666666666666664,49,21,>,28,76,83,<,-7,47.333333333333336,40.666666666666664,>,6.666666666666671,41,35,>,6,53,48,>,5,235,202,>,33
0,10,58.333333333333336,38.666666666666664,>,19.66666666666667,21,23,<,-2,83,65,>,18,40.666666666666664,40.666666666666664,=,0.0,35,32,>,3,48,56,<,-8,202,271,<,-69
55,10,38.666666666666664,58.333333333333336,<,-19.66666666666667,23,21,>,2,65,83,<,-18,40.666666666666664,40.666666666666664,=,0.0,32,35,<,-3,56,48,>,8,271,202,>,69
0,10,58.333333333333336,69.66666666666667,<,-11.333333333333336,21,65,<,-44,83,78,>,5,40.666666666666664,36.666666666666664,>,4.0,35,33,>,2,48,39,>,9,202,242,<,-40
101,10,69.66666666666667,58.333333333333336,>,11.333333333333336,65,21,>,44,78,83,<,-5,36.666666666666664,40.666666666666664,<,-4.0,33,35,<,-2,39,48,<,-9,242,202,>,40
0,10,58.333333333333336,47.333333333333336,>,11.0,21,21,=,0,83,62,>,21,40.666666666666664,40.333333333333336,>,0.3333333333333286,35,30,>,5,48,52,<,-4,202,244,<,-42
115,10,47.333333333333336,58.333333333333336,<,-11.0,21,21,=,0,62,83,<,-21,40.333333333333336,40.666666666666664,<,-0.3333333333333286,30,35,<,-5,52,48,>,4,244,202,>,42
0,10,58.333333333333336,67.66666666666667,<,-9.333333333333336,21,48,<,-27,83,87,<,-4,40.666666666666664,43.333333333333336,<,-2.6666666666666714,35,37,<,-2,48,54,<,-6,202,182,>,20
70,10,67.66666666666667,58.333333333333336,>,9.333333333333336,48,21,>,27,87,83,>,4,43.333333333333336,40.666666666666664,>,2.6666666666666714,37,35,>,2,54,48,>,6,182,202,<,-20
0,10,58.333333333333336,50.333333333333336,>,8.0,21,25,<,-4,83,75,>,8,40.666666666666664,46.0,<,-5.333333333333336,35,38,<,-3,48,58,<,-10,202,153,>,49
96,10,50.333333333333336,58.333333333333336,<,-8.0,25,21,>,4,75,83,<,-8,46.0,40.666666666666664,>,5.333333333333336,38,35,>,3,58,48,>,10,153,202,<,-49
0,10,58.333333333333336,62.0,<,-3.6666666666666643,21,22,<,-1,83,85,<,-2,40.666666666666664,38.0,>,2.6666666666666643,35,33,>,2,48,47,>,1,202,181,>,21
0,10,62.0,58.333333333333336,>,3.6666666666666643,22,21,>,1,85,83,>,2,38.0,40.666666666666664,<,-2.6666666666666643,33,35,<,-2,47,48,<,-1,181,202,<,-21
0,9,47.0,26.0,>,21.0,22,11,>,11,85,36,>,49,38.0,44.0,<,-6.0,33,32,>,1,47,56,<,-9,181,135,>,46
0,9,26.0,47.0,<,-21.0,11,22,<,-11,36,85,<,-49,44.0,38.0,>,6.0,32,33,<,-1,56,47,>,9,135,181,<,-46
0,9,47.0,38.666666666666664,>,8.333333333333336,22,33,<,-11,85,44,>,41,38.0,47.666666666666664,<,-9.666666666666664,33,34,<,-1,47,58,<,-11,181,108,>,73
28,9,38.666666666666664,47.0,<,-8.333333333333336,33,22,>,11,44,85,<,-41,47.666666666666664,38.0,>,9.666666666666664,34,33,>,1,58,47,>,11,108,181,<,-73
0,9,47.0,53.333333333333336,<,-6.333333333333336,22,35,<,-13,85,76,>,9,38.0,47.333333333333336,<,-9.333333333333336,33,41,<,-8,47,53,<,-6,181,235,<,-54
20,9,53.333333333333336,47.0,>,6.333333333333336,35,22,>,13,76,85,<,-9,47.333333333333336,38.0,>,9.333333333333336,41,33,>,8,53,47,>,6,235,181,>,54
0,9,47.0,33.0,>,14.0,22,11,>,11,85,65,>,20,38.0,40.666666666666664,<,-2.6666666666666643,33,32,>,1,47,56,<,-9,181,271,<,-90
19,9,33.0,47.0,<,-14.0,11,22,<,-11,65,85,<,-20,40.666666666666664,38.0,>,2.6666666666666643,32,33,<,-1,56,47,>,9,271,181,>,90
0,9,47.0,61.666666666666664,<,-14.666666666666664,22,30,<,-8,85,87,<,-2,38.0,43.333333333333336,<,-5.333333333333336,33,37,<,-4,47,54,<,-7,181,182,<,-1
0,9,61.666666666666664,47.0,>,14.666666666666664,30,22,>,8,87,85,>,2,43.333333333333336,38.0,>,5.333333333333336,37,33,>,4,54,47,>,7,182,181,>,1
0,9,47.0,70.33333333333333,<,-23.33333333333333,22,51,<,-29,85,85,=,0,38.0,46.0,<,-8.0,33,38,<,-5,47,58,<,-11,181,153,>,28
109,9,70.33333333333333,47.0,>,23.33333333333333,51,22,>,29,85,85,=,0,46.0,38.0,>,8.0,38,33,>,5,58,47,>,11,153,181,<,-28
0,9,47.0,62.333333333333336,<,-15.333333333333336,22,43,<,-21,85,78,>,7,38.0,36.666666666666664,>,1.3333333333333357,33,33,=,0,47,39,>,8,181,242,<,-61
56,9,62.333333333333336,47.0,>,15.333333333333336,43,22,>,21,78,85,<,-7,36.666666666666664,38.0,<,-1.3333333333333357,33,33,=,0,39,47,<,-8,242,181,>,61
0,9,47.0,33.0,>,14.0,22,16,>,6,85,62,>,23,38.0,40.333333333333336,<,-2.3333333333333357,33,30,>,3,47,52,<,-5,181,244,<,-63
72,9,33.0,47.0,<,-14.0,16,22,<,-6,62,85,<,-23,40.333333333333336,38.0,>,2.3333333333333357,30,33,<,-3,52,47,>,5,244,181,>,63
0,8,47.333333333333336,21.333333333333332,>,26.000000000000004,25,11,>,14,87,31,>,56,43.333333333333336,44.0,<,-0.6666666666666643,37,32,>,5,54,56,<,-2,182,135,>,47
0,8,21.333333333333332,47.333333333333336,<,-26.000000000000004,11,25,<,-14,31,87,<,-56,44.0,43.333333333333336,>,0.6666666666666643,32,37,<,-5,56,54,>,2,135,182,<,-47
0,8,47.333333333333336,20.0,>,27.333333333333336,25,11,>,14,87,26,>,61,43.333333333333336,40.666666666666664,>,2.6666666666666714,37,32,>,5,54,56,<,-2,182,271,<,-89
0,8,20.0,47.333333333333336,<,-27.333333333333336,11,25,<,-14,26,87,<,-61,40.666666666666664,43.333333333333336,<,-2.6666666666666714,32,37,<,-5,56,54,>,2,271,182,>,89
0,8,47.333333333333336,44.333333333333336,>,3.0,25,22,>,3,87,76,>,11,43.333333333333336,47.333333333333336,<,-4.0,37,41,<,-4,54,53,>,1,182,235,<,-53
19,8,44.333333333333336,47.333333333333336,<,-3.0,22,25,<,-3,76,87,<,-11,47.333333333333336,43.333333333333336,>,4.0,41,37,>,4,53,54,<,-1,235,182,>,53
0,8,47.333333333333336,39.666666666666664,>,7.666666666666671,25,33,<,-8,87,44,>,43,43.333333333333336,47.666666666666664,<,-4.333333333333329,37,34,>,3,54,58,<,-4,182,108,>,74
35,8,39.666666666666664,47.333333333333336,<,-7.666666666666671,33,25,>,8,44,87,<,-43,47.666666666666664,43.333333333333336,>,4.333333333333329,34,37,<,-3,58,54,>,4,108,182,<,-74
0,8,47.333333333333336,66.33333333333333,<,-18.999999999999993,25,43,<,-18,87,78,>,9,43.333333333333336,36.666666666666664,>,6.666666666666671,37,33,>,4,54,39,>,15,182,242,<,-60
56,8,66.33333333333333,47.333333333333336,>,18.999999999999993,43,25,>,18,78,87,<,-9,36.666666666666664,43.333333333333336,<,-6.666666666666671,33,37,<,-4,39,54,<,-15,242,182,>,60
0,8,47.333333333333336,20.666666666666668,>,26.666666666666668,25,16,>,9,87,25,>,62,43.333333333333336,40.333333333333336,>,3.0,37,30,>,7,54,52,>,2,182,244,<,-62
72,8,20.666666666666668,47.333333333333336,<,-26.666666666666668,16,25,<,-9,25,87,<,-62,40.333333333333336,43.333333333333336,<,-3.0,30,37,<,-7,52,54,<,-2,244,182,>,62
0,8,47.333333333333336,69.33333333333333,<,-21.999999999999993,25,51,<,-26,87,85,>,2,43.333333333333336,46.0,<,-2.6666666666666643,37,38,<,-1,54,58,<,-4,182,153,>,29
97,8,69.33333333333333,47.333333333333336,>,21.999999999999993,51,25,>,26,85,87,<,-2,46.0,43.333333333333336,>,2.6666666666666643,38,37,>,1,58,54,>,4,153,182,<,-29
0,7,39.0,21.333333333333332,>,17.666666666666668,23,11,>,12,68,31,>,37,40.666666666666664,44.0,<,-3.3333333333333357,32,32,=,0,56,56,=,0,271,135,>,136
0,7,21.333333333333332,39.0,<,-17.666666666666668,11,23,<,-12,31,68,<,-37,44.0,40.666666666666664,>,3.3333333333333357,32,32,=,0,56,56,=,0,135,271,<,-136
0,7,39.0,36.0,>,3.0,23,10,>,13,68,76,<,-8,40.666666666666664,47.333333333333336,<,-6.666666666666671,32,41,<,-9,56,53,>,3,271,235,>,36
0,7,36.0,39.0,<,-3.0,10,23,<,-13,76,68,>,8,47.333333333333336,40.666666666666664,>,6.666666666666671,41,32,>,9,53,56,<,-3,235,271,<,-36
0,7,39.0,50.666666666666664,<,-11.666666666666664,23,33,<,-10,68,77,<,-9,40.666666666666664,47.666666666666664,<,-7.0,32,34,<,-2,56,58,<,-2,271,108,>,163
35,7,50.666666666666664,39.0,>,11.666666666666664,33,23,>,10,77,68,>,9,47.666666666666664,40.666666666666664,>,7.0,34,32,>,2,58,56,>,2,108,271,<,-163
0,7,39.0,69.33333333333333,<,-30.33333333333333,23,52,<,-29,68,78,<,-10,40.666666666666664,36.666666666666664,>,4.0,32,33,<,-1,56,39,>,17,271,242,>,29
73,7,69.33333333333333,39.0,>,30.33333333333333,52,23,>,29,78,68,>,10,36.666666666666664,40.666666666666664,<,-4.0,33,32,>,1,39,56,<,-17,242,271,<,-29
0,7,39.0,41.333333333333336,<,-2.3333333333333357,23,21,>,2,68,78,<,-10,40.666666666666664,40.333333333333336,>,0.3333333333333286,32,30,>,2,56,52,>,4,271,244,>,27
79,7,41.333333333333336,39.0,>,2.3333333333333357,21,23,<,-2,78,68,>,10,40.333333333333336,40.666666666666664,<,-0.3333333333333286,30,32,<,-2,52,56,<,-4,244,271,<,-27
0,7,39.0,63.0,<,-24.0,23,51,<,-28,68,72,<,-4,40.666666666666664,46.0,<,-5.333333333333336,32,38,<,-6,56,58,<,-2,271,153,>,118
127,7,63.0,39.0,>,24.0,51,23,>,28,72,68,>,4,46.0,40.666666666666664,>,5.333333333333336,38,32,>,6,58,56,>,2,153,271,<,-118
0,6,41.0,18.0,>,23.0,10,11,<,-1,76,31,>,45,47.333333333333336,44.0,>,3.3333333333333357,41,32,>,9,53,56,<,-3,235,135,>,100
0,6,18.0,41.0,<,-23.0,11,10,>,1,31,76,<,-45,44.0,47.333333333333336,<,-3.3333333333333357,32,41,<,-9,56,53,>,3,135,235,<,-100
0,6,41.0,47.0,<,-6.0,10,31,<,-21,76,77,<,-1,47.333333333333336,47.666666666666664,<,-0.3333333333333286,41,34,>,7,53,58,<,-5,235,108,>,127
50,6,47.0,41.0,>,6.0,31,10,>,21,77,76,>,1,47.666666666666664,47.333333333333336,>,0.3333333333333286,34,41,<,-7,58,53,>,5,108,235,<,-127
0,6,41.0,46.666666666666664,<,-5.666666666666664,10,10,=,0,76,78,<,-2,47.333333333333336,36.666666666666664,>,10.666666666666671,41,33,>,8,53,39,>,14,235,242,<,-7
65,6,46.666666666666664,41.0,>,5.666666666666664,10,10,=,0,78,76,>,2,36.666666666666664,47.333333333333336,<,-10.666666666666671,33,41,<,-8,39,53,<,-14,242,235,>,7
0,6,41.0,47.666666666666664,<,-6.666666666666664,10,21,<,-11,76,78,<,-2,47.333333333333336,40.333333333333336,>,7.0,41,30,>,11,53,52,>,1,235,244,<,-9
117,6,47.666666666666664,41.0,>,6.666666666666664,21,10,>,11,78,76,>,2,40.333333333333336,47.333333333333336,<,-7.0,30,41,<,-11,52,53,<,-1,244,235,>,9
0,6,41.0,53.0,<,-12.0,10,42,<,-32,76,66,>,10,47.333333333333336,46.0,>,1.3333333333333357,41,38,>,3,53,58,<,-5,235,153,>,82
123,6,53.0,41.0,>,12.0,42,10,>,32,66,76,<,-10,46.0,47.333333333333336,<,-1.3333333333333357,38,41,<,-3,58,53,>,5,153,235,<,-82
0,5,16.333333333333332,33.666666666666664,<,-17.333333333333332,11,31,<,-20,26,37,<,-11,44.0,47.666666666666664,<,-3.6666666666666643,32,34,<,-2,56,58,<,-2,135,108,>,27
60,5,33.666666666666664,16.333333333333332,>,17.333333333333332,31,11,>,20,37,26,>,11,47.666666666666664,44.0,>,3.6666666666666643,34,32,>,2,58,56,>,2,108,135,<,-27
0,5,16.333333333333332,57.333333333333336,<,-41.0,11,10,>,1,26,84,<,-58,44.0,36.666666666666664,>,7.333333333333336,32,33,<,-1,56,39,>,17,135,242,<,-107
65,5,57.333333333333336,16.333333333333332,>,41.0,10,11,<,-1,84,26,>,58,36.666666666666664,44.0,<,-7.333333333333336,33,32,>,1,39,56,<,-17,242,135,>,107
0,5,16.333333333333332,29.666666666666668,<,-13.333333333333336,11,21,<,-10,26,44,<,-18,44.0,40.333333333333336,>,3.6666666666666643,32,30,>,2,56,52,>,4,135,244,<,-109
117,5,29.666666666666668,16.333333333333332,>,13.333333333333336,21,11,>,10,44,26,>,18,40.333333333333336,44.0,<,-3.6666666666666643,30,32,<,-2,52,56,<,-4,244,135,>,109
0,5,16.333333333333332,58.0,<,-41.66666666666667,11,42,<,-31,26,81,<,-55,44.0,46.0,<,-2.0,32,38,<,-6,56,58,<,-2,135,153,<,-18
136,5,58.0,16.333333333333332,>,41.66666666666667,42,11,>,31,81,26,>,55,46.0,44.0,>,2.0,38,32,>,6,58,56,>,2,153,135,>,18
0,4,45.333333333333336,32.666666666666664,>,12.666666666666671,13,30,<,-17,81,37,>,44,46.0,47.666666666666664,<,-1.6666666666666643,38,34,>,4,58,58,=,0,153,108,>,45
60,4,32.666666666666664,45.333333333333336,<,-12.666666666666671,30,13,>,17,37,81,<,-44,47.666666666666664,46.0,>,1.6666666666666643,34,38,<,-4,58,58,=,0,108,153,<,-45
0,4,45.333333333333336,46.666666666666664,<,-1.3333333333333286,13,10,>,3,81,84,<,-3,46.0,36.666666666666664,>,9.333333333333336,38,33,>,5,58,39,>,19,153,242,<,-89
65,4,46.666666666666664,45.333333333333336,>,1.3333333333333286,10,13,<,-3,84,81,>,3,36.666666666666664,46.0,<,-9.333333333333336,33,38,<,-5,39,58,<,-19,242,153,>,89
0,4,45.333333333333336,46.333333333333336,<,-1.0,13,24,<,-11,81,71,>,10,46.0,40.333333333333336,>,5.666666666666664,38,30,>,8,58,52,>,6,153,244,<,-91
117,4,46.333333333333336,45.333333333333336,>,1.0,24,13,>,11,71,81,<,-10,40.333333333333336,46.0,<,-5.666666666666664,30,38,<,-8,52,58,<,-6,244,153,>,91
0,3,28.666666666666668,32.666666666666664,<,-3.9999999999999964,18,30,<,-12,44,37,>,7,40.333333333333336,47.666666666666664,<,-7.333333333333329,30,34,<,-4,52,58,<,-6,244,108,>,136
60,3,32.666666666666664,28.666666666666668,>,3.9999999999999964,30,18,>,12,37,44,<,-7,47.666666666666664,40.333333333333336,>,7.333333333333329,34,30,>,4,58,52,>,6,108,244,<,-136
0,3,28.666666666666668,42.0,<,-13.333333333333332,18,10,>,8,44,84,<,-40,40.333333333333336,36.666666666666664,>,3.6666666666666714,30,33,<,-3,52,39,>,13,244,242,>,2
32,3,42.0,28.666666666666668,>,13.333333333333332,10,18,<,-8,84,44,>,40,36.666666666666664,40.333333333333336,<,-3.6666666666666714,33,30,>,3,39,52,<,-13,242,244,<,-2
0,2,35.666666666666664,28.333333333333332,>,7.333333333333332,10,17,<,-7,84,37,>,47,36.666666666666664,47.666666666666664,<,-11.0,33,34,<,-1,39,58,<,-19,242,108,>,134
26,2,28.333333333333332,35.666666666666664,<,-7.333333333333332,17,10,>,7,37,84,<,-47,47.666666666666664,36.666666666666664,>,11.0,34,33,>,1,58,39,>,19,108,242,<,-134
0,17,0.0,0.0,=,0.0,0,0,=,0,0,0,=,0,51.333333333333336,40.333333333333336,>,11.0,43,34,>,9,60,48,>,12,106,265,<,-159
112,17,0.0,0.0,=,0.0,0,0,=,0,0,0,=,0,40.333333333333336,51.333333333333336,<,-11.0,34,43,<,-9,48,60,<,-12,265,106,>,159
0,17,0.0,0.0,=,0.0,0,0,=,0,0,0,=,0,51.333333333333336,41.0,>,10.333333333333336,43,31,>,12,60,57,>,3,106,272,<,-166
121,17,0.0,0.0,=,0.0,0,0,=,0,0,0,=,0,41.0,51.333333333333336,<,-10.333333333333336,31,43,<,-12,57,60,<,-3,272,106,>,166
0,17,0.0,0.0,=,0.0,0,0,=,0,0,0,=,0,51.333333333333336,45.333333333333336,>,6.0,43,39,>,4,60,55,>,5,106,136,<,-30
0,17,0.0,0.0,=,0.0,0,0,=,0,0,0,=,0,45.333333333333336,51.333333333333336,<,-6.0,39,43,<,-4,55,60,<,-5,136,106,>,30
0,17,0.0,0.0,=,0.0,0,0,=,0,0,0,=,0,51.333333333333336,45.666666666666664,>,5.666666666666671,43,45,<,-2,60,47,>,13,106,142,<,-36
9,17,0.0,0.0,=,0.0,0,0,=,0,0,0,=,0,45.666666666666664,51.333333333333336,<,-5.666666666666671,45,43,>,2,47,60,<,-13,142,106,>,36
0,17,0.0,0.0,=,0.0,0,0,=,0,0,0,=,0,51.333333333333336,42.333333333333336,>,9.0,43,31,>,12,60,53,>,7,106,96,>,10
0,17,0.0,0.0,=,0.0,0,0,=,0,0,0,=,0,42.333333333333336,51.333333333333336,<,-9.0,31,43,<,-12,53,60,<,-7,96,106,<,-10
0,17,0.0,0.0,=,0.0,0,0,=,0,0,0,=,0,51.333333333333336,44.0,>,7.333333333333336,43,34,>,9,60,51,>,9,106,195,<,-89
90,17,0.0,0.0,=,0.0,0,0,=,0,0,0,=,0,44.0,51.333333333333336,<,-7.333333333333336,34,43,<,-9,51,60,<,-9,195,106,>,89
0,17,0.0,0.0,=,0.0,0,0,=,0,0,0,=,0,51.333333333333336,46.0,>,5.333333333333336,43,37,>,6,60,55,>,5,106,255,<,-149
107,17,0.0,0.0,=,0.0,0,0,=,0,0,0,=,0,46.0,51.333333333333336,<,-5.333333333333336,37,43,<,-6,55,60,<,-5,255,106,>,149
0,17,0.0,0.0,=,0.0,0,0,=,0,0,0,=,0,51.333333333333336,39.333333333333336,>,12.0,43,32,>,11,60,49,>,11,106,105,>,1
1,17,0.0,0.0,=,0.0,0,0,=,0,0,0,=,0,39.333333333333336,51.333333333333336,<,-12.0,32,43,<,-11,49,60,<,-11,105,106,<,-1
0,17,0.0,0.0,=,0.0,0,0,=,0,0,0,=,0,51.333333333333336,48.0,>,3.3333333333333357,43,36,>,7,60,60,=,0,106,157,<,-51
47,17,0.0,0.0,=,0.0,0,0,=,0,0,0,=,0,48.0,51.333333333333336,<,-3.3333333333333357,36,43,<,-7,60,60,=,0,157,106,>,51
0,17,0.0,0.0,=,0.0,0,0,=,0,0,0,=,0,51.333333333333336,56.666666666666664,<,-5.333333333333329,43,54,<,-11,60,59,>,1,106,212,<,-106
77,17,0.0,0.0,=,0.0,0,0,=,0,0,0,=,0,56.666666666666664,51.333333333333336,>,5.333333333333329,54,43,>,11,59,60,<,-1,212,106,>,106
0,17,0.0,0.0,=,0.0,0,0,=,0,0,0,=,0,51.333333333333336,49.0,>,2.3333333333333357,43,46,<,-3,60,55,>,5,106,238,<,-132
71,17,0.0,0.0,=,0.0,0,0,=,0,0,0,=,0,49.0,51.333333333333336,<,-2.3333333333333357,46,43,>,3,55,60,<,-5,238,106,>,132
0,17,0.0,0.0,=,0.0,0,0,=,0,0,0,=,0,51.333333333333336,41.333333333333336,>,10.0,43,32,>,11,60,60,=,0,106,133,<,-27
1,17,0.0,0.0,=,0.0,0,0,=,0,0,0,=,0,41.333333333333336,51.333333333333336,<,-10.0,32,43,<,-11,60,60,=,0,133,106,>,27
0,17,0.0,0.0,=,0.0,0,0,=,0,0,0,=,0,51.333333333333336,54.333333333333336,<,-3.0,43,53,<,-10,60,56,>,4,106,129,<,-23
74,17,0.0,0.0,=,0.0,0,0,=,0,0,0,=,0,54.333333333333336,51.333333333333336,>,3.0,53,43,>,10,56,60,<,-4,129,106,>,23
0,17,0.0,0.0,=,0.0,0,0,=,0,0,0,=,0,51.333333333333336,42.333333333333336,>,9.0,43,33,>,10,60,51,>,9,106,130,<,-24
37,17,0.0,0.0,=,0.0,0,0,=,0,0,0,=,0,42.333333333333336,51.333333333333336,<,-9.0,33,43,<,-10,51,60,<,-9,130,106,>,24
0,17,0.0,0.0,=,0.0,0,0,=,0,0,0,=,0,51.333333333333336,51.333333333333336,=,0.0,43,39,>,4,60,59,>,1,106,245,<,-139
66,17,0.0,0.0,=,0.0,0,0,=,0,0,0,=,0,51.333333333333336,51.333333333333336,=,0.0,39,43,<,-4,59,60,<,-1,245,106,>,139
0,17,0.0,0.0,=,0.0,0,0,=,0,0,0,=,0,51.333333333333336,42.666666666666664,>,8.666666666666671,43,33,>,10,60,54,>,6,106,110,<,-4
68,17,0.0,0.0,=,0.0,0,0,=,0,0,0,=,0,42.666666666666664,51.333333333333336,<,-8.666666666666671,33,43,<,-10,54,60,<,-6,110,106,>,4
0,16,23.666666666666668,8.333333333333334,>,15.333333333333334,0,0,=,0,71,25,>,46,45.333333333333336,42.333333333333336,>,3.0,39,31,>,8,55,53,>,2,136,96,>,40
0,16,8.333333333333334,23.666666666666668,<,-15.333333333333334,0,0,=,0,25,71,<,-46,42.333333333333336,45.333333333333336,<,-3.0,31,39,<,-8,53,55,<,-2,96,136,<,-40
0,16,23.666666666666668,22.0,>,1.6666666666666679,0,0,=,0,71,66,>,5,45.333333333333336,39.333333333333336,>,6.0,39,32,>,7,55,49,>,6,136,105,>,31
89,16,22.0,23.666666666666668,<,-1.6666666666666679,0,0,=,0,66,71,<,-5,39.333333333333336,45.333333333333336,<,-6.0,32,39,<,-7,49,55,<,-6,105,136,<,-31
0,16,23.666666666666668,5.0,>,18.666666666666668,0,0,=,0,71,15,>,56,45.333333333333336,41.333333333333336,>,4.0,39,32,>,7,55,60,<,-5,136,133,>,3
0,16,5.0,23.666666666666668,<,-18.666666666666668,0,0,=,0,15,71,<,-56,41.333333333333336,45.333333333333336,<,-4.0,32,39,<,-7,60,55,>,5,133,136,<,-3
0,16,23.666666666666668,16.666666666666668,>,7.0,0,0,=,0,71,50,>,21,45.333333333333336,45.666666666666664,<,-0.3333333333333286,39,45,<,-6,55,47,>,8,136,142,<,-6
73,16,16.666666666666668,23.666666666666668,<,-7.0,0,0,=,0,50,71,<,-21,45.666666666666664,45.333333333333336,>,0.3333333333333286,45,39,>,6,47,55,<,-8,142,136,>,6
0,16,23.666666666666668,27.666666666666668,<,-4.0,0,0,=,0,71,83,<,-12,45.333333333333336,42.333333333333336,>,3.0,39,33,>,6,55,51,>,4,136,130,>,6
58,16,27.666666666666668,23.666666666666668,>,4.0,0,0,=,0,83,71,>,12,42.333333333333336,45.333333333333336,<,-3.0,33,39,<,-6,51,55,<,-4,130,136,<,-6
0,16,23.666666666666668,14.333333333333334,>,9.333333333333334,0,0,=,0,71,43,>,28,45.333333333333336,48.0,<,-2.6666666666666643,39,36,>,3,55,60,<,-5,136,157,<,-21
105,16,14.333333333333334,23.666666666666668,<,-9.333333333333334,0,0,=,0,43,71,<,-28,48.0,45.333333333333336,>,2.6666666666666643,36,39,<,-3,60,55,>,5,157,136,>,21
0,16,23.666666666666668,10.333333333333334,>,13.333333333333334,0,0,=,0,71,31,>,40,45.333333333333336,51.333333333333336,<,-6.0,39,39,=,0,55,59,<,-4,136,245,<,-109
142,16,10.333333333333334,23.666666666666668,<,-13.333333333333334,0,0,=,0,31,71,<,-40,51.333333333333336,45.333333333333336,>,6.0,39,39,=,0,59,55,>,4,245,136,>,109
0,16,23.666666666666668,5.333333333333333,>,18.333333333333336,0,0,=,0,71,16,>,55,45.333333333333336,42.666666666666664,>,2.6666666666666714,39,33,>,6,55,54,>,1,136,110,>,26
68,16,5.333333333333333,23.666666666666668,<,-18.333333333333336,0,0,=,0,16,71,<,-55,42.666666666666664,45.333333333333336,<,-2.6666666666666714,33,39,<,-6,54,55,<,-1,110,136,<,-26
0,16,23.666666666666668,30.0,<,-6.333333333333332,0,0,=,0,71,90,<,-19,45.333333333333336,49.0,<,-3.6666666666666643,39,46,<,-7,55,55,=,0,136,238,<,-102
97,16,30.0,23.666666666666668,>,6.333333333333332,0,0,=,0,90,71,>,19,49.0,45.333333333333336,>,3.6666666666666643,46,39,>,7,55,55,=,0,238,136,>,102
0,16,23.666666666666668,26.0,<,-2.333333333333332,0,0,=,0,71,78,<,-7,45.333333333333336,54.333333333333336,<,-9.0,39,53,<,-14,55,56,<,-1,136,129,>,7
59,16,26.0,23.666666666666668,>,2.333333333333332,0,0,=,0,78,71,>,7,54.333333333333336,45.333333333333336,>,9.0,53,39,>,14,56,55,>,1,129,136,<,-7
0,16,23.666666666666668,14.0,>,9.666666666666668,0,0,=,0,71,42,>,29,45.333333333333336,56.666666666666664,<,-11.333333333333329,39,54,<,-15,55,59,<,-4,136,212,<,-76
77,16,14.0,23.666666666666668,<,-9.666666666666668,0,0,=,0,42,71,<,-29,56.666666666666664,45.333333333333336,>,11.333333333333329,54,39,>,15,59,55,>,4,212,136,>,76
0,16,23.666666666666668,13.666666666666666,>,10.000000000000002,0,0,=,0,71,41,>,30,45.333333333333336,44.0,>,1.3333333333333357,39,34,>,5,55,51,>,4,136,195,<,-59
121,16,13.666666666666666,23.666666666666668,<,-10.000000000000002,0,0,=,0,41,71,<,-30,44.0,45.333333333333336,<,-1.3333333333333357,34,39,<,-5,51,55,<,-4,195,136,>,59
0,16,23.666666666666668,8.0,>,15.666666666666668,0,0,=,0,71,24,>,47,45.333333333333336,46.0,<,-0.6666666666666643,39,37,>,2,55,55,=,0,136,255,<,-119
81,16,8.0,23.666666666666668,<,-15.666666666666668,0,0,=,0,24,71,<,-47,46.0,45.333333333333336,>,0.6666666666666643,37,39,<,-2,55,55,=,0,255,136,>,119
0,16,23.666666666666668,30.0,<,-6.333333333333332,0,0,=,0,71,90,<,-19,45.333333333333336,40.333333333333336,>,5.0,39,34,>,5,55,48,>,7,136,265,<,-129
175,16,30.0,23.666666666666668,>,6.333333333333332,0,0,=,0,90,71,>,19,40.333333333333336,45.333333333333336,<,-5.0,34,39,<,-5,48,55,<,-7,265,136,>,129
0,16,23.666666666666668,14.666666666666666,>,9.000000000000002,0,0,=,0,71,44,>,27,45.333333333333336,41.0,>,4.333333333333336,39,31,>,8,55,57,<,-2,136,272,<,-136
180,16,14.666666666666666,23.666666666666668,<,-9.000000000000002,0,0,=,0,44,71,<,-27,41.0,45.333333333333336,<,-4.333333333333336,31,39,<,-8,57,55,>,2,272,136,>,136
0,15,15.0,23.666666666666668,<,-8.666666666666668,0,0,=,0,25,56,<,-31,42.333333333333336,41.333333333333336,>,1.0,31,32,<,-1,53,60,<,-7,96,133,<,-37
0,15,23.666666666666668,15.0,>,8.666666666666668,0,0,=,0,56,25,>,31,41.333333333333336,42.333333333333336,<,-1.0,32,31,>,1,60,53,>,7,133,96,>,37
0,15,15.0,44.333333333333336,<,-29.333333333333336,0,0,=,0,25,83,<,-58,42.333333333333336,42.333333333333336,=,0.0,31,33,<,-2,53,51,>,2,96,130,<,-34
53,15,44.333333333333336,15.0,>,29.333333333333336,0,0,=,0,83,25,>,58,42.333333333333336,42.333333333333336,=,0.0,33,31,>,2,51,53,<,-2,130,96,>,34
0,15,15.0,33.333333333333336,<,-18.333333333333336,0,0,=,0,25,78,<,-53,42.333333333333336,54.333333333333336,<,-12.0,31,53,<,-22,53,56,<,-3,96,129,<,-33
89,15,33.333333333333336,15.0,>,18.333333333333336,0,0,=,0,78,25,>,53,54.333333333333336,42.333333333333336,>,12.0,53,31,>,22,56,53,>,3,129,96,>,33
0,15,15.0,12.666666666666666,>,2.333333333333334,0,0,=,0,25,22,>,3,42.333333333333336,42.666666666666664,<,-0.3333333333333286,31,33,<,-2,53,54,<,-1,96,110,<,-14
0,15,12.666666666666666,15.0,<,-2.333333333333334,0,0,=,0,22,25,<,-3,42.666666666666664,42.333333333333336,>,0.3333333333333286,33,31,>,2,54,53,>,1,110,96,>,14
0,15,15.0,27.666666666666668,<,-12.666666666666668,0,0,=,0,25,50,<,-25,42.333333333333336,45.666666666666664,<,-3.3333333333333286,31,45,<,-14,53,47,>,6,96,142,<,-46
67,15,27.666666666666668,15.0,>,12.666666666666668,0,0,=,0,50,25,>,25,45.666666666666664,42.333333333333336,>,3.3333333333333286,45,31,>,14,47,53,<,-6,142,96,>,46
0,15,15.0,43.666666666666664,<,-28.666666666666664,0,0,=,0,25,89,<,-64,42.333333333333336,56.666666666666664,<,-14.333333333333329,31,54,<,-23,53,59,<,-6,96,212,<,-116
166,15,43.666666666666664,15.0,>,28.666666666666664,0,0,=,0,89,25,>,64,56.666666666666664,42.333333333333336,>,14.333333333333329,54,31,>,23,59,53,>,6,212,96,>,116
0,15,15.0,23.333333333333332,<,-8.333333333333332,0,0,=,0,25,46,<,-21,42.333333333333336,46.0,<,-3.6666666666666643,31,37,<,-6,53,55,<,-2,96,255,<,-159
81,15,23.333333333333332,15.0,>,8.333333333333332,0,0,=,0,46,25,>,21,46.0,42.333333333333336,>,3.6666666666666643,37,31,>,6,55,53,>,2,255,96,>,159
0,15,15.0,33.0,<,-18.0,0,0,=,0,25,66,<,-41,42.333333333333336,39.333333333333336,>,3.0,31,32,<,-1,53,49,>,4,96,105,<,-9
64,15,33.0,15.0,>,18.0,0,0,=,0,66,25,>,41,39.333333333333336,42.333333333333336,<,-3.0,32,31,>,1,49,53,<,-4,105,96,>,9
0,15,15.0,55.0,<,-40.0,0,0,=,0,25,90,<,-65,42.333333333333336,49.0,<,-6.666666666666664,31,46,<,-15,53,55,<,-2,96,238,<,-142
97,15,55.0,15.0,>,40.0,0,0,=,0,90,25,>,65,49.0,42.333333333333336,>,6.666666666666664,46,31,>,15,55,53,>,2,238,96,>,142
0,15,15.0,41.666666666666664,<,-26.666666666666664,0,0,=,0,25,82,<,-57,42.333333333333336,48.0,<,-5.666666666666664,31,36,<,-5,53,60,<,-7,96,157,<,-61
144,15,41.666666666666664,15.0,>,26.666666666666664,0,0,=,0,82,25,>,57,48.0,42.333333333333336,>,5.666666666666664,36,31,>,5,60,53,>,7,157,96,>,61
0,15,15.0,30.666666666666668,<,-15.666666666666668,0,0,=,0,25,51,<,-26,42.333333333333336,44.0,<,-1.6666666666666643,31,34,<,-3,53,51,>,2,96,195,<,-99
75,15,30.666666666666668,15.0,>,15.666666666666668,0,0,=,0,51,25,>,26,44.0,42.333333333333336,>,1.6666666666666643,34,31,>,3,51,53,<,-2,195,96,>,99
0,15,15.0,27.333333333333332,<,-12.333333333333332,0,0,=,0,25,51,<,-26,42.333333333333336,51.333333333333336,<,-9.0,31,39,<,-8,53,59,<,-6,96,245,<,-149
100,15,27.333333333333332,15.0,>,12.333333333333332,0,0,=,0,51,25,>,26,51.333333333333336,42.333333333333336,>,9.0,39,31,>,8,59,53,>,6,245,96,>,149
0,15,15.0,46.333333333333336,<,-31.333333333333336,0,0,=,0,25,90,<,-65,42.333333333333336,40.333333333333336,>,2.0,31,34,<,-3,53,48,>,5,96,265,<,-169
205,15,46.333333333333336,15.0,>,31.333333333333336,0,0,=,0,90,25,>,65,40.333333333333336,42.333333333333336,<,-2.0,34,31,>,3,48,53,<,-5,265,96,>,169
0,15,15.0,23.333333333333332,<,-8.333333333333332,0,0,=,0,25,44,<,-19,42.333333333333336,41.0,>,1.3333333333333357,31,31,=,0,53,57,<,-4,96,272,<,-176
180,15,23.333333333333332,15.0,>,8.333333333333332,0,0,=,0,44,25,>,19,41.0,42.333333333333336,<,-1.3333333333333357,31,31,=,0,57,53,>,4,272,96,>,176
0,14,33.333333333333336,27.0,>,6.333333333333336,15,16,<,-1,56,43,>,13,41.333333333333336,42.666666666666664,<,-1.3333333333333286,32,33,<,-1,60,54,>,6,133,110,>,23
0,14,27.0,33.333333333333336,<,-6.333333333333336,16,15,>,1,43,56,<,-13,42.666666666666664,41.333333333333336,>,1.3333333333333286,33,32,>,1,54,60,<,-6,110,133,<,-23
0,14,33.333333333333336,69.0,<,-35.666666666666664,15,50,<,-35,56,83,<,-27,41.333333333333336,42.333333333333336,<,-1.0,32,33,<,-1,60,51,>,9,133,130,>,3
180,14,69.0,33.333333333333336,>,35.666666666666664,50,15,>,35,83,56,>,27,42.333333333333336,41.333333333333336,>,1.0,33,32,>,1,51,60,<,-9,130,133,<,-3
0,14,33.333333333333336,43.0,<,-9.666666666666664,15,30,<,-15,56,66,<,-10,41.333333333333336,39.333333333333336,>,2.0,32,32,=,0,60,49,>,11,133,105,>,28
0,14,43.0,33.333333333333336,>,9.666666666666664,30,15,>,15,66,56,>,10,39.333333333333336,41.333333333333336,<,-2.0,32,32,=,0,49,60,<,-11,105,133,<,-28
0,14,33.333333333333336,53.666666666666664,<,-20.33333333333333,15,33,<,-18,56,78,<,-22,41.333333333333336,45.666666666666664,<,-4.333333333333329,32,45,<,-13,60,47,>,13,133,142,<,-9
144,14,53.666666666666664,33.333333333333336,>,20.33333333333333,33,15,>,18,78,56,>,22,45.666666666666664,41.333333333333336,>,4.333333333333329,45,32,>,13,47,60,<,-13,142,133,>,9
0,14,33.333333333333336,38.0,<,-4.666666666666664,15,22,<,-7,56,51,>,5,41.333333333333336,44.0,<,-2.6666666666666643,32,34,<,-2,60,51,>,9,133,195,<,-62
114,14,38.0,33.333333333333336,>,4.666666666666664,22,15,>,7,51,56,<,-5,44.0,41.333333333333336,>,2.6666666666666643,34,32,>,2,51,60,<,-9,195,133,>,62
0,14,33.333333333333336,27.666666666666668,>,5.666666666666668,15,13,>,2,56,46,>,10,41.333333333333336,46.0,<,-4.666666666666664,32,37,<,-5,60,55,>,5,133,255,<,-122
81,14,27.666666666666668,33.333333333333336,<,-5.666666666666668,13,15,<,-2,46,56,<,-10,46.0,41.333333333333336,>,4.666666666666664,37,32,>,5,55,60,<,-5,255,133,>,122
0,14,33.333333333333336,61.333333333333336,<,-28.0,15,22,<,-7,56,84,<,-28,41.333333333333336,54.333333333333336,<,-13.0,32,53,<,-21,60,56,>,4,133,129,>,4
99,14,61.333333333333336,33.333333333333336,>,28.0,22,15,>,7,84,56,>,28,54.333333333333336,41.333333333333336,>,13.0,53,32,>,21,56,60,<,-4,129,133,<,-4
0,14,33.333333333333336,67.66666666666667,<,-34.333333333333336,15,38,<,-23,56,90,<,-34,41.333333333333336,49.0,<,-7.666666666666664,32,46,<,-14,60,55,>,5,133,238,<,-105
105,14,67.66666666666667,33.333333333333336,>,34.333333333333336,38,15,>,23,90,56,>,34,49.0,41.333333333333336,>,7.666666666666664,46,32,>,14,55,60,<,-5,238,133,>,105
0,14,33.333333333333336,32.666666666666664,>,0.6666666666666714,15,16,<,-1,56,51,>,5,41.333333333333336,51.333333333333336,<,-10.0,32,39,<,-7,60,59,>,1,133,245,<,-112
94,14,32.666666666666664,33.333333333333336,<,-0.6666666666666714,16,15,>,1,51,56,<,-5,51.333333333333336,41.333333333333336,>,10.0,39,32,>,7,59,60,<,-1,245,133,>,112
0,14,33.333333333333336,68.33333333333333,<,-34.99999999999999,15,43,<,-28,56,82,<,-26,41.333333333333336,48.0,<,-6.666666666666664,32,36,<,-4,60,60,=,0,133,157,<,-24
166,14,68.33333333333333,33.333333333333336,>,34.99999999999999,43,15,>,28,82,56,>,26,48.0,41.333333333333336,>,6.666666666666664,36,32,>,4,60,60,=,0,157,133,>,24
0,14,33.333333333333336,60.333333333333336,<,-27.0,15,42,<,-27,56,89,<,-33,41.333333333333336,56.666666666666664,<,-15.333333333333329,32,54,<,-22,60,59,>,1,133,212,<,-79
177,14,60.333333333333336,33.333333333333336,>,27.0,42,15,>,27,89,56,>,33,56.666666666666664,41.333333333333336,>,15.333333333333329,54,32,>,22,59,60,<,-1,212,133,>,79
0,14,33.333333333333336,43.333333333333336,<,-10.0,15,26,<,-11,56,60,<,-4,41.333333333333336,41.0,>,0.3333333333333357,32,31,>,1,60,57,>,3,133,272,<,-139
213,14,43.333333333333336,33.333333333333336,>,10.0,26,15,>,11,60,56,>,4,41.0,41.333333333333336,<,-0.3333333333333357,31,32,<,-1,57,60,<,-3,272,133,>,139
0,14,33.333333333333336,75.33333333333333,<,-41.99999999999999,15,49,<,-34,56,90,<,-34,41.333333333333336,40.333333333333336,>,1.0,32,34,<,-2,60,48,>,12,133,265,<,-132
296,14,75.33333333333333,33.333333333333336,>,41.99999999999999,49,15,>,34,90,56,>,34,40.333333333333336,41.333333333333336,<,-1.0,34,32,>,2,48,60,<,-12,265,133,>,132
0,13,32.666666666666664,33.666666666666664,<,-1.0,30,22,>,8,35,43,<,-8,39.333333333333336,42.666666666666664,<,-3.3333333333333286,32,33,<,-1,49,54,<,-5,105,110,<,-5
0,13,33.666666666666664,32.666666666666664,>,1.0,22,30,<,-8,43,35,>,8,42.666666666666664,39.333333333333336,>,3.3333333333333286,33,32,>,1,54,49,>,5,110,105,>,5
0,13,32.666666666666664,24.0,>,8.666666666666664,30,13,>,17,35,46,<,-11,39.333333333333336,46.0,<,-6.666666666666664,32,37,<,-5,49,55,<,-6,105,255,<,-150
80,13,24.0,32.666666666666664,<,-8.666666666666664,13,30,<,-17,46,35,>,11,46.0,39.333333333333336,>,6.666666666666664,37,32,>,5,55,49,>,6,255,105,>,150
0,13,32.666666666666664,31.333333333333332,>,1.3333333333333321,30,16,>,14,35,51,<,-16,39.333333333333336,51.333333333333336,<,-12.0,32,39,<,-7,49,59,<,-10,105,245,<,-140
94,13,31.333333333333332,32.666666666666664,<,-1.3333333333333321,16,30,<,-14,51,35,>,16,51.333333333333336,39.333333333333336,>,12.0,39,32,>,7,59,49,>,10,245,105,>,140
0,13,32.666666666666664,39.333333333333336,<,-6.666666666666671,30,12,>,18,35,84,<,-49,39.333333333333336,54.333333333333336,<,-15.0,32,53,<,-21,49,56,<,-7,105,129,<,-24
0,13,39.333333333333336,32.666666666666664,>,6.666666666666671,12,30,<,-18,84,35,>,49,54.333333333333336,39.333333333333336,>,15.0,53,32,>,21,56,49,>,7,129,105,>,24
0,13,32.666666666666664,66.66666666666667,<,-34.00000000000001,30,38,<,-8,35,87,<,-52,39.333333333333336,49.0,<,-9.666666666666664,32,46,<,-14,49,55,<,-6,105,238,<,-133
105,13,66.66666666666667,32.666666666666664,>,34.00000000000001,38,30,>,8,87,35,>,52,49.0,39.333333333333336,>,9.666666666666664,46,32,>,14,55,49,>,6,238,105,>,133
0,13,32.666666666666664,40.333333333333336,<,-7.666666666666671,30,22,>,8,35,51,<,-16,39.333333333333336,44.0,<,-4.666666666666664,32,34,<,-2,49,51,<,-2,105,195,<,-90
114,13,40.333333333333336,32.666666666666664,>,7.666666666666671,22,30,<,-8,51,35,>,16,44.0,39.333333333333336,>,4.666666666666664,34,32,>,2,51,49,>,2,195,105,>,90
0,13,32.666666666666664,62.333333333333336,<,-29.66666666666667,30,33,<,-3,35,78,<,-43,39.333333333333336,45.666666666666664,<,-6.333333333333329,32,45,<,-13,49,47,>,2,105,142,<,-37
190,13,62.333333333333336,32.666666666666664,>,29.66666666666667,33,30,>,3,78,35,>,43,45.666666666666664,39.333333333333336,>,6.333333333333329,45,32,>,13,47,49,<,-2,142,105,>,37
0,13,32.666666666666664,82.0,<,-49.333333333333336,30,80,<,-50,35,84,<,-49,39.333333333333336,48.0,<,-8.666666666666664,32,36,<,-4,49,60,<,-11,105,157,<,-52
263,13,82.0,32.666666666666664,>,49.333333333333336,80,30,>,50,84,35,>,49,48.0,39.333333333333336,>,8.666666666666664,36,32,>,4,60,49,>,11,157,105,>,52
0,13,32.666666666666664,62.333333333333336,<,-29.66666666666667,30,48,<,-18,35,89,<,-54,39.333333333333336,56.666666666666664,<,-17.33333333333333,32,54,<,-22,49,59,<,-10,105,212,<,-107
177,13,62.333333333333336,32.666666666666664,>,29.66666666666667,48,30,>,18,89,35,>,54,56.666666666666664,39.333333333333336,>,17.33333333333333,54,32,>,22,59,49,>,10,212,105,>,107
0,13,32.666666666666664,60.0,<,-27.333333333333336,30,50,<,-20,35,74,<,-39,39.333333333333336,42.333333333333336,<,-3.0,32,33,<,-1,49,51,<,-2,105,130,<,-25
180,13,60.0,32.666666666666664,>,27.333333333333336,50,30,>,20,74,35,>,39,42.333333333333336,39.333333333333336,>,3.0,33,32,>,1,51,49,>,2,130,105,>,25
0,13,32.666666666666664,53.333333333333336,<,-20.66666666666667,30,26,>,4,35,74,<,-39,39.333333333333336,41.0,<,-1.6666666666666643,32,31,>,1,49,57,<,-8,105,272,<,-167
213,13,53.333333333333336,32.666666666666664,>,20.66666666666667,26,30,<,-4,74,35,>,39,41.0,39.333333333333336,>,1.6666666666666643,31,32,<,-1,57,49,>,8,272,105,>,167
0,13,32.666666666666664,55.0,<,-22.333333333333336,30,29,>,1,35,87,<,-52,39.333333333333336,40.333333333333336,<,-1.0,32,34,<,-2,49,48,>,1,105,265,<,-160
132,13,55.0,32.666666666666664,>,22.333333333333336,29,30,<,-1,87,35,>,52,40.333333333333336,39.333333333333336,>,1.0,34,32,>,2,48,49,<,-1,265,105,>,160
0,12,33.666666666666664,33.666666666666664,=,0.0,12,22,<,-10,67,43,>,24,54.333333333333336,42.666666666666664,>,11.666666666666671,53,33,>,20,56,54,>,2,129,110,>,19
0,12,33.666666666666664,33.666666666666664,=,0.0,22,12,>,10,43,67,<,-24,42.666666666666664,54.333333333333336,<,-11.666666666666671,33,53,<,-20,54,56,<,-2,110,129,<,-19
0,12,33.666666666666664,44.333333333333336,<,-10.666666666666671,12,13,<,-1,67,74,<,-7,54.333333333333336,46.0,>,8.333333333333336,53,37,>,16,56,55,>,1,129,255,<,-126
80,12,44.333333333333336,33.666666666666664,>,10.666666666666671,13,12,>,1,74,67,>,7,46.0,54.333333333333336,<,-8.333333333333336,37,53,<,-16,55,56,<,-1,255,129,>,126
0,12,33.666666666666664,53.666666666666664,<,-20.0,12,27,<,-15,67,83,<,-16,54.333333333333336,51.333333333333336,>,3.0,53,39,>,14,56,59,<,-3,129,245,<,-116
132,12,53.666666666666664,33.666666666666664,>,20.0,27,12,>,15,83,67,>,16,51.333333333333336,54.333333333333336,<,-3.0,39,53,<,-14,59,56,>,3,245,129,>,116
0,12,33.666666666666664,67.33333333333333,<,-33.666666666666664,12,40,<,-28,67,87,<,-20,54.333333333333336,49.0,>,5.333333333333336,53,46,>,7,56,55,>,1,129,238,<,-109
61,12,67.33333333333333,33.666666666666664,>,33.666666666666664,40,12,>,28,87,67,>,20,49.0,54.333333333333336,<,-5.333333333333336,46,53,<,-7,55,56,<,-1,238,129,>,109
0,12,33.666666666666664,42.333333333333336,<,-8.666666666666671,12,28,<,-16,67,51,>,16,54.333333333333336,44.0,>,10.333333333333336,53,34,>,19,56,51,>,5,129,195,<,-66
0,12,42.333333333333336,33.666666666666664,>,8.666666666666671,28,12,>,16,51,67,<,-16,44.0,54.333333333333336,<,-10.333333333333336,34,53,<,-19,51,56,<,-5,195,129,>,66
0,12,33.666666666666664,48.666666666666664,<,-15.0,12,29,<,-17,67,68,<,-1,54.333333333333336,40.333333333333336,>,14.0,53,34,>,19,56,48,>,8,129,265,<,-136
161,12,48.666666666666664,33.666666666666664,>,15.0,29,12,>,17,68,67,>,1,40.333333333333336,54.333333333333336,<,-14.0,34,53,<,-19,48,56,<,-8,265,129,>,136
0,12,33.666666666666664,72.66666666666667,<,-39.00000000000001,12,48,<,-36,67,89,<,-22,54.333333333333336,56.666666666666664,<,-2.3333333333333286,53,54,<,-1,56,59,<,-3,129,212,<,-83
183,12,72.66666666666667,33.666666666666664,>,39.00000000000001,48,12,>,36,89,67,>,22,56.666666666666664,54.333333333333336,>,2.3333333333333286,54,53,>,1,59,56,>,3,212,129,>,83
0,12,33.666666666666664,53.666666666666664,<,-20.0,12,50,<,-38,67,56,>,11,54.333333333333336,42.333333333333336,>,12.0,53,33,>,20,56,51,>,5,129,130,<,-1
141,12,53.666666666666664,33.666666666666664,>,20.0,50,12,>,38,56,67,<,-11,42.333333333333336,54.333333333333336,<,-12.0,33,53,<,-20,51,56,<,-5,130,129,>,1
0,12,33.666666666666664,55.666666666666664,<,-22.0,12,33,<,-21,67,76,<,-9,54.333333333333336,45.666666666666664,>,8.666666666666671,53,45,>,8,56,47,>,9,129,142,<,-13
155,12,55.666666666666664,33.666666666666664,>,22.0,33,12,>,21,76,67,>,9,45.666666666666664,54.333333333333336,<,-8.666666666666671,45,53,<,-8,47,56,<,-9,142,129,>,13
0,12,33.666666666666664,57.666666666666664,<,-24.0,12,26,<,-14,67,74,<,-7,54.333333333333336,41.0,>,13.333333333333336,53,31,>,22,56,57,<,-1,129,272,<,-143
163,12,57.666666666666664,33.666666666666664,>,24.0,26,12,>,14,74,67,>,7,41.0,54.333333333333336,<,-13.333333333333336,31,53,<,-22,57,56,>,1,272,129,>,143
0,12,33.666666666666664,76.66666666666667,<,-43.00000000000001,12,64,<,-52,67,84,<,-17,54.333333333333336,48.0,>,6.333333333333336,53,36,>,17,56,60,<,-4,129,157,<,-28
247,12,76.66666666666667,33.666666666666664,>,43.00000000000001,64,12,>,52,84,67,>,17,48.0,54.333333333333336,<,-6.333333333333336,36,53,<,-17,60,56,>,4,157,129,>,28
0,11,54.0,36.666666666666664,>,17.333333333333336,28,22,>,6,83,45,>,38,44.0,42.666666666666664,>,1.3333333333333357,34,33,>,1,51,54,<,-3,195,110,>,85
0,11,36.666666666666664,54.0,<,-17.333333333333336,22,28,<,-6,45,83,<,-38,42.666666666666664,44.0,<,-1.3333333333333357,33,34,<,-1,54,51,>,3,110,195,<,-85
0,11,54.0,61.333333333333336,<,-7.333333333333336,28,40,<,-12,83,75,>,8,44.0,49.0,<,-5.0,34,46,<,-12,51,55,<,-4,195,238,<,-43
61,11,61.333333333333336,54.0,>,7.333333333333336,40,28,>,12,75,83,<,-8,49.0,44.0,>,5.0,46,34,>,12,55,51,>,4,238,195,>,43
0,11,54.0,63.666666666666664,<,-9.666666666666664,28,46,<,-18,83,74,>,9,44.0,46.0,<,-2.0,34,37,<,-3,51,55,<,-4,195,255,<,-60
127,11,63.666666666666664,54.0,>,9.666666666666664,46,28,>,18,74,83,<,-9,46.0,44.0,>,2.0,37,34,>,3,55,51,>,4,255,195,>,60
0,11,54.0,74.33333333333333,<,-20.33333333333333,28,51,<,-23,83,89,<,-6,44.0,51.333333333333336,<,-7.333333333333336,34,39,<,-5,51,59,<,-8,195,245,<,-50
149,11,74.33333333333333,54.0,>,20.33333333333333,51,28,>,23,89,83,>,6,51.333333333333336,44.0,>,7.333333333333336,39,34,>,5,59,51,>,8,245,195,>,50
0,11,54.0,59.666666666666664,<,-5.666666666666664,28,50,<,-22,83,74,>,9,44.0,42.333333333333336,>,1.6666666666666643,34,33,>,1,51,51,=,0,195,130,>,65
141,11,59.666666666666664,54.0,>,5.666666666666664,50,28,>,22,74,83,<,-9,42.333333333333336,44.0,<,-1.6666666666666643,33,34,<,-1,51,51,=,0,130,195,<,-65
0,11,54.0,36.333333333333336,>,17.666666666666664,28,18,>,10,83,58,>,25,44.0,45.666666666666664,<,-1.6666666666666643,34,45,<,-11,51,47,>,4,195,142,>,53
0,11,36.333333333333336,54.0,<,-17.666666666666664,18,28,<,-10,58,83,<,-25,45.666666666666664,44.0,>,1.6666666666666643,45,34,>,11,47,51,<,-4,142,195,<,-53
0,11,54.0,55.0,<,-1.0,28,48,<,-20,83,68,>,15,44.0,40.333333333333336,>,3.6666666666666643,34,34,=,0,51,48,>,3,195,265,<,-70
174,11,55.0,54.0,>,1.0,48,28,>,20,68,83,<,-15,40.333333333333336,44.0,<,-3.6666666666666643,34,34,=,0,48,51,<,-3,265,195,>,70
0,11,54.0,47.0,>,7.0,28,26,>,2,83,73,>,10,44.0,41.0,>,3.0,34,31,>,3,51,57,<,-6,195,272,<,-77
99,11,47.0,54.0,<,-7.0,26,28,<,-2,73,83,<,-10,41.0,44.0,<,-3.0,31,34,<,-3,57,51,>,6,272,195,>,77
0,11,54.0,77.66666666666667,<,-23.66666666666667,28,63,<,-35,83,89,<,-6,44.0,56.666666666666664,<,-12.666666666666664,34,54,<,-20,51,59,<,-8,195,212,<,-17
163,11,77.66666666666667,54.0,>,23.66666666666667,63,28,>,35,89,83,>,6,56.666666666666664,44.0,>,12.666666666666664,54,34,>,20,59,51,>,8,212,195,>,17
0,11,54.0,62.666666666666664,<,-8.666666666666664,28,42,<,-14,83,82,>,1,44.0,48.0,<,-4.0,34,36,<,-2,51,60,<,-9,195,157,>,38
132,11,62.666666666666664,54.0,>,8.666666666666664,42,28,>,14,82,83,<,-1,48.0,44.0,>,4.0,36,34,>,2,60,51,>,9,157,195,<,-38
0,10,26.666666666666668,44.0,<,-17.333333333333332,18,22,<,-4,33,65,<,-32,45.666666666666664,42.666666666666664,>,3.0,45,33,>,12,47,54,<,-7,142,110,>,32
0,10,44.0,26.666666666666668,>,17.333333333333332,22,18,>,4,65,33,>,32,42.666666666666664,45.666666666666664,<,-3.0,33,45,<,-12,54,47,>,7,110,142,<,-32
0,10,26.666666666666668,65.33333333333333,<,-38.66666666666666,18,52,<,-34,33,75,<,-42,45.666666666666664,49.0,<,-3.3333333333333357,45,46,<,-1,47,55,<,-8,142,238,<,-96
92,10,65.33333333333333,26.666666666666668,>,38.66666666666666,52,18,>,34,75,33,>,42,49.0,45.666666666666664,>,3.3333333333333357,46,45,>,1,55,47,>,8,238,142,>,96
0,10,26.666666666666668,39.666666666666664,<,-12.999999999999996,18,26,<,-8,33,51,<,-18,45.666666666666664,41.0,>,4.666666666666664,45,31,>,14,47,57,<,-10,142,272,<,-130
99,10,39.666666666666664,26.666666666666668,>,12.999999999999996,26,18,>,8,51,33,>,18,41.0,45.666666666666664,<,-4.666666666666664,31,45,<,-14,57,47,>,10,272,142,>,130
0,10,26.666666666666668,47.666666666666664,<,-20.999999999999996,18,26,<,-8,33,71,<,-38,45.666666666666664,46.0,<,-0.3333333333333357,45,37,>,8,47,55,<,-8,142,255,<,-113
0,10,47.666666666666664,26.666666666666668,>,20.999999999999996,26,18,>,8,71,33,>,38,46.0,45.666666666666664,>,0.3333333333333357,37,45,<,-8,55,47,>,8,255,142,>,113
0,10,26.666666666666668,50.333333333333336,<,-23.666666666666668,18,27,<,-9,33,82,<,-49,45.666666666666664,48.0,<,-2.3333333333333357,45,36,>,9,47,60,<,-13,142,157,<,-15
132,10,50.333333333333336,26.666666666666668,>,23.666666666666668,27,18,>,9,82,33,>,49,48.0,45.666666666666664,>,2.3333333333333357,36,45,<,-9,60,47,>,13,157,142,>,15
0,10,26.666666666666668,46.666666666666664,<,-19.999999999999996,18,16,>,2,33,74,<,-41,45.666666666666664,42.333333333333336,>,3.3333333333333286,45,33,>,12,47,51,<,-4,142,130,>,12
75,10,46.666666666666664,26.666666666666668,>,19.999999999999996,16,18,<,-2,74,33,>,41,42.333333333333336,45.666666666666664,<,-3.3333333333333286,33,45,<,-12,51,47,>,4,130,142,<,-12
0,10,26.666666666666668,59.333333333333336,<,-32.66666666666667,18,38,<,-20,33,89,<,-56,45.666666666666664,51.333333333333336,<,-5.666666666666671,45,39,>,6,47,59,<,-12,142,245,<,-103
57,10,59.333333333333336,26.666666666666668,>,32.66666666666667,38,18,>,20,89,33,>,56,51.333333333333336,45.666666666666664,>,5.666666666666671,39,45,<,-6,59,47,>,12,245,142,>,103
0,10,26.666666666666668,62.333333333333336,<,-35.66666666666667,18,35,<,-17,33,89,<,-56,45.666666666666664,56.666666666666664,<,-11.0,45,54,<,-9,47,59,<,-12,142,212,<,-70
79,10,62.333333333333336,26.666666666666668,>,35.66666666666667,35,18,>,17,89,33,>,56,56.666666666666664,45.666666666666664,>,11.0,54,45,>,9,59,47,>,12,212,142,>,70
0,10,26.666666666666668,59.666666666666664,<,-33.0,18,48,<,-30,33,82,<,-49,45.666666666666664,40.333333333333336,>,5.333333333333329,45,34,>,11,47,48,<,-1,142,265,<,-123
151,10,59.666666666666664,26.666666666666668,>,33.0,48,18,>,30,82,33,>,49,40.333333333333336,45.666666666666664,<,-5.333333333333329,34,45,<,-11,48,47,>,1,265,142,>,123
0,9,45.666666666666664,47.0,<,-1.3333333333333357,26,22,>,4,65,65,=,0,46.0,42.666666666666664,>,3.3333333333333357,37,33,>,4,55,54,>,1,255,110,>,145
0,9,47.0,45.666666666666664,>,1.3333333333333357,22,26,<,-4,65,65,=,0,42.666666666666664,46.0,<,-3.3333333333333357,33,37,<,-4,54,55,<,-1,110,255,<,-145
0,9,45.666666666666664,35.666666666666664,>,10.0,26,18,>,8,65,51,>,14,46.0,51.333333333333336,<,-5.333333333333336,37,39,<,-2,55,59,<,-4,255,245,>,10
0,9,35.666666666666664,45.666666666666664,<,-10.0,18,26,<,-8,51,65,<,-14,51.333333333333336,46.0,>,5.333333333333336,39,37,>,2,59,55,>,4,245,255,<,-10
0,9,45.666666666666664,34.333333333333336,>,11.333333333333329,26,16,>,10,65,50,>,15,46.0,42.333333333333336,>,3.6666666666666643,37,33,>,4,55,51,>,4,255,130,>,125
75,9,34.333333333333336,45.666666666666664,<,-11.333333333333329,16,26,<,-10,50,65,<,-15,42.333333333333336,46.0,<,-3.6666666666666643,33,37,<,-4,51,55,<,-4,130,255,<,-125
0,9,45.666666666666664,52.666666666666664,<,-7.0,26,34,<,-8,65,89,<,-24,46.0,56.666666666666664,<,-10.666666666666664,37,54,<,-17,55,59,<,-4,255,212,>,43
57,9,52.666666666666664,45.666666666666664,>,7.0,34,26,>,8,89,65,>,24,56.666666666666664,46.0,>,10.666666666666664,54,37,>,17,59,55,>,4,212,255,<,-43
0,9,45.666666666666664,69.66666666666667,<,-24.000000000000007,26,52,<,-26,65,82,<,-17,46.0,49.0,<,-3.0,37,46,<,-9,55,55,=,0,255,238,>,17
92,9,69.66666666666667,45.666666666666664,>,24.000000000000007,52,26,>,26,82,65,>,17,49.0,46.0,>,3.0,46,37,>,9,55,55,=,0,238,255,<,-17
0,9,45.666666666666664,36.666666666666664,>,9.0,26,26,=,0,65,51,>,14,46.0,41.0,>,5.0,37,31,>,6,55,57,<,-2,255,272,<,-17
53,9,36.666666666666664,45.666666666666664,<,-9.0,26,26,=,0,51,65,<,-14,41.0,46.0,<,-5.0,31,37,<,-6,57,55,>,2,272,255,>,17
0,9,45.666666666666664,42.333333333333336,>,3.3333333333333286,26,18,>,8,65,82,<,-17,46.0,48.0,<,-2.0,37,36,>,1,55,60,<,-5,255,157,>,98
113,9,42.333333333333336,45.666666666666664,<,-3.3333333333333286,18,26,<,-8,82,65,>,17,48.0,46.0,>,2.0,36,37,<,-1,60,55,>,5,157,255,<,-98
0,9,45.666666666666664,52.666666666666664,<,-7.0,26,27,<,-1,65,82,<,-17,46.0,40.333333333333336,>,5.666666666666664,37,34,>,3,55,48,>,7,255,265,<,-10
114,9,52.666666666666664,45.666666666666664,>,7.0,27,26,>,1,82,65,>,17,40.333333333333336,46.0,<,-5.666666666666664,34,37,<,-3,48,55,<,-7,265,255,>,10
0,8,46.666666666666664,42.333333333333336,>,4.333333333333329,18,22,<,-4,71,54,>,17,51.333333333333336,42.666666666666664,>,8.666666666666671,39,33,>,6,59,54,>,5,245,110,>,135
0,8,42.333333333333336,46.666666666666664,<,-4.333333333333329,22,18,>,4,54,71,<,-17,42.666666666666664,51.333333333333336,<,-8.666666666666671,33,39,<,-6,54,59,<,-5,110,245,<,-135
0,8,46.666666666666664,35.333333333333336,>,11.333333333333329,18,26,<,-8,71,47,>,24,51.333333333333336,41.0,>,10.333333333333336,39,31,>,8,59,57,>,2,245,272,<,-27
53,8,35.333333333333336,46.666666666666664,<,-11.333333333333329,26,18,>,8,47,71,<,-24,41.0,51.333333333333336,<,-10.333333333333336,31,39,<,-8,57,59,<,-2,272,245,>,27
0,8,46.666666666666664,61.333333333333336,<,-14.666666666666671,18,34,<,-16,71,89,<,-18,51.333333333333336,56.666666666666664,<,-5.333333333333329,39,54,<,-15,59,59,=,0,245,212,>,33
50,8,61.333333333333336,46.666666666666664,>,14.666666666666671,34,18,>,16,89,71,>,18,56.666666666666664,51.333333333333336,>,5.333333333333329,54,39,>,15,59,59,=,0,212,245,<,-33
0,8,46.666666666666664,34.333333333333336,>,12.333333333333329,18,16,>,2,71,50,>,21,51.333333333333336,42.333333333333336,>,9.0,39,33,>,6,59,51,>,8,245,130,>,115
96,8,34.333333333333336,46.666666666666664,<,-12.333333333333329,16,18,<,-2,50,71,<,-21,42.333333333333336,51.333333333333336,<,-9.0,33,39,<,-6,51,59,<,-8,130,245,<,-115
0,8,46.666666666666664,65.0,<,-18.333333333333336,18,38,<,-20,71,82,<,-11,51.333333333333336,49.0,>,2.3333333333333357,39,46,<,-7,59,55,>,4,245,238,>,7
0,8,65.0,46.666666666666664,>,18.333333333333336,38,18,>,20,82,71,>,11,49.0,51.333333333333336,<,-2.3333333333333357,46,39,>,7,55,59,<,-4,238,245,<,-7
0,8,46.666666666666664,39.666666666666664,>,7.0,18,18,=,0,71,82,<,-11,51.333333333333336,48.0,>,3.3333333333333357,39,36,>,3,59,60,<,-1,245,157,>,88
124,8,39.666666666666664,46.666666666666664,<,-7.0,18,18,=,0,82,71,>,11,48.0,51.333333333333336,<,-3.3333333333333357,36,39,<,-3,60,59,>,1,157,245,<,-88
0,8,46.666666666666664,46.333333333333336,>,0.3333333333333286,18,27,<,-9,71,63,>,8,51.333333333333336,40.333333333333336,>,11.0,39,34,>,5,59,48,>,11,245,265,<,-20
114,8,46.333333333333336,46.666666666666664,<,-0.3333333333333286,27,18,>,9,63,71,<,-8,40.333333333333336,51.333333333333336,<,-11.0,34,39,<,-5,48,59,<,-11,265,245,>,20
0,7,46.333333333333336,53.0,<,-6.666666666666664,26,22,>,4,75,86,<,-11,49.0,42.666666666666664,>,6.333333333333336,46,33,>,13,55,54,>,1,238,110,>,128
0,7,53.0,46.333333333333336,>,6.666666666666664,22,26,<,-4,86,75,>,11,42.666666666666664,49.0,<,-6.333333333333336,33,46,<,-13,54,55,<,-1,110,238,<,-128
0,7,46.333333333333336,53.333333333333336,<,-7.0,26,10,>,16,75,89,<,-14,49.0,56.666666666666664,<,-7.666666666666664,46,54,<,-8,55,59,<,-4,238,212,>,26
0,7,53.333333333333336,46.333333333333336,>,7.0,10,26,<,-16,89,75,>,14,56.666666666666664,49.0,>,7.666666666666664,54,46,>,8,59,55,>,4,212,238,<,-26
0,7,46.333333333333336,45.0,>,1.3333333333333357,26,26,=,0,75,62,>,13,49.0,41.0,>,8.0,46,31,>,15,55,57,<,-2,238,272,<,-34
89,7,45.0,46.333333333333336,<,-1.3333333333333357,26,26,=,0,62,75,<,-13,41.0,49.0,<,-8.0,31,46,<,-15,57,55,>,2,272,238,>,34
0,7,46.333333333333336,43.666666666666664,>,2.6666666666666714,26,16,>,10,75,65,>,10,49.0,42.333333333333336,>,6.666666666666664,46,33,>,13,55,51,>,4,238,130,>,108
102,7,43.666666666666664,46.333333333333336,<,-2.6666666666666714,16,26,<,-10,65,75,<,-10,42.333333333333336,49.0,<,-6.666666666666664,33,46,<,-13,51,55,<,-4,130,238,<,-108
0,7,46.333333333333336,50.666666666666664,<,-4.333333333333329,26,40,<,-14,75,63,>,12,49.0,40.333333333333336,>,8.666666666666664,46,34,>,12,55,48,>,7,238,265,<,-27
96,7,50.666666666666664,46.333333333333336,>,4.333333333333329,40,26,>,14,63,75,<,-12,40.333333333333336,49.0,<,-8.666666666666664,34,46,<,-12,48,55,<,-7,265,238,>,27
0,7,46.333333333333336,46.0,>,0.3333333333333357,26,19,>,7,75,82,<,-7,49.0,48.0,>,1.0,46,36,>,10,55,60,<,-5,238,157,>,81
148,7,46.0,46.333333333333336,<,-0.3333333333333357,19,26,<,-7,82,75,>,7,48.0,49.0,<,-1.0,36,46,<,-10,60,55,>,5,157,238,<,-81
0,6,61.333333333333336,61.0,>,0.3333333333333357,10,22,<,-12,89,86,>,3,56.666666666666664,42.666666666666664,>,14.0,54,33,>,21,59,54,>,5,212,110,>,102
0,6,61.0,61.333333333333336,<,-0.3333333333333357,22,10,>,12,86,89,<,-3,42.666666666666664,56.666666666666664,<,-14.0,33,54,<,-21,54,59,<,-5,110,212,<,-102
0,6,61.333333333333336,37.333333333333336,>,24.0,10,24,<,-14,89,62,>,27,56.666666666666664,41.0,>,15.666666666666664,54,31,>,23,59,57,>,2,212,272,<,-60
100,6,37.333333333333336,61.333333333333336,<,-24.0,24,10,>,14,62,89,<,-27,41.0,56.666666666666664,<,-15.666666666666664,31,54,<,-23,57,59,<,-2,272,212,>,60
0,6,61.333333333333336,49.0,>,12.333333333333336,10,40,<,-30,89,58,>,31,56.666666666666664,40.333333333333336,>,16.33333333333333,54,34,>,20,59,48,>,11,212,265,<,-53
96,6,49.0,61.333333333333336,<,-12.333333333333336,40,10,>,30,58,89,<,-31,40.333333333333336,56.666666666666664,<,-16.33333333333333,34,54,<,-20,48,59,<,-11,265,212,>,53
0,6,61.333333333333336,44.666666666666664,>,16.66666666666667,10,19,<,-9,89,65,>,24,56.666666666666664,42.333333333333336,>,14.333333333333329,54,33,>,21,59,51,>,8,212,130,>,82
146,6,44.666666666666664,61.333333333333336,<,-16.66666666666667,19,10,>,9,65,89,<,-24,42.333333333333336,56.666666666666664,<,-14.333333333333329,33,54,<,-21,51,59,<,-8,130,212,<,-82
0,6,61.333333333333336,64.33333333333333,<,-2.999999999999993,10,37,<,-27,89,82,>,7,56.666666666666664,48.0,>,8.666666666666664,54,36,>,18,59,60,<,-1,212,157,>,55
165,6,64.33333333333333,61.333333333333336,>,2.999999999999993,37,10,>,27,82,89,<,-7,48.0,56.666666666666664,<,-8.666666666666664,36,54,<,-18,60,59,>,1,157,212,<,-55
0,5,62.0,42.333333333333336,>,19.666666666666664,22,20,>,2,89,58,>,31,42.666666666666664,40.333333333333336,>,2.3333333333333286,33,34,<,-1,54,48,>,6,110,265,<,-155
146,5,42.333333333333336,62.0,<,-19.666666666666664,20,22,<,-2,58,89,<,-31,40.333333333333336,42.666666666666664,<,-2.3333333333333286,34,33,>,1,48,54,<,-6,265,110,>,155
0,5,62.0,34.333333333333336,>,27.666666666666664,22,24,<,-2,89,53,>,36,42.666666666666664,41.0,>,1.6666666666666643,33,31,>,2,54,57,<,-3,110,272,<,-162
107,5,34.333333333333336,62.0,<,-27.666666666666664,24,22,>,2,53,89,<,-36,41.0,42.666666666666664,<,-1.6666666666666643,31,33,<,-2,57,54,>,3,272,110,>,162
0,5,62.0,42.333333333333336,>,19.666666666666664,22,19,>,3,89,58,>,31,42.666666666666664,42.333333333333336,>,0.3333333333333286,33,33,=,0,54,51,>,3,110,130,<,-20
176,5,42.333333333333336,62.0,<,-19.666666666666664,19,22,<,-3,58,89,<,-31,42.333333333333336,42.666666666666664,<,-0.3333333333333286,33,33,=,0,51,54,<,-3,130,110,>,20
0,5,62.0,70.66666666666667,<,-8.666666666666671,22,56,<,-34,89,82,>,7,42.666666666666664,48.0,<,-5.333333333333336,33,36,<,-3,54,60,<,-6,110,157,<,-47
263,5,70.66666666666667,62.0,>,8.666666666666671,56,22,>,34,82,89,<,-7,48.0,42.666666666666664,>,5.333333333333336,36,33,>,3,60,54,>,6,157,110,>,47
0,4,47.333333333333336,30.0,>,17.333333333333336,12,13,<,-1,74,53,>,21,48.0,41.0,>,7.0,36,31,>,5,60,57,>,3,157,272,<,-115
107,4,30.0,47.333333333333336,<,-17.333333333333336,13,12,>,1,53,74,<,-21,41.0,48.0,<,-7.0,31,36,<,-5,57,60,<,-3,272,157,>,115
0,4,47.333333333333336,53.0,<,-5.666666666666664,12,20,<,-8,74,81,<,-7,48.0,40.333333333333336,>,7.666666666666664,36,34,>,2,60,48,>,12,157,265,<,-108
146,4,53.0,47.333333333333336,>,5.666666666666664,20,12,>,8,81,74,>,7,40.333333333333336,48.0,<,-7.666666666666664,34,36,<,-2,48,60,<,-12,265,157,>,108
0,4,47.333333333333336,40.666666666666664,>,6.666666666666671,12,19,<,-7,74,58,>,16,48.0,42.333333333333336,>,5.666666666666664,36,33,>,3,60,51,>,9,157,130,>,27
176,4,40.666666666666664,47.333333333333336,<,-6.666666666666671,19,12,>,7,58,74,<,-16,42.333333333333336,48.0,<,-5.666666666666664,33,36,<,-3,51,60,<,-9,130,157,<,-27
0,3,32.333333333333336,46.333333333333336,<,-14.0,19,24,<,-5,58,62,<,-4,42.333333333333336,41.0,>,1.3333333333333357,33,31,>,2,51,57,<,-6,130,272,<,-142
107,3,46.333333333333336,32.333333333333336,>,14.0,24,19,>,5,62,58,>,4,41.0,42.333333333333336,<,-1.3333333333333357,31,33,<,-2,57,51,>,6,272,130,>,142
0,3,32.333333333333336,52.666666666666664,<,-20.33333333333333,19,20,<,-1,58,80,<,-22,42.333333333333336,40.333333333333336,>,2.0,33,34,<,-1,51,48,>,3,130,265,<,-135
146,3,52.666666666666664,32.333333333333336,>,20.33333333333333,20,19,>,1,80,58,>,22,40.333333333333336,42.333333333333336,<,-2.0,34,33,>,1,48,51,<,-3,265,130,>,135
0,2,32.666666666666664,43.666666666666664,<,-11.0,20,24,<,-4,58,54,>,4,40.333333333333336,41.0,<,-0.6666666666666643,34,31,>,3,48,57,<,-9,265,272,<,-7
107,2,43.666666666666664,32.666666666666664,>,11.0,24,20,>,4,54,58,<,-4,41.0,40.333333333333336,>,0.6666666666666643,31,34,<,-3,57,48,>,9,272,265,>,7
0,18,0.0,0.0,=,0.0,0,0,=,0,0,0,=,0,51.666666666666664,36.0,>,15.666666666666664,43,33,>,10,60,40,>,20,203,141,>,62
39,18,0.0,0.0,=,0.0,0,0,=,0,0,0,=,0,36.0,51.666666666666664,<,-15.666666666666664,33,43,<,-10,40,60,<,-20,141,203,<,-62
0,18,0.0,0.0,=,0.0,0,0,=,0,0,0,=,0,51.666666666666664,43.333333333333336,>,8.333333333333329,43,32,>,11,60,54,>,6,203,203,=,0
56,18,0.0,0.0,=,0.0,0,0,=,0,0,0,=,0,43.333333333333336,51.666666666666664,<,-8.333333333333329,32,43,<,-11,54,60,<,-6,203,203,=,0
0,18,0.0,0.0,=,0.0,0,0,=,0,0,0,=,0,51.666666666666664,41.333333333333336,>,10.333333333333329,43,31,>,12,60,50,>,10,203,222,<,-19
20,18,0.0,0.0,=,0.0,0,0,=,0,0,0,=,0,41.333333333333336,51.666666666666664,<,-10.333333333333329,31,43,<,-12,50,60,<,-10,222,203,>,19
0,18,0.0,0.0,=,0.0,0,0,=,0,0,0,=,0,51.666666666666664,45.333333333333336,>,6.333333333333329,43,33,>,10,60,53,>,7,203,129,>,74
57,18,0.0,0.0,=,0.0,0,0,=,0,0,0,=,0,45.333333333333336,51.666666666666664,<,-6.333333333333329,33,43,<,-10,53,60,<,-7,129,203,<,-74
0,18,0.0,0.0,=,0.0,0,0,=,0,0,0,=,0,51.666666666666664,42.333333333333336,>,9.333333333333329,43,30,>,13,60,58,>,2,203,250,<,-47
79,18,0.0,0.0,=,0.0,0,0,=,0,0,0,=,0,42.333333333333336,51.666666666666664,<,-9.333333333333329,30,43,<,-13,58,60,<,-2,250,203,>,47
0,18,0.0,0.0,=,0.0,0,0,=,0,0,0,=,0,51.666666666666664,47.0,>,4.666666666666664,43,30,>,13,60,56,>,4,203,233,<,-30
137,18,0.0,0.0,=,0.0,0,0,=,0,0,0,=,0,47.0,51.666666666666664,<,-4.666666666666664,30,43,<,-13,56,60,<,-4,233,203,>,30
0,18,0.0,0.0,=,0.0,0,0,=,0,0,0,=,0,51.666666666666664,43.666666666666664,>,8.0,43,34,>,9,60,57,>,3,203,96,>,107
21,18,0.0,0.0,=,0.0,0,0,=,0,0,0,=,0,43.666666666666664,51.666666666666664,<,-8.0,34,43,<,-9,57,60,<,-3,96,203,<,-107
0,18,0.0,0.0,=,0.0,0,0,=,0,0,0,=,0,51.666666666666664,48.666666666666664,>,3.0,43,44,<,-1,60,52,>,8,203,197,>,6
49,18,0.0,0.0,=,0.0,0,0,=,0,0,0,=,0,48.666666666666664,51.666666666666664,<,-3.0,44,43,>,1,52,60,<,-8,197,203,<,-6
0,18,0.0,0.0,=,0.0,0,0,=,0,0,0,=,0,51.666666666666664,46.333333333333336,>,5.333333333333329,43,33,>,10,60,59,>,1,203,104,>,99
62,18,0.0,0.0,=,0.0,0,0,=,0,0,0,=,0,46.333333333333336,51.666666666666664,<,-5.333333333333329,33,43,<,-10,59,60,<,-1,104,203,<,-99
0,18,0.0,0.0,=,0.0,0,0,=,0,0,0,=,0,51.666666666666664,42.0,>,9.666666666666664,43,35,>,8,60,48,>,12,203,198,>,5
54,18,0.0,0.0,=,0.0,0,0,=,0,0,0,=,0,42.0,51.666666666666664,<,-9.666666666666664,35,43,<,-8,48,60,<,-12,198,203,<,-5
0,18,0.0,0.0,=,0.0,0,0,=,0,0,0,=,0,51.666666666666664,51.333333333333336,>,0.3333333333333286,43,49,<,-6,60,55,>,5,203,263,<,-60
98,18,0.0,0.0,=,0.0,0,0,=,0,0,0,=,0,51.333333333333336,51.666666666666664,<,-0.3333333333333286,49,43,>,6,55,60,<,-5,263,203,>,60
0,18,0.0,0.0,=,0.0,0,0,=,0,0,0,=,0,51.666666666666664,39.666666666666664,>,12.0,43,32,>,11,60,48,>,12,203,279,<,-76
118,18,0.0,0.0,=,0.0,0,0,=,0,0,0,=,0,39.666666666666664,51.666666666666664,<,-12.0,32,43,<,-11,48,60,<,-12,279,203,>,76
0,18,0.0,0.0,=,0.0,0,0,=,0,0,0,=,0,51.666666666666664,47.333333333333336,>,4.333333333333329,43,40,>,3,60,56,>,4,203,220,<,-17
21,18,0.0,0.0,=,0.0,0,0,=,0,0,0,=,0,47.333333333333336,51.666666666666664,<,-4.333333333333329,40,43,<,-3,56,60,<,-4,220,203,>,17
0,18,0.0,0.0,=,0.0,0,0,=,0,0,0,=,0,51.666666666666664,50.333333333333336,>,1.3333333333333286,43,44,<,-1,60,56,>,4,203,127,>,76
21,18,0.0,0.0,=,0.0,0,0,=,0,0,0,=,0,50.333333333333336,51.666666666666664,<,-1.3333333333333286,44,43,>,1,56,60,<,-4,127,203,<,-76
0,18,0.0,0.0,=,0.0,0,0,=,0,0,0,=,0,51.666666666666664,42.666666666666664,>,9.0,43,33,>,10,60,54,>,6,203,242,<,-39
81,18,0.0,0.0,=,0.0,0,0,=,0,0,0,=,0,42.666666666666664,51.666666666666664,<,-9.0,33,43,<,-10,54,60,<,-6,242,203,>,39
0,18,0.0,0.0,=,0.0,0,0,=,0,0,0,=,0,51.666666666666664,38.666666666666664,>,13.0,43,30,>,13,60,50,>,10,203,253,<,-50
113,18,0.0,0.0,=,0.0,0,0,=,0,0,0,=,0,38.666666666666664,51.666666666666664,<,-13.0,30,43,<,-13,50,60,<,-10,253,203,>,50
0,18,0.0,0.0,=,0.0,0,0,=,0,0,0,=,0,51.666666666666664,38.0,>,13.666666666666664,43,33,>,10,60,45,>,15,203,250,<,-47
126,18,0.0,0.0,=,0.0,0,0,=,0,0,0,=,0,38.0,51.666666666666664,<,-13.666666666666664,33,43,<,-10,45,60,<,-15,250,203,>,47
0,17,4.333333333333333,23.666666666666668,<,-19.333333333333336,0,0,=,0,13,71,<,-58,41.333333333333336,43.666666666666664,<,-2.3333333333333286,31,34,<,-3,50,57,<,-7,222,96,>,126
0,17,23.666666666666668,4.333333333333333,>,19.333333333333336,0,0,=,0,71,13,>,58,43.666666666666664,41.333333333333336,>,2.3333333333333286,34,31,>,3,57,50,>,7,96,222,<,-126
0,17,4.333333333333333,11.333333333333334,<,-7.000000000000001,0,0,=,0,13,34,<,-21,41.333333333333336,47.333333333333336,<,-6.0,31,40,<,-9,50,56,<,-6,222,220,>,2
35,17,11.333333333333334,4.333333333333333,>,7.000000000000001,0,0,=,0,34,13,>,21,47.333333333333336,41.333333333333336,>,6.0,40,31,>,9,56,50,>,6,220,222,<,-2
0,17,4.333333333333333,27.0,<,-22.666666666666668,0,0,=,0,13,81,<,-68,41.333333333333336,50.333333333333336,<,-9.0,31,44,<,-13,50,56,<,-6,222,127,>,95
65,17,27.0,4.333333333333333,>,22.666666666666668,0,0,=,0,81,13,>,68,50.333333333333336,41.333333333333336,>,9.0,44,31,>,13,56,50,>,6,127,222,<,-95
0,17,4.333333333333333,18.666666666666668,<,-14.333333333333336,0,0,=,0,13,56,<,-43,41.333333333333336,36.0,>,5.333333333333336,31,33,<,-2,50,40,>,10,222,141,>,81
0,17,18.666666666666668,4.333333333333333,>,14.333333333333336,0,0,=,0,56,13,>,43,36.0,41.333333333333336,<,-5.333333333333336,33,31,>,2,40,50,<,-10,141,222,<,-81
0,17,4.333333333333333,16.666666666666668,<,-12.333333333333336,0,0,=,0,13,50,<,-37,41.333333333333336,48.666666666666664,<,-7.333333333333329,31,44,<,-13,50,52,<,-2,222,197,>,25
75,17,16.666666666666668,4.333333333333333,>,12.333333333333336,0,0,=,0,50,13,>,37,48.666666666666664,41.333333333333336,>,7.333333333333329,44,31,>,13,52,50,>,2,197,222,<,-25
0,17,4.333333333333333,20.666666666666668,<,-16.333333333333336,0,0,=,0,13,62,<,-49,41.333333333333336,42.0,<,-0.6666666666666643,31,35,<,-4,50,48,>,2,222,198,>,24
70,17,20.666666666666668,4.333333333333333,>,16.333333333333336,0,0,=,0,62,13,>,49,42.0,41.333333333333336,>,0.6666666666666643,35,31,>,4,48,50,<,-2,198,222,<,-24
0,17,4.333333333333333,15.666666666666666,<,-11.333333333333332,0,0,=,0,13,47,<,-34,41.333333333333336,43.333333333333336,<,-2.0,31,32,<,-1,50,54,<,-4,222,203,>,19
90,17,15.666666666666666,4.333333333333333,>,11.333333333333332,0,0,=,0,47,13,>,34,43.333333333333336,41.333333333333336,>,2.0,32,31,>,1,54,50,>,4,203,222,<,-19
0,17,4.333333333333333,13.0,<,-8.666666666666668,0,0,=,0,13,39,<,-26,41.333333333333336,45.333333333333336,<,-4.0,31,33,<,-2,50,53,<,-3,222,129,>,93
40,17,13.0,4.333333333333333,>,8.666666666666668,0,0,=,0,39,13,>,26,45.333333333333336,41.333333333333336,>,4.0,33,31,>,2,53,50,>,3,129,222,<,-93
0,17,4.333333333333333,5.0,<,-0.666666666666667,0,0,=,0,13,15,<,-2,41.333333333333336,46.333333333333336,<,-5.0,31,33,<,-2,50,59,<,-9,222,104,>,118
43,17,5.0,4.333333333333333,>,0.666666666666667,0,0,=,0,15,13,>,2,46.333333333333336,41.333333333333336,>,5.0,33,31,>,2,59,50,>,9,104,222,<,-118
0,17,4.333333333333333,6.666666666666667,<,-2.333333333333334,0,0,=,0,13,20,<,-7,41.333333333333336,42.333333333333336,<,-1.0,31,30,>,1,50,58,<,-8,222,250,<,-28
108,17,6.666666666666667,4.333333333333333,>,2.333333333333334,0,0,=,0,20,13,>,7,42.333333333333336,41.333333333333336,>,1.0,30,31,<,-1,58,50,>,8,250,222,>,28
0,17,4.333333333333333,26.0,<,-21.666666666666668,0,0,=,0,13,78,<,-65,41.333333333333336,42.666666666666664,<,-1.3333333333333286,31,33,<,-2,50,54,<,-4,222,242,<,-20
110,17,26.0,4.333333333333333,>,21.666666666666668,0,0,=,0,78,13,>,65,42.666666666666664,41.333333333333336,>,1.3333333333333286,33,31,>,2,54,50,>,4,242,222,>,20
0,17,4.333333333333333,25.333333333333332,<,-21.0,0,0,=,0,13,76,<,-63,41.333333333333336,51.333333333333336,<,-10.0,31,49,<,-18,50,55,<,-5,222,263,<,-41
128,17,25.333333333333332,4.333333333333333,>,21.0,0,0,=,0,76,13,>,63,51.333333333333336,41.333333333333336,>,10.0,49,31,>,18,55,50,>,5,263,222,>,41
0,17,4.333333333333333,30.0,<,-25.666666666666668,0,0,=,0,13,90,<,-77,41.333333333333336,38.666666666666664,>,2.6666666666666714,31,30,>,1,50,50,=,0,222,253,<,-31
125,17,30.0,4.333333333333333,>,25.666666666666668,0,0,=,0,90,13,>,77,38.666666666666664,41.333333333333336,<,-2.6666666666666714,30,31,<,-1,50,50,=,0,253,222,>,31
0,17,4.333333333333333,24.333333333333332,<,-20.0,0,0,=,0,13,73,<,-60,41.333333333333336,39.666666666666664,>,1.6666666666666714,31,32,<,-1,50,48,>,2,222,279,<,-57
117,17,24.333333333333332,4.333333333333333,>,20.0,0,0,=,0,73,13,>,60,39.666666666666664,41.333333333333336,<,-1.6666666666666714,32,31,>,1,48,50,<,-2,279,222,>,57
0,17,4.333333333333333,22.0,<,-17.666666666666668,0,0,=,0,13,66,<,-53,41.333333333333336,38.0,>,3.3333333333333357,31,33,<,-2,50,45,>,5,222,250,<,-28
106,17,22.0,4.333333333333333,>,17.666666666666668,0,0,=,0,66,13,>,53,38.0,41.333333333333336,<,-3.3333333333333357,33,31,>,2,45,50,<,-5,250,222,>,28
0,17,4.333333333333333,24.666666666666668,<,-20.333333333333336,0,0,=,0,13,74,<,-61,41.333333333333336,47.0,<,-5.666666666666664,31,30,>,1,50,56,<,-6,222,233,<,-11
240,17,24.666666666666668,4.333333333333333,>,20.333333333333336,0,0,=,0,74,13,>,61,47.0,41.333333333333336,>,5.666666666666664,30,31,<,-1,56,50,>,6,233,222,>,11
0,16,5.333333333333333,6.666666666666667,<,-1.333333333333334,0,0,=,0,16,20,<,-4,36.0,43.666666666666664,<,-7.666666666666664,33,34,<,-1,40,57,<,-17,141,96,>,45
0,16,6.666666666666667,5.333333333333333,>,1.333333333333334,0,0,=,0,20,16,>,4,43.666666666666664,36.0,>,7.666666666666664,34,33,>,1,57,40,>,17,96,141,<,-45
0,16,5.333333333333333,5.333333333333333,=,0.0,0,0,=,0,16,16,=,0,36.0,47.333333333333336,<,-11.333333333333336,33,40,<,-7,40,56,<,-16,141,220,<,-79
35,16,5.333333333333333,5.333333333333333,=,0.0,0,0,=,0,16,16,=,0,47.333333333333336,36.0,>,11.333333333333336,40,33,>,7,56,40,>,16,220,141,>,79
0,16,5.333333333333333,7.0,<,-1.666666666666667,0,0,=,0,16,21,<,-5,36.0,45.333333333333336,<,-9.333333333333336,33,33,=,0,40,53,<,-13,141,129,>,12
0,16,7.0,5.333333333333333,>,1.666666666666667,0,0,=,0,21,16,>,5,45.333333333333336,36.0,>,9.333333333333336,33,33,=,0,53,40,>,13,129,141,<,-12
0,16,5.333333333333333,26.333333333333332,<,-21.0,0,0,=,0,16,79,<,-63,36.0,46.333333333333336,<,-10.333333333333336,33,33,=,0,40,59,<,-19,141,104,>,37
43,16,26.333333333333332,5.333333333333333,>,21.0,0,0,=,0,79,16,>,63,46.333333333333336,36.0,>,10.333333333333336,33,33,=,0,59,40,>,19,104,141,<,-37
0,16,5.333333333333333,25.333333333333332,<,-20.0,0,0,=,0,16,76,<,-60,36.0,50.333333333333336,<,-14.333333333333336,33,44,<,-11,40,56,<,-16,141,127,>,14
38,16,25.333333333333332,5.333333333333333,>,20.0,0,0,=,0,76,16,>,60,50.333333333333336,36.0,>,14.333333333333336,44,33,>,11,56,40,>,16,127,141,<,-14
0,16,5.333333333333333,29.666666666666668,<,-24.333333333333336,0,0,=,0,16,89,<,-73,36.0,42.0,<,-6.0,33,35,<,-2,40,48,<,-8,141,198,<,-57
70,16,29.666666666666668,5.333333333333333,>,24.333333333333336,0,0,=,0,89,16,>,73,42.0,36.0,>,6.0,35,33,>,2,48,40,>,8,198,141,>,57
0,16,5.333333333333333,15.666666666666666,<,-10.333333333333332,0,0,=,0,16,47,<,-31,36.0,48.666666666666664,<,-12.666666666666664,33,44,<,-11,40,52,<,-12,141,197,<,-56
103,16,15.666666666666666,5.333333333333333,>,10.333333333333332,0,0,=,0,47,16,>,31,48.666666666666664,36.0,>,12.666666666666664,44,33,>,11,52,40,>,12,197,141,>,56
0,16,5.333333333333333,7.0,<,-1.666666666666667,0,0,=,0,16,21,<,-5,36.0,43.333333333333336,<,-7.333333333333336,33,32,>,1,40,54,<,-14,141,203,<,-62
73,16,7.0,5.333333333333333,>,1.666666666666667,0,0,=,0,21,16,>,5,43.333333333333336,36.0,>,7.333333333333336,32,33,<,-1,54,40,>,14,203,141,>,62
0,16,5.333333333333333,14.333333333333334,<,-9.0,0,0,=,0,16,43,<,-27,36.0,38.0,<,-2.0,33,33,=,0,40,45,<,-5,141,250,<,-109
106,16,14.333333333333334,5.333333333333333,>,9.0,0,0,=,0,43,16,>,27,38.0,36.0,>,2.0,33,33,=,0,45,40,>,5,250,141,>,109
0,16,5.333333333333333,10.666666666666666,<,-5.333333333333333,0,0,=,0,16,32,<,-16,36.0,42.333333333333336,<,-6.333333333333336,33,30,>,3,40,58,<,-18,141,250,<,-109
108,16,10.666666666666666,5.333333333333333,>,5.333333333333333,0,0,=,0,32,16,>,16,42.333333333333336,36.0,>,6.333333333333336,30,33,<,-3,58,40,>,18,250,141,>,109
0,16,5.333333333333333,9.0,<,-3.666666666666667,0,0,=,0,16,27,<,-11,36.0,42.666666666666664,<,-6.666666666666664,33,33,=,0,40,54,<,-14,141,242,<,-101
110,16,9.0,5.333333333333333,>,3.666666666666667,0,0,=,0,27,16,>,11,42.666666666666664,36.0,>,6.666666666666664,33,33,=,0,54,40,>,14,242,141,>,101
0,16,5.333333333333333,22.333333333333332,<,-17.0,0,0,=,0,16,67,<,-51,36.0,39.666666666666664,<,-3.6666666666666643,33,32,>,1,40,48,<,-8,141,279,<,-138
147,16,22.333333333333332,5.333333333333333,>,17.0,0,0,=,0,67,16,>,51,39.666666666666664,36.0,>,3.6666666666666643,32,33,<,-1,48,40,>,8,279,141,>,138
0,16,5.333333333333333,8.333333333333334,<,-3.000000000000001,0,0,=,0,16,25,<,-9,36.0,38.666666666666664,<,-2.6666666666666643,33,30,>,3,40,50,<,-10,141,253,<,-112
125,16,8.333333333333334,5.333333333333333,>,3.000000000000001,0,0,=,0,25,16,>,9,38.666666666666664,36.0,>,2.6666666666666643,30,33,<,-3,50,40,>,10,253,141,>,112
0,16,5.333333333333333,12.666666666666666,<,-7.333333333333333,0,0,=,0,16,38,<,-22,36.0,51.333333333333336,<,-15.333333333333336,33,49,<,-16,40,55,<,-15,141,263,<,-122
128,16,12.666666666666666,5.333333333333333,>,7.333333333333333,0,0,=,0,38,16,>,22,51.333333333333336,36.0,>,15.333333333333336,49,33,>,16,55,40,>,15,263,141,>,122
0,16,5.333333333333333,23.333333333333332,<,-18.0,0,0,=,0,16,70,<,-54,36.0,47.0,<,-11.0,33,30,>,3,40,56,<,-16,141,233,<,-92
239,16,23.333333333333332,5.333333333333333,>,18.0,0,0,=,0,70,16,>,54,47.0,36.0,>,11.0,30,33,<,-3,56,40,>,16,233,141,>,92
0,15,31.333333333333332,17.333333333333332,>,14.0,0,0,=,0,73,32,>,41,45.333333333333336,43.666666666666664,>,1.6666666666666714,33,34,<,-1,53,57,<,-4,129,96,>,33
0,15,17.333333333333332,31.333333333333332,<,-14.0,0,0,=,0,32,73,<,-41,43.666666666666664,45.333333333333336,<,-1.6666666666666714,34,33,>,1,57,53,>,4,96,129,<,-33
0,15,31.333333333333332,17.0,>,14.333333333333332,0,0,=,0,73,35,>,38,45.333333333333336,47.333333333333336,<,-2.0,33,40,<,-7,53,56,<,-3,129,220,<,-91
90,15,17.0,31.333333333333332,<,-14.333333333333332,0,0,=,0,35,73,<,-38,47.333333333333336,45.333333333333336,>,2.0,40,33,>,7,56,53,>,3,220,129,>,91
0,15,31.333333333333332,48.666666666666664,<,-17.333333333333332,0,0,=,0,73,76,<,-3,45.333333333333336,50.333333333333336,<,-5.0,33,44,<,-11,53,56,<,-3,129,127,>,2
54,15,48.666666666666664,31.333333333333332,>,17.333333333333332,0,0,=,0,76,73,>,3,50.333333333333336,45.333333333333336,>,5.0,44,33,>,11,56,53,>,3,127,129,<,-2
0,15,31.333333333333332,37.0,<,-5.666666666666668,0,0,=,0,73,79,<,-6,45.333333333333336,46.333333333333336,<,-1.0,33,33,=,0,53,59,<,-6,129,104,>,25
76,15,37.0,31.333333333333332,>,5.666666666666668,0,0,=,0,79,73,>,6,46.333333333333336,45.333333333333336,>,1.0,33,33,=,0,59,53,>,6,104,129,<,-25
0,15,31.333333333333332,43.333333333333336,<,-12.000000000000004,0,0,=,0,73,89,<,-16,45.333333333333336,42.0,>,3.3333333333333357,33,35,<,-2,53,48,>,5,129,198,<,-69
106,15,43.333333333333336,31.333333333333332,>,12.000000000000004,0,0,=,0,89,73,>,16,42.0,45.333333333333336,<,-3.3333333333333357,35,33,>,2,48,53,<,-5,198,129,>,69
0,15,31.333333333333332,21.0,>,10.333333333333332,0,0,=,0,73,42,>,31,45.333333333333336,43.333333333333336,>,2.0,33,32,>,1,53,54,<,-1,129,203,<,-74
78,15,21.0,31.333333333333332,<,-10.333333333333332,0,0,=,0,42,73,<,-31,43.333333333333336,45.333333333333336,<,-2.0,32,33,<,-1,54,53,>,1,203,129,>,74
0,15,31.333333333333332,22.333333333333332,>,9.0,0,0,=,0,73,47,>,26,45.333333333333336,48.666666666666664,<,-3.3333333333333286,33,44,<,-11,53,52,>,1,129,197,<,-68
65,15,22.333333333333332,31.333333333333332,<,-9.0,0,0,=,0,47,73,<,-26,48.666666666666664,45.333333333333336,>,3.3333333333333286,44,33,>,11,52,53,<,-1,197,129,>,68
0,15,31.333333333333332,17.666666666666668,>,13.666666666666664,0,0,=,0,73,43,>,30,45.333333333333336,38.0,>,7.333333333333336,33,33,=,0,53,45,>,8,129,250,<,-121
0,15,17.666666666666668,31.333333333333332,<,-13.666666666666664,0,0,=,0,43,73,<,-30,38.0,45.333333333333336,<,-7.333333333333336,33,33,=,0,45,53,<,-8,250,129,>,121
0,15,31.333333333333332,30.0,>,1.3333333333333321,0,0,=,0,73,58,>,15,45.333333333333336,42.333333333333336,>,3.0,33,30,>,3,53,58,<,-5,129,250,<,-121
176,15,30.0,31.333333333333332,<,-1.3333333333333321,0,0,=,0,58,73,<,-15,42.333333333333336,45.333333333333336,<,-3.0,30,33,<,-3,58,53,>,5,250,129,>,121
0,15,31.333333333333332,25.0,>,6.333333333333332,0,0,=,0,73,48,>,25,45.333333333333336,42.666666666666664,>,2.6666666666666714,33,33,=,0,53,54,<,-1,129,242,<,-113
133,15,25.0,31.333333333333332,<,-6.333333333333332,0,0,=,0,48,73,<,-25,42.666666666666664,45.333333333333336,<,-2.6666666666666714,33,33,=,0,54,53,>,1,242,129,>,113
0,15,31.333333333333332,19.666666666666668,>,11.666666666666664,0,0,=,0,73,34,>,39,45.333333333333336,38.666666666666664,>,6.666666666666671,33,30,>,3,53,50,>,3,129,253,<,-124
127,15,19.666666666666668,31.333333333333332,<,-11.666666666666664,0,0,=,0,34,73,<,-39,38.666666666666664,45.333333333333336,<,-6.666666666666671,30,33,<,-3,50,53,<,-3,253,129,>,124
0,15,31.333333333333332,32.0,<,-0.6666666666666679,0,0,=,0,73,58,>,15,45.333333333333336,51.333333333333336,<,-6.0,33,49,<,-16,53,55,<,-2,129,263,<,-134
215,15,32.0,31.333333333333332,>,0.6666666666666679,0,0,=,0,58,73,<,-15,51.333333333333336,45.333333333333336,>,6.0,49,33,>,16,55,53,>,2,263,129,>,134
0,15,31.333333333333332,27.666666666666668,>,3.6666666666666643,0,0,=,0,73,67,>,6,45.333333333333336,39.666666666666664,>,5.666666666666671,33,32,>,1,53,48,>,5,129,279,<,-150
115,15,27.666666666666668,31.333333333333332,<,-3.6666666666666643,0,0,=,0,67,73,<,-6,39.666666666666664,45.333333333333336,<,-5.666666666666671,32,33,<,-1,48,53,<,-5,279,129,>,150
0,15,31.333333333333332,44.666666666666664,<,-13.333333333333332,0,0,=,0,73,70,>,3,45.333333333333336,47.0,<,-1.6666666666666643,33,30,>,3,53,56,<,-3,129,233,<,-104
238,15,44.666666666666664,31.333333333333332,>,13.333333333333332,0,0,=,0,70,73,<,-3,47.0,45.333333333333336,>,1.6666666666666643,30,33,<,-3,56,53,>,3,233,129,>,104
0,14,24.666666666666668,11.666666666666666,>,13.000000000000002,0,0,=,0,42,25,>,17,43.666666666666664,38.0,>,5.666666666666664,34,33,>,1,57,45,>,12,96,250,<,-154
0,14,11.666666666666666,24.666666666666668,<,-13.000000000000002,0,0,=,0,25,42,<,-17,38.0,43.666666666666664,<,-5.666666666666664,33,34,<,-1,45,57,<,-12,250,96,>,154
0,14,24.666666666666668,50.666666666666664,<,-25.999999999999996,0,0,=,0,42,82,<,-40,43.666666666666664,50.333333333333336,<,-6.666666666666671,34,44,<,-10,57,56,>,1,96,127,<,-31
54,14,50.666666666666664,24.666666666666668,>,25.999999999999996,0,0,=,0,82,42,>,40,50.333333333333336,43.666666666666664,>,6.666666666666671,44,34,>,10,56,57,<,-1,127,96,>,31
0,14,24.666666666666668,21.666666666666668,>,3.0,0,0,=,0,42,45,<,-3,43.666666666666664,48.666666666666664,<,-5.0,34,44,<,-10,57,52,>,5,96,197,<,-101
65,14,21.666666666666668,24.666666666666668,<,-3.0,0,0,=,0,45,42,>,3,48.666666666666664,43.666666666666664,>,5.0,44,34,>,10,52,57,<,-5,197,96,>,101
0,14,24.666666666666668,21.666666666666668,>,3.0,0,0,=,0,42,33,>,9,43.666666666666664,46.333333333333336,<,-2.6666666666666714,34,33,>,1,57,59,<,-2,96,104,<,-8
76,14,21.666666666666668,24.666666666666668,<,-3.0,0,0,=,0,33,42,<,-9,46.333333333333336,43.666666666666664,>,2.6666666666666714,33,34,<,-1,59,57,>,2,104,96,>,8
0,14,24.666666666666668,28.666666666666668,<,-4.0,0,0,=,0,42,44,<,-2,43.666666666666664,43.333333333333336,>,0.3333333333333286,34,32,>,2,57,54,>,3,96,203,<,-107
78,14,28.666666666666668,24.666666666666668,>,4.0,0,0,=,0,44,42,>,2,43.333333333333336,43.666666666666664,<,-0.3333333333333286,32,34,<,-2,54,57,<,-3,203,96,>,107
0,14,24.666666666666668,41.333333333333336,<,-16.666666666666668,0,0,=,0,42,89,<,-47,43.666666666666664,47.333333333333336,<,-3.6666666666666714,34,40,<,-6,57,56,>,1,96,220,<,-124
90,14,41.333333333333336,24.666666666666668,>,16.666666666666668,0,0,=,0,89,42,>,47,47.333333333333336,43.666666666666664,>,3.6666666666666714,40,34,>,6,56,57,<,-1,220,96,>,124
0,14,24.666666666666668,21.0,>,3.666666666666668,0,0,=,0,42,41,>,1,43.666666666666664,42.0,>,1.6666666666666643,34,35,<,-1,57,48,>,9,96,198,<,-102
0,14,21.0,24.666666666666668,<,-3.666666666666668,0,0,=,0,41,42,<,-1,42.0,43.666666666666664,<,-1.6666666666666643,35,34,>,1,48,57,<,-9,198,96,>,102
0,14,24.666666666666668,34.333333333333336,<,-9.666666666666668,0,0,=,0,42,87,<,-45,43.666666666666664,39.666666666666664,>,4.0,34,32,>,2,57,48,>,9,96,279,<,-183
115,14,34.333333333333336,24.666666666666668,>,9.666666666666668,0,0,=,0,87,42,>,45,39.666666666666664,43.666666666666664,<,-4.0,32,34,<,-2,48,57,<,-9,279,96,>,183
0,14,24.666666666666668,39.666666666666664,<,-14.999999999999996,0,0,=,0,42,85,<,-43,43.666666666666664,38.666666666666664,>,5.0,34,30,>,4,57,50,>,7,96,253,<,-157
127,14,39.666666666666664,24.666666666666668,>,14.999999999999996,0,0,=,0,85,42,>,43,38.666666666666664,43.666666666666664,<,-5.0,30,34,<,-4,50,57,<,-7,253,96,>,157
0,14,24.666666666666668,42.333333333333336,<,-17.666666666666668,0,0,=,0,42,79,<,-37,43.666666666666664,42.666666666666664,>,1.0,34,33,>,1,57,54,>,3,96,242,<,-146
133,14,42.333333333333336,24.666666666666668,>,17.666666666666668,0,0,=,0,79,42,>,37,42.666666666666664,43.666666666666664,<,-1.0,33,34,<,-1,54,57,<,-3,242,96,>,146
0,14,24.666666666666668,32.333333333333336,<,-7.666666666666668,0,0,=,0,42,58,<,-16,43.666666666666664,42.333333333333336,>,1.3333333333333286,34,30,>,4,57,58,<,-1,96,250,<,-154
176,14,32.333333333333336,24.666666666666668,>,7.666666666666668,0,0,=,0,58,42,>,16,42.333333333333336,43.666666666666664,<,-1.3333333333333286,30,34,<,-4,58,57,>,1,250,96,>,154
0,14,24.666666666666668,25.333333333333332,<,-0.6666666666666643,0,0,=,0,42,58,<,-16,43.666666666666664,51.333333333333336,<,-7.666666666666671,34,49,<,-15,57,55,>,2,96,263,<,-167
96,14,25.333333333333332,24.666666666666668,>,0.6666666666666643,0,0,=,0,58,42,>,16,51.333333333333336,43.666666666666664,>,7.666666666666671,49,34,>,15,55,57,<,-2,263,96,>,167
0,14,24.666666666666668,50.333333333333336,<,-25.666666666666668,0,0,=,0,42,87,<,-45,43.666666666666664,47.0,<,-3.3333333333333357,34,30,>,4,57,56,>,1,96,233,<,-137
196,14,50.333333333333336,24.666666666666668,>,25.666666666666668,0,0,=,0,87,42,>,45,47.0,43.666666666666664,>,3.3333333333333357,30,34,<,-4,56,57,<,-1,233,96,>,137
0,13,35.333333333333336,23.666666666666668,>,11.666666666666668,22,10,>,12,43,36,>,7,42.0,38.0,>,4.0,35,33,>,2,48,45,>,3,198,250,<,-52
0,13,23.666666666666668,35.333333333333336,<,-11.666666666666668,10,22,<,-12,36,43,<,-7,38.0,42.0,<,-4.0,33,35,<,-2,45,48,<,-3,250,198,>,52
0,13,35.333333333333336,73.33333333333333,<,-37.99999999999999,22,68,<,-46,43,82,<,-39,42.0,50.333333333333336,<,-8.333333333333336,35,44,<,-9,48,56,<,-8,198,127,>,71
163,13,73.33333333333333,35.333333333333336,>,37.99999999999999,68,22,>,46,82,43,>,39,50.333333333333336,42.0,>,8.333333333333336,44,35,>,9,56,48,>,8,127,198,<,-71
0,13,35.333333333333336,39.0,<,-3.6666666666666643,22,20,>,2,43,52,<,-9,42.0,48.666666666666664,<,-6.666666666666664,35,44,<,-9,48,52,<,-4,198,197,>,1
65,13,39.0,35.333333333333336,>,3.6666666666666643,20,22,<,-2,52,43,>,9,48.666666666666664,42.0,>,6.666666666666664,44,35,>,9,52,48,>,4,197,198,<,-1
0,13,35.333333333333336,26.0,>,9.333333333333336,22,13,>,9,43,33,>,10,42.0,46.333333333333336,<,-4.333333333333336,35,33,>,2,48,59,<,-11,198,104,>,94
0,13,26.0,35.333333333333336,<,-9.333333333333336,13,22,<,-9,33,43,<,-10,46.333333333333336,42.0,>,4.333333333333336,33,35,<,-2,59,48,>,11,104,198,<,-94
0,13,35.333333333333336,43.333333333333336,<,-8.0,22,42,<,-20,43,44,<,-1,42.0,43.333333333333336,<,-1.3333333333333357,35,32,>,3,48,54,<,-6,198,203,<,-5
150,13,43.333333333333336,35.333333333333336,>,8.0,42,22,>,20,44,43,>,1,43.333333333333336,42.0,>,1.3333333333333357,32,35,<,-3,54,48,>,6,203,198,>,5
0,13,35.333333333333336,70.66666666666667,<,-35.333333333333336,22,35,<,-13,43,89,<,-46,42.0,47.333333333333336,<,-5.333333333333336,35,40,<,-5,48,56,<,-8,198,220,<,-22
101,13,70.66666666666667,35.333333333333336,>,35.333333333333336,35,22,>,13,89,43,>,46,47.333333333333336,42.0,>,5.333333333333336,40,35,>,5,56,48,>,8,220,198,>,22
0,13,35.333333333333336,29.333333333333332,>,6.0000000000000036,22,12,>,10,43,58,<,-15,42.0,51.333333333333336,<,-9.333333333333336,35,49,<,-14,48,55,<,-7,198,263,<,-65
96,13,29.333333333333332,35.333333333333336,<,-6.0000000000000036,12,22,<,-10,58,43,>,15,51.333333333333336,42.0,>,9.333333333333336,49,35,>,14,55,48,>,7,263,198,>,65
0,13,35.333333333333336,41.0,<,-5.666666666666664,22,16,>,6,43,87,<,-44,42.0,39.666666666666664,>,2.3333333333333357,35,32,>,3,48,48,=,0,198,279,<,-81
126,13,41.0,35.333333333333336,>,5.666666666666664,16,22,<,-6,87,43,>,44,39.666666666666664,42.0,<,-2.3333333333333357,32,35,<,-3,48,48,=,0,279,198,>,81
0,13,35.333333333333336,64.33333333333333,<,-28.999999999999993,22,34,<,-12,43,85,<,-42,42.0,38.666666666666664,>,3.3333333333333357,35,30,>,5,48,50,<,-2,198,253,<,-55
127,13,64.33333333333333,35.333333333333336,>,28.999999999999993,34,22,>,12,85,43,>,42,38.666666666666664,42.0,<,-3.3333333333333357,30,35,<,-5,50,48,>,2,253,198,>,55
0,13,35.333333333333336,57.0,<,-21.666666666666664,22,44,<,-22,43,79,<,-36,42.0,42.666666666666664,<,-0.6666666666666643,35,33,>,2,48,54,<,-6,198,242,<,-44
155,13,57.0,35.333333333333336,>,21.666666666666664,44,22,>,22,79,43,>,36,42.666666666666664,42.0,>,0.6666666666666643,33,35,<,-2,54,48,>,6,242,198,>,44
0,13,35.333333333333336,52.333333333333336,<,-17.0,22,39,<,-17,43,60,<,-17,42.0,42.333333333333336,<,-0.3333333333333357,35,30,>,5,48,58,<,-10,198,250,<,-52
179,13,52.333333333333336,35.333333333333336,>,17.0,39,22,>,17,60,43,>,17,42.333333333333336,42.0,>,0.3333333333333357,30,35,<,-5,58,48,>,10,250,198,>,52
0,13,35.333333333333336,53.666666666666664,<,-18.33333333333333,22,10,>,12,43,87,<,-44,42.0,47.0,<,-5.0,35,30,>,5,48,56,<,-8,198,233,<,-35
196,13,53.666666666666664,35.333333333333336,>,18.33333333333333,10,22,<,-12,87,43,>,44,47.0,42.0,>,5.0,30,35,<,-5,56,48,>,8,233,198,>,35
0,12,35.333333333333336,28.333333333333332,>,7.0000000000000036,13,10,>,3,61,39,>,22,46.333333333333336,38.0,>,8.333333333333336,33,33,=,0,59,45,>,14,104,250,<,-146
0,12,28.333333333333332,35.333333333333336,<,-7.0000000000000036,10,13,<,-3,39,61,<,-22,38.0,46.333333333333336,<,-8.333333333333336,33,33,=,0,45,59,<,-14,250,104,>,146
0,12,35.333333333333336,32.666666666666664,>,2.6666666666666714,13,20,<,-7,61,52,>,9,46.333333333333336,48.666666666666664,<,-2.3333333333333286,33,44,<,-11,59,52,>,7,104,197,<,-93
0,12,32.666666666666664,35.333333333333336,<,-2.6666666666666714,20,13,>,7,52,61,<,-9,48.666666666666664,46.333333333333336,>,2.3333333333333286,44,33,>,11,52,59,<,-7,197,104,>,93
0,12,35.333333333333336,37.666666666666664,<,-2.3333333333333286,13,12,>,1,61,58,>,3,46.333333333333336,51.333333333333336,<,-5.0,33,49,<,-16,59,55,>,4,104,263,<,-159
60,12,37.666666666666664,35.333333333333336,>,2.3333333333333286,12,13,<,-1,58,61,<,-3,51.333333333333336,46.333333333333336,>,5.0,49,33,>,16,55,59,<,-4,263,104,>,159
0,12,35.333333333333336,71.0,<,-35.666666666666664,13,35,<,-22,61,90,<,-29,46.333333333333336,47.333333333333336,<,-1.0,33,40,<,-7,59,56,>,3,104,220,<,-116
101,12,71.0,35.333333333333336,>,35.666666666666664,35,13,>,22,90,61,>,29,47.333333333333336,46.333333333333336,>,1.0,40,33,>,7,56,59,<,-3,220,104,>,116
0,12,35.333333333333336,31.333333333333332,>,4.0000000000000036,13,16,<,-3,61,58,>,3,46.333333333333336,39.666666666666664,>,6.666666666666671,33,32,>,1,59,48,>,11,104,279,<,-175
75,12,31.333333333333332,35.333333333333336,<,-4.0000000000000036,16,13,>,3,58,61,<,-3,39.666666666666664,46.333333333333336,<,-6.666666666666671,32,33,<,-1,48,59,<,-11,279,104,>,175
0,12,35.333333333333336,45.666666666666664,<,-10.333333333333329,13,29,<,-16,61,74,<,-13,46.333333333333336,38.666666666666664,>,7.666666666666671,33,30,>,3,59,50,>,9,104,253,<,-149
93,12,45.666666666666664,35.333333333333336,>,10.333333333333329,29,13,>,16,74,61,>,13,38.666666666666664,46.333333333333336,<,-7.666666666666671,30,33,<,-3,50,59,<,-9,253,104,>,149
0,12,35.333333333333336,33.333333333333336,>,2.0,13,14,<,-1,61,44,>,17,46.333333333333336,43.333333333333336,>,3.0,33,32,>,1,59,54,>,5,104,203,<,-99
94,12,33.333333333333336,35.333333333333336,<,-2.0,14,13,>,1,44,61,<,-17,43.333333333333336,46.333333333333336,<,-3.0,32,33,<,-1,54,59,<,-5,203,104,>,99
0,12,35.333333333333336,42.333333333333336,<,-7.0,13,35,<,-22,61,48,>,13,46.333333333333336,42.666666666666664,>,3.6666666666666714,33,33,=,0,59,54,>,5,104,242,<,-138
31,12,42.333333333333336,35.333333333333336,>,7.0,35,13,>,22,48,61,<,-13,42.666666666666664,46.333333333333336,<,-3.6666666666666714,33,33,=,0,54,59,<,-5,242,104,>,138
0,12,35.333333333333336,68.0,<,-32.666666666666664,13,66,<,-53,61,70,<,-9,46.333333333333336,50.333333333333336,<,-4.0,33,44,<,-11,59,56,>,3,104,127,<,-23
138,12,68.0,35.333333333333336,>,32.666666666666664,66,13,>,53,70,61,>,9,50.333333333333336,46.333333333333336,>,4.0,44,33,>,11,56,59,<,-3,127,104,>,23
0,12,35.333333333333336,68.66666666666667,<,-33.333333333333336,13,58,<,-45,61,88,<,-27,46.333333333333336,42.333333333333336,>,4.0,33,30,>,3,59,58,>,1,104,250,<,-146
179,12,68.66666666666667,35.333333333333336,>,33.333333333333336,58,13,>,45,88,61,>,27,42.333333333333336,46.333333333333336,<,-4.0,30,33,<,-3,58,59,<,-1,250,104,>,146
0,12,35.333333333333336,41.0,<,-5.666666666666664,13,10,>,3,61,64,<,-3,46.333333333333336,47.0,<,-0.6666666666666643,33,30,>,3,59,56,>,3,104,233,<,-129
38,12,41.0,35.333333333333336,>,5.666666666666664,10,13,<,-3,64,61,>,3,47.0,46.333333333333336,>,0.6666666666666643,30,33,<,-3,56,59,<,-3,233,104,>,129
0,11,36.0,31.666666666666668,>,4.333333333333332,20,10,>,10,62,46,>,16,48.666666666666664,38.0,>,10.666666666666664,44,33,>,11,52,45,>,7,197,250,<,-53
0,11,31.666666666666668,36.0,<,-4.333333333333332,10,20,<,-10,46,62,<,-16,38.0,48.666666666666664,<,-10.666666666666664,33,44,<,-11,45,52,<,-7,250,197,>,53
0,11,36.0,37.666666666666664,<,-1.6666666666666643,20,30,<,-10,62,48,>,14,48.666666666666664,42.666666666666664,>,6.0,44,33,>,11,52,54,<,-2,197,242,<,-45
31,11,37.666666666666664,36.0,>,1.6666666666666643,30,20,>,10,48,62,<,-14,42.666666666666664,48.666666666666664,<,-6.0,33,44,<,-11,54,52,>,2,242,197,>,45
0,11,36.0,41.666666666666664,<,-5.666666666666664,20,12,>,8,62,64,<,-2,48.666666666666664,47.0,>,1.6666666666666643,44,30,>,14,52,56,<,-4,197,233,<,-36
38,11,41.666666666666664,36.0,>,5.666666666666664,12,20,<,-8,64,62,>,2,47.0,48.666666666666664,<,-1.6666666666666643,30,44,<,-14,56,52,>,4,233,197,>,36
0,11,36.0,58.666666666666664,<,-22.666666666666664,20,43,<,-23,62,75,<,-13,48.666666666666664,51.333333333333336,<,-2.6666666666666714,44,49,<,-5,52,55,<,-3,197,263,<,-66
60,11,58.666666666666664,36.0,>,22.666666666666664,43,20,>,23,75,62,>,13,51.333333333333336,48.666666666666664,>,2.6666666666666714,49,44,>,5,55,52,>,3,263,197,>,66
0,11,36.0,47.666666666666664,<,-11.666666666666664,20,16,>,4,62,69,<,-7,48.666666666666664,39.666666666666664,>,9.0,44,32,>,12,52,48,>,4,197,279,<,-82
75,11,47.666666666666664,36.0,>,11.666666666666664,16,20,<,-4,69,62,>,7,39.666666666666664,48.666666666666664,<,-9.0,32,44,<,-12,48,52,<,-4,279,197,>,82
0,11,36.0,45.333333333333336,<,-9.333333333333336,20,29,<,-9,62,73,<,-11,48.666666666666664,38.666666666666664,>,10.0,44,30,>,14,52,50,>,2,197,253,<,-56
93,11,45.333333333333336,36.0,>,9.333333333333336,29,20,>,9,73,62,>,11,38.666666666666664,48.666666666666664,<,-10.0,30,44,<,-14,50,52,<,-2,253,197,>,56
0,11,36.0,23.666666666666668,>,12.333333333333332,20,14,>,6,62,42,>,20,48.666666666666664,43.333333333333336,>,5.333333333333329,44,32,>,12,52,54,<,-2,197,203,<,-6
0,11,23.666666666666668,36.0,<,-12.333333333333332,14,20,<,-6,42,62,<,-20,43.333333333333336,48.666666666666664,<,-5.333333333333329,32,44,<,-12,54,52,>,2,203,197,>,6
0,11,36.0,53.666666666666664,<,-17.666666666666664,20,35,<,-15,62,90,<,-28,48.666666666666664,47.333333333333336,>,1.3333333333333286,44,40,>,4,52,56,<,-4,197,220,<,-23
76,11,53.666666666666664,36.0,>,17.666666666666664,35,20,>,15,90,62,>,28,47.333333333333336,48.666666666666664,<,-1.3333333333333286,40,44,<,-4,56,52,>,4,220,197,>,23
0,11,36.0,75.0,<,-39.0,20,66,<,-46,62,89,<,-27,48.666666666666664,50.333333333333336,<,-1.6666666666666714,44,44,=,0,52,56,<,-4,197,127,>,70
138,11,75.0,36.0,>,39.0,66,20,>,46,89,62,>,27,50.333333333333336,48.666666666666664,>,1.6666666666666714,44,44,=,0,56,52,>,4,127,197,<,-70
0,11,36.0,74.0,<,-38.0,20,58,<,-38,62,88,<,-26,48.666666666666664,42.333333333333336,>,6.333333333333329,44,30,>,14,52,58,<,-6,197,250,<,-53
161,11,74.0,36.0,>,38.0,58,20,>,38,88,62,>,26,42.333333333333336,48.666666666666664,<,-6.333333333333329,30,44,<,-14,58,52,>,6,250,197,>,53
0,10,36.666666666666664,43.0,<,-6.333333333333336,15,10,>,5,53,73,<,-20,43.333333333333336,38.0,>,5.333333333333336,32,33,<,-1,54,45,>,9,203,250,<,-47
0,10,43.0,36.666666666666664,>,6.333333333333336,10,15,<,-5,73,53,>,20,38.0,43.333333333333336,<,-5.333333333333336,33,32,>,1,45,54,<,-9,250,203,>,47
0,10,36.666666666666664,47.0,<,-10.333333333333336,15,30,<,-15,53,63,<,-10,43.333333333333336,42.666666666666664,>,0.6666666666666714,32,33,<,-1,54,54,=,0,203,242,<,-39
31,10,47.0,36.666666666666664,>,10.333333333333336,30,15,>,15,63,53,>,10,42.666666666666664,43.333333333333336,<,-0.6666666666666714,33,32,>,1,54,54,=,0,242,203,>,39
0,10,36.666666666666664,30.333333333333332,>,6.333333333333332,15,12,>,3,53,64,<,-11,43.333333333333336,47.0,<,-3.6666666666666643,32,30,>,2,54,56,<,-2,203,233,<,-30
0,10,30.333333333333332,36.666666666666664,<,-6.333333333333332,12,15,<,-3,64,53,>,11,47.0,43.333333333333336,>,3.6666666666666643,30,32,<,-2,56,54,>,2,233,203,>,30
0,10,36.666666666666664,54.0,<,-17.333333333333336,15,29,<,-14,53,75,<,-22,43.333333333333336,51.333333333333336,<,-8.0,32,49,<,-17,54,55,<,-1,203,263,<,-60
27,10,54.0,36.666666666666664,>,17.333333333333336,29,15,>,14,75,53,>,22,51.333333333333336,43.333333333333336,>,8.0,49,32,>,17,55,54,>,1,263,203,>,60
0,10,36.666666666666664,48.666666666666664,<,-12.0,15,16,<,-1,53,69,<,-16,43.333333333333336,39.666666666666664,>,3.6666666666666714,32,32,=,0,54,48,>,6,203,279,<,-76
48,10,48.666666666666664,36.666666666666664,>,12.0,16,15,>,1,69,53,>,16,39.666666666666664,43.333333333333336,<,-3.6666666666666714,32,32,=,0,48,54,<,-6,279,203,>,76
0,10,36.666666666666664,43.333333333333336,<,-6.666666666666671,15,35,<,-20,53,59,<,-6,43.333333333333336,47.333333333333336,<,-4.0,32,40,<,-8,54,56,<,-2,203,220,<,-17
76,10,43.333333333333336,36.666666666666664,>,6.666666666666671,35,15,>,20,59,53,>,6,47.333333333333336,43.333333333333336,>,4.0,40,32,>,8,56,54,>,2,220,203,>,17
0,10,36.666666666666664,52.0,<,-15.333333333333336,15,34,<,-19,53,73,<,-20,43.333333333333336,38.666666666666664,>,4.666666666666671,32,30,>,2,54,50,>,4,203,253,<,-50
103,10,52.0,36.666666666666664,>,15.333333333333336,34,15,>,19,73,53,>,20,38.666666666666664,43.333333333333336,<,-4.666666666666671,30,32,<,-2,50,54,<,-4,253,203,>,50
0,10,36.666666666666664,56.666666666666664,<,-20.0,15,11,>,4,53,89,<,-36,43.333333333333336,50.333333333333336,<,-7.0,32,44,<,-12,54,56,<,-2,203,127,>,76
126,10,56.666666666666664,36.666666666666664,>,20.0,11,15,<,-4,89,53,>,36,50.333333333333336,43.333333333333336,>,7.0,44,32,>,12,56,54,>,2,127,203,<,-76
0,10,36.666666666666664,53.333333333333336,<,-16.66666666666667,15,26,<,-11,53,76,<,-23,43.333333333333336,42.333333333333336,>,1.0,32,30,>,2,54,58,<,-4,203,250,<,-47
66,10,53.333333333333336,36.666666666666664,>,16.66666666666667,26,15,>,11,76,53,>,23,42.333333333333336,43.333333333333336,<,-1.0,30,32,<,-2,58,54,>,4,250,203,>,47
0,9,33.666666666666664,57.0,<,-23.333333333333336,15,10,>,5,64,88,<,-24,47.0,38.0,>,9.0,30,33,<,-3,56,45,>,11,233,250,<,-17
0,9,57.0,33.666666666666664,>,23.333333333333336,10,15,<,-5,88,64,>,24,38.0,47.0,<,-9.0,33,30,>,3,45,56,<,-11,250,233,>,17
0,9,33.666666666666664,49.0,<,-15.333333333333336,15,29,<,-14,64,60,>,4,47.0,51.333333333333336,<,-4.333333333333336,30,49,<,-19,56,55,>,1,233,263,<,-30
27,9,49.0,33.666666666666664,>,15.333333333333336,29,15,>,14,60,64,<,-4,51.333333333333336,47.0,>,4.333333333333336,49,30,>,19,55,56,<,-1,263,233,>,30
0,9,33.666666666666664,46.666666666666664,<,-13.0,15,29,<,-14,64,63,>,1,47.0,42.666666666666664,>,4.333333333333336,30,33,<,-3,56,54,>,2,233,242,<,-9
54,9,46.666666666666664,33.666666666666664,>,13.0,29,15,>,14,63,64,<,-1,42.666666666666664,47.0,<,-4.333333333333336,33,30,>,3,54,56,<,-2,242,233,>,9
0,9,33.666666666666664,54.666666666666664,<,-21.0,15,16,<,-1,64,87,<,-23,47.0,39.666666666666664,>,7.333333333333336,30,32,<,-2,56,48,>,8,233,279,<,-46
48,9,54.666666666666664,33.666666666666664,>,21.0,16,15,>,1,87,64,>,23,39.666666666666664,47.0,<,-7.333333333333336,32,30,>,2,48,56,<,-8,279,233,>,46
0,9,33.666666666666664,46.666666666666664,<,-13.0,15,26,<,-11,64,58,>,6,47.0,42.333333333333336,>,4.666666666666664,30,30,=,0,56,58,<,-2,233,250,<,-17
66,9,46.666666666666664,33.666666666666664,>,13.0,26,15,>,11,58,64,<,-6,42.333333333333336,47.0,<,-4.666666666666664,30,30,=,0,58,56,>,2,250,233,>,17
0,9,33.666666666666664,34.666666666666664,<,-1.0,15,10,>,5,64,59,>,5,47.0,47.333333333333336,<,-0.3333333333333357,30,40,<,-10,56,56,=,0,233,220,>,13
0,9,34.666666666666664,33.666666666666664,>,1.0,10,15,<,-5,59,64,<,-5,47.333333333333336,47.0,>,0.3333333333333357,40,30,>,10,56,56,=,0,220,233,<,-13
0,9,33.666666666666664,46.333333333333336,<,-12.666666666666671,15,34,<,-19,64,56,>,8,47.0,38.666666666666664,>,8.333333333333336,30,30,=,0,56,50,>,6,233,253,<,-20
103,9,46.333333333333336,33.666666666666664,>,12.666666666666671,34,15,>,19,56,64,<,-8,38.666666666666664,47.0,<,-8.333333333333336,30,30,=,0,50,56,<,-6,253,233,>,20
0,9,33.666666666666664,37.333333333333336,<,-3.6666666666666714,15,11,>,4,64,70,<,-6,47.0,50.333333333333336,<,-3.3333333333333357,30,44,<,-14,56,56,=,0,233,127,>,106
118,9,37.333333333333336,33.666666666666664,>,3.6666666666666714,11,15,<,-4,70,64,>,6,50.333333333333336,47.0,>,3.3333333333333357,44,30,>,14,56,56,=,0,127,233,<,-106
0,8,29.0,60.0,<,-31.0,10,10,=,0,42,88,<,-46,47.333333333333336,38.0,>,9.333333333333336,40,33,>,7,56,45,>,11,220,250,<,-30
0,8,60.0,29.0,>,31.0,10,10,=,0,88,42,>,46,38.0,47.333333333333336,<,-9.333333333333336,33,40,<,-7,45,56,<,-11,250,220,>,30
0,8,29.0,57.333333333333336,<,-28.333333333333336,10,54,<,-44,42,60,<,-18,47.333333333333336,51.333333333333336,<,-4.0,40,49,<,-9,56,55,>,1,220,263,<,-43
121,8,57.333333333333336,29.0,>,28.333333333333336,54,10,>,44,60,42,>,18,51.333333333333336,47.333333333333336,>,4.0,49,40,>,9,55,56,<,-1,263,220,>,43
0,8,29.0,61.0,<,-32.0,10,16,<,-6,42,87,<,-45,47.333333333333336,39.666666666666664,>,7.666666666666671,40,32,>,8,56,48,>,8,220,279,<,-59
95,8,61.0,29.0,>,32.0,16,10,>,6,87,42,>,45,39.666666666666664,47.333333333333336,<,-7.666666666666671,32,40,<,-8,48,56,<,-8,279,220,>,59
0,8,29.0,29.0,=,0.0,10,10,=,0,42,48,<,-6,47.333333333333336,42.666666666666664,>,4.666666666666671,40,33,>,7,56,54,>,2,220,242,<,-22
29,8,29.0,29.0,=,0.0,10,10,=,0,48,42,>,6,42.666666666666664,47.333333333333336,<,-4.666666666666671,33,40,<,-7,54,56,<,-2,242,220,>,22
0,8,29.0,49.0,<,-20.0,10,33,<,-23,42,58,<,-16,47.333333333333336,42.333333333333336,>,5.0,40,30,>,10,56,58,<,-2,220,250,<,-30
81,8,49.0,29.0,>,20.0,33,10,>,23,58,42,>,16,42.333333333333336,47.333333333333336,<,-5.0,30,40,<,-10,58,56,>,2,250,220,>,30
0,8,29.0,34.333333333333336,<,-5.333333333333336,10,13,<,-3,42,56,<,-14,47.333333333333336,38.666666666666664,>,8.666666666666671,40,30,>,10,56,50,>,6,220,253,<,-33
75,8,34.333333333333336,29.0,>,5.333333333333336,13,10,>,3,56,42,>,14,38.666666666666664,47.333333333333336,<,-8.666666666666671,30,40,<,-10,50,56,<,-6,253,220,>,33
0,8,29.0,52.666666666666664,<,-23.666666666666664,10,31,<,-21,42,70,<,-28,47.333333333333336,50.333333333333336,<,-3.0,40,44,<,-4,56,56,=,0,220,127,>,93
118,8,52.666666666666664,29.0,>,23.666666666666664,31,10,>,21,70,42,>,28,50.333333333333336,47.333333333333336,>,3.0,44,40,>,4,56,56,=,0,127,220,<,-93
0,7,60.0,46.0,>,14.0,10,10,=,0,88,80,>,8,38.0,42.666666666666664,<,-4.666666666666664,33,33,=,0,45,54,<,-9,250,242,>,8
29,7,46.0,60.0,<,-14.0,10,10,=,0,80,88,<,-8,42.666666666666664,38.0,>,4.666666666666664,33,33,=,0,54,45,>,9,242,250,<,-8
0,7,60.0,32.333333333333336,>,27.666666666666664,10,13,<,-3,88,50,>,38,38.0,38.666666666666664,<,-0.6666666666666643,33,30,>,3,45,50,<,-5,250,253,<,-3
75,7,32.333333333333336,60.0,<,-27.666666666666664,13,10,>,3,50,88,<,-38,38.666666666666664,38.0,>,0.6666666666666643,30,33,<,-3,50,45,>,5,253,250,>,3
0,7,60.0,53.333333333333336,>,6.666666666666664,10,33,<,-23,88,69,>,19,38.0,42.333333333333336,<,-4.333333333333336,33,30,>,3,45,58,<,-13,250,250,=,0
81,7,53.333333333333336,60.0,<,-6.666666666666664,33,10,>,23,69,88,<,-19,42.333333333333336,38.0,>,4.333333333333336,30,33,<,-3,58,45,>,13,250,250,=,0
0,7,60.0,55.0,>,5.0,10,16,<,-6,88,80,>,8,38.0,39.666666666666664,<,-1.6666666666666643,33,32,>,1,45,48,<,-3,250,279,<,-29
83,7,55.0,60.0,<,-5.0,16,10,>,6,80,88,<,-8,39.666666666666664,38.0,>,1.6666666666666643,32,33,<,-1,48,45,>,3,279,250,>,29
0,7,60.0,71.0,<,-11.0,10,57,<,-47,88,86,>,2,38.0,50.333333333333336,<,-12.333333333333336,33,44,<,-11,45,56,<,-11,250,127,>,123
163,7,71.0,60.0,>,11.0,57,10,>,47,86,88,<,-2,50.333333333333336,38.0,>,12.333333333333336,44,33,>,11,56,45,>,11,127,250,<,-123
0,7,60.0,48.0,>,12.0,10,32,<,-22,88,58,>,30,38.0,51.333333333333336,<,-13.333333333333336,33,49,<,-16,45,55,<,-10,250,263,<,-13
0,7,48.0,60.0,<,-12.0,32,10,>,22,58,88,<,-30,51.333333333333336,38.0,>,13.333333333333336,49,33,>,16,55,45,>,10,263,250,>,13
0,6,38.0,53.0,<,-15.0,28,10,>,18,54,80,<,-26,51.333333333333336,42.666666666666664,>,8.666666666666671,49,33,>,16,55,54,>,1,263,242,>,21
29,6,53.0,38.0,>,15.0,10,28,<,-18,80,54,>,26,42.666666666666664,51.333333333333336,<,-8.666666666666671,33,49,<,-16,54,55,<,-1,242,263,<,-21
0,6,38.0,49.333333333333336,<,-11.333333333333336,28,13,>,15,54,85,<,-31,51.333333333333336,38.666666666666664,>,12.666666666666671,49,30,>,19,55,50,>,5,263,253,>,10
75,6,49.333333333333336,38.0,>,11.333333333333336,13,28,<,-15,85,54,>,31,38.666666666666664,51.333333333333336,<,-12.666666666666671,30,49,<,-19,50,55,<,-5,253,263,<,-10
0,6,38.0,47.333333333333336,<,-9.333333333333336,28,33,<,-5,54,69,<,-15,51.333333333333336,42.333333333333336,>,9.0,49,30,>,19,55,58,<,-3,263,250,>,13
81,6,47.333333333333336,38.0,>,9.333333333333336,33,28,>,5,69,54,>,15,42.333333333333336,51.333333333333336,<,-9.0,30,49,<,-19,58,55,>,3,250,263,<,-13
0,6,38.0,62.333333333333336,<,-24.333333333333336,28,38,<,-10,54,80,<,-26,51.333333333333336,39.666666666666664,>,11.666666666666671,49,32,>,17,55,48,>,7,263,279,<,-16
83,6,62.333333333333336,38.0,>,24.333333333333336,38,28,>,10,80,54,>,26,39.666666666666664,51.333333333333336,<,-11.666666666666671,32,49,<,-17,48,55,<,-7,279,263,>,16
0,6,38.0,51.333333333333336,<,-13.333333333333336,28,11,>,17,54,86,<,-32,51.333333333333336,50.333333333333336,>,1.0,49,44,>,5,55,56,<,-1,263,127,>,136
0,6,51.333333333333336,38.0,>,13.333333333333336,11,28,<,-17,86,54,>,32,50.333333333333336,51.333333333333336,<,-1.0,44,49,<,-5,56,55,>,1,127,263,<,-136
0,5,29.666666666666668,31.0,<,-1.3333333333333321,11,10,>,1,57,69,<,-12,50.333333333333336,42.666666666666664,>,7.666666666666671,44,33,>,11,56,54,>,2,127,242,<,-115
21,5,31.0,29.666666666666668,>,1.3333333333333321,10,11,<,-1,69,57,>,12,42.666666666666664,50.333333333333336,<,-7.666666666666671,33,44,<,-11,54,56,<,-2,242,127,>,115
0,5,29.666666666666668,57.333333333333336,<,-27.666666666666668,11,13,<,-2,57,85,<,-28,50.333333333333336,38.666666666666664,>,11.666666666666671,44,30,>,14,56,50,>,6,127,253,<,-126
75,5,57.333333333333336,29.666666666666668,>,27.666666666666668,13,11,>,2,85,57,>,28,38.666666666666664,50.333333333333336,<,-11.666666666666671,30,44,<,-14,50,56,<,-6,253,127,>,126
0,5,29.666666666666668,52.0,<,-22.333333333333332,11,33,<,-22,57,83,<,-26,50.333333333333336,42.333333333333336,>,8.0,44,30,>,14,56,58,<,-2,127,250,<,-123
81,5,52.0,29.666666666666668,>,22.333333333333332,33,11,>,22,83,57,>,26,42.333333333333336,50.333333333333336,<,-8.0,30,44,<,-14,58,56,>,2,250,127,>,123
0,5,29.666666666666668,48.0,<,-18.333333333333332,11,26,<,-15,57,80,<,-23,50.333333333333336,39.666666666666664,>,10.666666666666671,44,32,>,12,56,48,>,8,127,279,<,-152
0,5,48.0,29.666666666666668,>,18.333333333333332,26,11,>,15,80,57,>,23,39.666666666666664,50.333333333333336,<,-10.666666666666671,32,44,<,-12,48,56,<,-8,279,127,>,152
0,4,64.33333333333333,17.0,>,47.33333333333333,26,10,>,16,87,27,>,60,39.666666666666664,42.666666666666664,<,-3.0,32,33,<,-1,48,54,<,-6,279,242,>,37
0,4,17.0,64.33333333333333,<,-47.33333333333333,10,26,<,-16,27,87,<,-60,42.666666666666664,39.666666666666664,>,3.0,33,32,>,1,54,48,>,6,242,279,<,-37
0,4,64.33333333333333,47.666666666666664,>,16.666666666666664,26,13,>,13,87,74,>,13,39.666666666666664,38.666666666666664,>,1.0,32,30,>,2,48,50,<,-2,279,253,>,26
49,4,47.666666666666664,64.33333333333333,<,-16.666666666666664,13,26,<,-13,74,87,<,-13,38.666666666666664,39.666666666666664,<,-1.0,30,32,<,-2,50,48,>,2,253,279,<,-26
0,4,64.33333333333333,48.666666666666664,>,15.666666666666664,26,30,<,-4,87,83,>,4,39.666666666666664,42.333333333333336,<,-2.6666666666666714,32,30,>,2,48,58,<,-10,279,250,>,29
4,4,48.666666666666664,64.33333333333333,<,-15.666666666666664,30,26,>,4,83,87,<,-4,42.333333333333336,39.666666666666664,>,2.6666666666666714,30,32,<,-2,58,48,>,10,250,279,<,-29
0,3,39.333333333333336,46.333333333333336,<,-7.0,10,30,<,-20,81,76,>,5,42.666666666666664,42.333333333333336,>,0.3333333333333286,33,30,>,3,54,58,<,-4,242,250,<,-8
4,3,46.333333333333336,39.333333333333336,>,7.0,30,10,>,20,76,81,<,-5,42.333333333333336,42.666666666666664,<,-0.3333333333333286,30,33,<,-3,58,54,>,4,250,242,>,8
0,3,39.333333333333336,47.333333333333336,<,-8.0,10,13,<,-3,81,73,>,8,42.666666666666664,38.666666666666664,>,4.0,33,30,>,3,54,50,>,4,242,253,<,-11
59,3,47.333333333333336,39.333333333333336,>,8.0,13,10,>,3,73,81,<,-8,38.666666666666664,42.666666666666664,<,-4.0,30,33,<,-3,50,54,<,-4,253,242,>,11
0,2,35.0,62.666666666666664,<,-27.666666666666664,13,33,<,-20,73,79,<,-6,38.666666666666664,42.333333333333336,<,-3.6666666666666714,30,30,=,0,50,58,<,-8,253,250,>,3
81,2,62.666666666666664,35.0,>,27.666666666666664,33,13,>,20,79,73,>,6,42.333333333333336,38.666666666666664,>,3.6666666666666714,30,30,=,0,58,50,>,8,250,253,<,-3
0,17,0.0,0.0,=,0.0,0,0,=,0,0,0,=,0,50.0,38.666666666666664,>,11.333333333333336,40,35,>,5,59,41,>,18,113,112,>,1
88,17,0.0,0.0,=,0.0,0,0,=,0,0,0,=,0,38.666666666666664,50.0,<,-11.333333333333336,35,40,<,-5,41,59,<,-18,112,113,<,-1
0,17,0.0,0.0,=,0.0,0,0,=,0,0,0,=,0,50.0,48.333333333333336,>,1.6666666666666643,40,34,>,6,59,59,=,0,113,184,<,-71
152,17,0.0,0.0,=,0.0,0,0,=,0,0,0,=,0,48.333333333333336,50.0,<,-1.6666666666666643,34,40,<,-6,59,59,=,0,184,113,>,71
0,17,0.0,0.0,=,0.0,0,0,=,0,0,0,=,0,50.0,41.333333333333336,>,8.666666666666664,40,35,>,5,59,45,>,14,113,129,<,-16
45,17,0.0,0.0,=,0.0,0,0,=,0,0,0,=,0,41.333333333333336,50.0,<,-8.666666666666664,35,40,<,-5,45,59,<,-14,129,113,>,16
0,17,0.0,0.0,=,0.0,0,0,=,0,0,0,=,0,50.0,49.333333333333336,>,0.6666666666666643,40,48,<,-8,59,52,>,7,113,92,>,21
17,17,0.0,0.0,=,0.0,0,0,=,0,0,0,=,0,49.333333333333336,50.0,<,-0.6666666666666643,48,40,>,8,52,59,<,-7,92,113,<,-21
0,17,0.0,0.0,=,0.0,0,0,=,0,0,0,=,0,50.0,49.333333333333336,>,0.6666666666666643,40,44,<,-4,59,57,>,2,113,182,<,-69
137,17,0.0,0.0,=,0.0,0,0,=,0,0,0,=,0,49.333333333333336,50.0,<,-0.6666666666666643,44,40,>,4,57,59,<,-2,182,113,>,69
0,17,0.0,0.0,=,0.0,0,0,=,0,0,0,=,0,50.0,49.333333333333336,>,0.6666666666666643,40,39,>,1,59,59,=,0,113,244,<,-131
151,17,0.0,0.0,=,0.0,0,0,=,0,0,0,=,0,49.333333333333336,50.0,<,-0.6666666666666643,39,40,<,-1,59,59,=,0,244,113,>,131
0,17,0.0,0.0,=,0.0,0,0,=,0,0,0,=,0,50.0,47.333333333333336,>,2.6666666666666643,40,41,<,-1,59,56,>,3,113,245,<,-132
134,17,0.0,0.0,=,0.0,0,0,=,0,0,0,=,0,47.333333333333336,50.0,<,-2.6666666666666643,41,40,>,1,56,59,<,-3,245,113,>,132
0,17,0.0,0.0,=,0.0,0,0,=,0,0,0,=,0,50.0,52.666666666666664,<,-2.6666666666666643,40,51,<,-11,59,56,>,3,113,153,<,-40
81,17,0.0,0.0,=,0.0,0,0,=,0,0,0,=,0,52.666666666666664,50.0,>,2.6666666666666643,51,40,>,11,56,59,<,-3,153,113,>,40
0,17,0.0,0.0,=,0.0,0,0,=,0,0,0,=,0,50.0,36.333333333333336,>,13.666666666666664,40,32,>,8,59,45,>,14,113,110,>,3
0,17,0.0,0.0,=,0.0,0,0,=,0,0,0,=,0,36.333333333333336,50.0,<,-13.666666666666664,32,40,<,-8,45,59,<,-14,110,113,<,-3
0,17,0.0,0.0,=,0.0,0,0,=,0,0,0,=,0,50.0,46.333333333333336,>,3.6666666666666643,40,43,<,-3,59,52,>,7,113,262,<,-149
217,17,0.0,0.0,=,0.0,0,0,=,0,0,0,=,0,46.333333333333336,50.0,<,-3.6666666666666643,43,40,>,3,52,59,<,-7,262,113,>,149
0,17,0.0,0.0,=,0.0,0,0,=,0,0,0,=,0,50.0,43.333333333333336,>,6.666666666666664,40,36,>,4,59,50,>,9,113,108,>,5
71,17,0.0,0.0,=,0.0,0,0,=,0,0,0,=,0,43.333333333333336,50.0,<,-6.666666666666664,36,40,<,-4,50,59,<,-9,108,113,<,-5
0,17,0.0,0.0,=,0.0,0,0,=,0,0,0,=,0,50.0,56.0,<,-6.0,40,53,<,-13,59,60,<,-1,113,100,>,13
117,17,0.0,0.0,=,0.0,0,0,=,0,0,0,=,0,56.0,50.0,>,6.0,53,40,>,13,60,59,>,1,100,113,<,-13
0,17,0.0,0.0,=,0.0,0,0,=,0,0,0,=,0,50.0,41.666666666666664,>,8.333333333333336,40,39,>,1,59,43,>,16,113,96,>,17
57,17,0.0,0.0,=,0.0,0,0,=,0,0,0,=,0,41.666666666666664,50.0,<,-8.333333333333336,39,40,<,-1,43,59,<,-16,96,113,<,-17
0,17,0.0,0.0,=,0.0,0,0,=,0,0,0,=,0,50.0,38.666666666666664,>,11.333333333333336,40,30,>,10,59,46,>,13,113,149,<,-36
0,17,0.0,0.0,=,0.0,0,0,=,0,0,0,=,0,38.666666666666664,50.0,<,-11.333333333333336,30,40,<,-10,46,59,<,-13,149,113,>,36
0,17,0.0,0.0,=,0.0,0,0,=,0,0,0,=,0,50.0,40.0,>,10.0,40,33,>,7,59,47,>,12,113,102,>,11
20,17,0.0,0.0,=,0.0,0,0,=,0,0,0,=,0,40.0,50.0,<,-10.0,33,40,<,-7,47,59,<,-12,102,113,<,-11
0,17,0.0,0.0,=,0.0,0,0,=,0,0,0,=,0,50.0,48.0,>,2.0,40,38,>,2,59,53,>,6,113,197,<,-84
147,17,0.0,0.0,=,0.0,0,0,=,0,0,0,=,0,48.0,50.0,<,-2.0,38,40,<,-2,53,59,<,-6,197,113,>,84
0,16,14.0,16.333333333333332,<,-2.333333333333332,0,0,=,0,42,49,<,-7,36.333333333333336,38.666666666666664,<,-2.3333333333333286,32,30,>,2,45,46,<,-1,110,149,<,-39
0,16,16.333333333333332,14.0,>,2.333333333333332,0,0,=,0,49,42,>,7,38.666666666666664,36.333333333333336,>,2.3333333333333286,30,32,<,-2,46,45,>,1,149,110,>,39
0,16,14.0,26.666666666666668,<,-12.666666666666668,0,0,=,0,42,80,<,-38,36.333333333333336,49.333333333333336,<,-13.0,32,48,<,-16,45,52,<,-7,110,92,>,18
66,16,26.666666666666668,14.0,>,12.666666666666668,0,0,=,0,80,42,>,38,49.333333333333336,36.333333333333336,>,13.0,48,32,>,16,52,45,>,7,92,110,<,-18
0,16,14.0,8.333333333333334,>,5.666666666666666,0,0,=,0,42,25,>,17,36.333333333333336,40.0,<,-3.6666666666666643,32,33,<,-1,45,47,<,-2,110,102,>,8
0,16,8.333333333333334,14.0,<,-5.666666666666666,0,0,=,0,25,42,<,-17,40.0,36.333333333333336,>,3.6666666666666643,33,32,>,1,47,45,>,2,102,110,<,-8
0,16,14.0,25.333333333333332,<,-11.333333333333332,0,0,=,0,42,76,<,-34,36.333333333333336,41.333333333333336,<,-5.0,32,35,<,-3,45,45,=,0,110,129,<,-19
48,16,25.333333333333332,14.0,>,11.333333333333332,0,0,=,0,76,42,>,34,41.333333333333336,36.333333333333336,>,5.0,35,32,>,3,45,45,=,0,129,110,>,19
0,16,14.0,14.666666666666666,<,-0.6666666666666661,0,0,=,0,42,44,<,-2,36.333333333333336,41.666666666666664,<,-5.333333333333329,32,39,<,-7,45,43,>,2,110,96,>,14
57,16,14.666666666666666,14.0,>,0.6666666666666661,0,0,=,0,44,42,>,2,41.666666666666664,36.333333333333336,>,5.333333333333329,39,32,>,7,43,45,<,-2,96,110,<,-14
0,16,14.0,23.666666666666668,<,-9.666666666666668,0,0,=,0,42,71,<,-29,36.333333333333336,43.333333333333336,<,-7.0,32,36,<,-4,45,50,<,-5,110,108,>,2
112,16,23.666666666666668,14.0,>,9.666666666666668,0,0,=,0,71,42,>,29,43.333333333333336,36.333333333333336,>,7.0,36,32,>,4,50,45,>,5,108,110,<,-2
0,16,14.0,15.333333333333334,<,-1.333333333333334,0,0,=,0,42,46,<,-4,36.333333333333336,52.666666666666664,<,-16.33333333333333,32,51,<,-19,45,56,<,-11,110,153,<,-43
81,16,15.333333333333334,14.0,>,1.333333333333334,0,0,=,0,46,42,>,4,52.666666666666664,36.333333333333336,>,16.33333333333333,51,32,>,19,56,45,>,11,153,110,>,43
0,16,14.0,17.0,<,-3.0,0,0,=,0,42,51,<,-9,36.333333333333336,38.666666666666664,<,-2.3333333333333286,32,35,<,-3,45,41,>,4,110,112,<,-2
129,16,17.0,14.0,>,3.0,0,0,=,0,51,42,>,9,38.666666666666664,36.333333333333336,>,2.3333333333333286,35,32,>,3,41,45,<,-4,112,110,>,2
0,16,14.0,5.666666666666667,>,8.333333333333332,0,0,=,0,42,17,>,25,36.333333333333336,56.0,<,-19.666666666666664,32,53,<,-21,45,60,<,-15,110,100,>,10
73,16,5.666666666666667,14.0,<,-8.333333333333332,0,0,=,0,17,42,<,-25,56.0,36.333333333333336,>,19.666666666666664,53,32,>,21,60,45,>,15,100,110,<,-10
0,16,14.0,16.333333333333332,<,-2.333333333333332,0,0,=,0,42,49,<,-7,36.333333333333336,47.333333333333336,<,-11.0,32,41,<,-9,45,56,<,-11,110,245,<,-135
186,16,16.333333333333332,14.0,>,2.333333333333332,0,0,=,0,49,42,>,7,47.333333333333336,36.333333333333336,>,11.0,41,32,>,9,56,45,>,11,245,110,>,135
0,16,14.0,20.666666666666668,<,-6.666666666666668,0,0,=,0,42,62,<,-20,36.333333333333336,49.333333333333336,<,-13.0,32,44,<,-12,45,57,<,-12,110,182,<,-72
186,16,20.666666666666668,14.0,>,6.666666666666668,0,0,=,0,62,42,>,20,49.333333333333336,36.333333333333336,>,13.0,44,32,>,12,57,45,>,12,182,110,>,72
0,16,14.0,7.0,>,7.0,0,0,=,0,42,21,>,21,36.333333333333336,48.0,<,-11.666666666666664,32,38,<,-6,45,53,<,-8,110,197,<,-87
147,16,7.0,14.0,<,-7.0,0,0,=,0,21,42,<,-21,48.0,36.333333333333336,>,11.666666666666664,38,32,>,6,53,45,>,8,197,110,>,87
0,16,14.0,22.666666666666668,<,-8.666666666666668,0,0,=,0,42,68,<,-26,36.333333333333336,49.333333333333336,<,-13.0,32,39,<,-7,45,59,<,-14,110,244,<,-134
211,16,22.666666666666668,14.0,>,8.666666666666668,0,0,=,0,68,42,>,26,49.333333333333336,36.333333333333336,>,13.0,39,32,>,7,59,45,>,14,244,110,>,134
0,16,14.0,20.666666666666668,<,-6.666666666666668,0,0,=,0,42,62,<,-20,36.333333333333336,48.333333333333336,<,-12.0,32,34,<,-2,45,59,<,-14,110,184,<,-74
179,16,20.666666666666668,14.0,>,6.666666666666668,0,0,=,0,62,42,>,20,48.333333333333336,36.333333333333336,>,12.0,34,32,>,2,59,45,>,14,184,110,>,74
0,16,14.0,7.666666666666667,>,6.333333333333333,0,0,=,0,42,23,>,19,36.333333333333336,46.333333333333336,<,-10.0,32,43,<,-11,45,52,<,-7,110,262,<,-152
200,16,7.666666666666667,14.0,<,-6.333333333333333,0,0,=,0,23,42,<,-19,46.333333333333336,36.333333333333336,>,10.0,43,32,>,11,52,45,>,7,262,110,>,152
0,15,34.666666666666664,37.666666666666664,<,-3.0,0,0,=,0,55,88,<,-33,38.666666666666664,40.0,<,-1.3333333333333357,30,33,<,-3,46,47,<,-1,149,102,>,47
0,15,37.666666666666664,34.666666666666664,>,3.0,0,0,=,0,88,55,>,33,40.0,38.666666666666664,>,1.3333333333333357,33,30,>,3,47,46,>,1,102,149,<,-47
0,15,34.666666666666664,34.333333333333336,>,0.3333333333333286,0,0,=,0,55,76,<,-21,38.666666666666664,41.333333333333336,<,-2.6666666666666714,30,35,<,-5,46,45,>,1,149,129,>,20
48,15,34.333333333333336,34.666666666666664,<,-0.3333333333333286,0,0,=,0,76,55,>,21,41.333333333333336,38.666666666666664,>,2.6666666666666714,35,30,>,5,45,46,<,-1,129,149,<,-20
0,15,34.666666666666664,43.666666666666664,<,-9.0,0,0,=,0,55,87,<,-32,38.666666666666664,41.666666666666664,<,-3.0,30,39,<,-9,46,43,>,3,149,96,>,53
57,15,43.666666666666664,34.666666666666664,>,9.0,0,0,=,0,87,55,>,32,41.666666666666664,38.666666666666664,>,3.0,39,30,>,9,43,46,<,-3,96,149,<,-53
0,15,34.666666666666664,31.333333333333332,>,3.333333333333332,0,0,=,0,55,80,<,-25,38.666666666666664,49.333333333333336,<,-10.666666666666671,30,48,<,-18,46,52,<,-6,149,92,>,57
0,15,31.333333333333332,34.666666666666664,<,-3.333333333333332,0,0,=,0,80,55,>,25,49.333333333333336,38.666666666666664,>,10.666666666666671,48,30,>,18,52,46,>,6,92,149,<,-57
0,15,34.666666666666664,28.0,>,6.666666666666664,0,0,=,0,55,67,<,-12,38.666666666666664,56.0,<,-17.333333333333336,30,53,<,-23,46,60,<,-14,149,100,>,49
73,15,28.0,34.666666666666664,<,-6.666666666666664,0,0,=,0,67,55,>,12,56.0,38.666666666666664,>,17.333333333333336,53,30,>,23,60,46,>,14,100,149,<,-49
0,15,34.666666666666664,22.333333333333332,>,12.333333333333332,0,0,=,0,55,46,>,9,38.666666666666664,52.666666666666664,<,-14.0,30,51,<,-21,46,56,<,-10,149,153,<,-4
81,15,22.333333333333332,34.666666666666664,<,-12.333333333333332,0,0,=,0,46,55,<,-9,52.666666666666664,38.666666666666664,>,14.0,51,30,>,21,56,46,>,10,153,149,>,4
0,15,34.666666666666664,51.666666666666664,<,-17.0,0,0,=,0,55,84,<,-29,38.666666666666664,43.333333333333336,<,-4.666666666666671,30,36,<,-6,46,50,<,-4,149,108,>,41
132,15,51.666666666666664,34.666666666666664,>,17.0,0,0,=,0,84,55,>,29,43.333333333333336,38.666666666666664,>,4.666666666666671,36,30,>,6,50,46,>,4,108,149,<,-41
0,15,34.666666666666664,42.666666666666664,<,-8.0,0,0,=,0,55,77,<,-22,38.666666666666664,38.666666666666664,=,0.0,30,35,<,-5,46,41,>,5,149,112,>,37
165,15,42.666666666666664,34.666666666666664,>,8.0,0,0,=,0,77,55,>,22,38.666666666666664,38.666666666666664,=,0.0,35,30,>,5,41,46,<,-5,112,149,<,-37
0,15,34.666666666666664,32.666666666666664,>,2.0,0,0,=,0,55,77,<,-22,38.666666666666664,48.0,<,-9.333333333333336,30,38,<,-8,46,53,<,-7,149,197,<,-48
147,15,32.666666666666664,34.666666666666664,<,-2.0,0,0,=,0,77,55,>,22,48.0,38.666666666666664,>,9.333333333333336,38,30,>,8,53,46,>,7,197,149,>,48
0,15,34.666666666666664,24.666666666666668,>,9.999999999999996,0,0,=,0,55,62,<,-7,38.666666666666664,48.333333333333336,<,-9.666666666666671,30,34,<,-4,46,59,<,-13,149,184,<,-35
199,15,24.666666666666668,34.666666666666664,<,-9.999999999999996,0,0,=,0,62,55,>,7,48.333333333333336,38.666666666666664,>,9.666666666666671,34,30,>,4,59,46,>,13,184,149,>,35
0,15,34.666666666666664,43.333333333333336,<,-8.666666666666671,0,0,=,0,55,68,<,-13,38.666666666666664,49.333333333333336,<,-10.666666666666671,30,44,<,-14,46,57,<,-11,149,182,<,-33
256,15,43.333333333333336,34.666666666666664,>,8.666666666666671,0,0,=,0,68,55,>,13,49.333333333333336,38.666666666666664,>,10.666666666666671,44,30,>,14,57,46,>,11,182,149,>,33
0,15,34.666666666666664,24.0,>,10.666666666666664,0,0,=,0,55,49,>,6,38.666666666666664,47.333333333333336,<,-8.666666666666671,30,41,<,-11,46,56,<,-10,149,245,<,-96
182,15,24.0,34.666666666666664,<,-10.666666666666664,0,0,=,0,49,55,<,-6,47.333333333333336,38.666666666666664,>,8.666666666666671,41,30,>,11,56,46,>,10,245,149,>,96
0,15,34.666666666666664,21.333333333333332,>,13.333333333333332,0,0,=,0,55,41,>,14,38.666666666666664,46.333333333333336,<,-7.666666666666671,30,43,<,-13,46,52,<,-6,149,262,<,-113
192,15,21.333333333333332,34.666666666666664,<,-13.333333333333332,0,0,=,0,41,55,<,-14,46.333333333333336,38.666666666666664,>,7.666666666666671,43,30,>,13,52,46,>,6,262,149,>,113
0,15,34.666666666666664,47.333333333333336,<,-12.666666666666671,0,0,=,0,55,74,<,-19,38.666666666666664,49.333333333333336,<,-10.666666666666671,30,39,<,-9,46,59,<,-13,149,244,<,-95
275,15,47.333333333333336,34.666666666666664,>,12.666666666666671,0,0,=,0,74,55,>,19,49.333333333333336,38.666666666666664,>,10.666666666666671,39,30,>,9,59,46,>,13,244,149,>,95
0,14,49.666666666666664,44.666666666666664,>,5.0,14,21,<,-7,80,88,<,-8,49.333333333333336,40.0,>,9.333333333333336,48,33,>,15,52,47,>,5,92,102,<,-10
0,14,44.666666666666664,49.666666666666664,<,-5.0,21,14,>,7,88,80,>,8,40.0,49.333333333333336,<,-9.333333333333336,33,48,<,-15,47,52,<,-5,102,92,>,10
0,14,49.666666666666664,38.666666666666664,>,11.0,14,13,>,1,80,76,>,4,49.333333333333336,41.333333333333336,>,8.0,48,35,>,13,52,45,>,7,92,129,<,-37
52,14,38.666666666666664,49.666666666666664,<,-11.0,13,14,<,-1,76,80,<,-4,41.333333333333336,49.333333333333336,<,-8.0,35,48,<,-13,45,52,<,-7,129,92,>,37
0,14,49.666666666666664,48.0,>,1.6666666666666643,14,13,>,1,80,87,<,-7,49.333333333333336,41.666666666666664,>,7.666666666666671,48,39,>,9,52,43,>,9,92,96,<,-4
0,14,48.0,49.666666666666664,<,-1.6666666666666643,13,14,<,-1,87,80,>,7,41.666666666666664,49.333333333333336,<,-7.666666666666671,39,48,<,-9,43,52,<,-9,96,92,>,4
0,14,49.666666666666664,41.333333333333336,>,8.333333333333329,14,17,<,-3,80,67,>,13,49.333333333333336,56.0,<,-6.666666666666664,48,53,<,-5,52,60,<,-8,92,100,<,-8
103,14,41.333333333333336,49.666666666666664,<,-8.333333333333329,17,14,>,3,67,80,<,-13,56.0,49.333333333333336,>,6.666666666666664,53,48,>,5,60,52,>,8,100,92,>,8
0,14,49.666666666666664,34.666666666666664,>,15.0,14,21,<,-7,80,46,>,34,49.333333333333336,52.666666666666664,<,-3.3333333333333286,48,51,<,-3,52,56,<,-4,92,153,<,-61
166,14,34.666666666666664,49.666666666666664,<,-15.0,21,14,>,7,46,80,<,-34,52.666666666666664,49.333333333333336,>,3.3333333333333286,51,48,>,3,56,52,>,4,153,92,>,61
0,14,49.666666666666664,81.33333333333333,<,-31.666666666666664,14,71,<,-57,80,89,<,-9,49.333333333333336,43.333333333333336,>,6.0,48,36,>,12,52,50,>,2,92,108,<,-16
348,14,81.33333333333333,49.666666666666664,>,31.666666666666664,71,14,>,57,89,80,>,9,43.333333333333336,49.333333333333336,<,-6.0,36,48,<,-12,50,52,<,-2,108,92,>,16
0,14,49.666666666666664,41.333333333333336,>,8.333333333333329,14,21,<,-7,80,77,>,3,49.333333333333336,48.0,>,1.3333333333333357,48,38,>,10,52,53,<,-1,92,197,<,-105
172,14,41.333333333333336,49.666666666666664,<,-8.333333333333329,21,14,>,7,77,80,<,-3,48.0,49.333333333333336,<,-1.3333333333333357,38,48,<,-10,53,52,>,1,197,92,>,105
0,14,49.666666666666664,71.0,<,-21.333333333333336,14,51,<,-37,80,85,<,-5,49.333333333333336,38.666666666666664,>,10.666666666666671,48,35,>,13,52,41,>,11,92,112,<,-20
231,14,71.0,49.666666666666664,>,21.333333333333336,51,14,>,37,85,80,>,5,38.666666666666664,49.333333333333336,<,-10.666666666666671,35,48,<,-13,41,52,<,-11,112,92,>,20
0,14,49.666666666666664,47.666666666666664,>,2.0,14,23,<,-9,80,71,>,9,49.333333333333336,47.333333333333336,>,2.0,48,41,>,7,52,56,<,-4,92,245,<,-153
182,14,47.666666666666664,49.666666666666664,<,-2.0,23,14,>,9,71,80,<,-9,47.333333333333336,49.333333333333336,<,-2.0,41,48,<,-7,56,52,>,4,245,92,>,153
0,14,49.666666666666664,49.666666666666664,=,0.0,14,23,<,-9,80,85,<,-5,49.333333333333336,46.333333333333336,>,3.0,48,43,>,5,52,52,=,0,92,262,<,-170
192,14,49.666666666666664,49.666666666666664,=,0.0,23,14,>,9,85,80,>,5,46.333333333333336,49.333333333333336,<,-3.0,43,48,<,-5,52,52,=,0,262,92,>,170
0,14,49.666666666666664,34.0,>,15.666666666666664,14,12,>,2,80,62,>,18,49.333333333333336,48.333333333333336,>,1.0,48,34,>,14,52,59,<,-7,92,184,<,-92
222,14,34.0,49.666666666666664,<,-15.666666666666664,12,14,<,-2,62,80,<,-18,48.333333333333336,49.333333333333336,<,-1.0,34,48,<,-14,59,52,>,7,184,92,>,92
0,14,49.666666666666664,48.0,>,1.6666666666666643,14,14,=,0,80,68,>,12,49.333333333333336,49.333333333333336,=,0.0,48,44,>,4,52,57,<,-5,92,182,<,-90
210,14,48.0,49.666666666666664,<,-1.6666666666666643,14,14,=,0,68,80,<,-12,49.333333333333336,49.333333333333336,=,0.0,44,48,<,-4,57,52,>,5,182,92,>,90
0,14,49.666666666666664,77.0,<,-27.333333333333336,14,68,<,-54,80,89,<,-9,49.333333333333336,49.333333333333336,=,0.0,48,39,>,9,52,59,<,-7,92,244,<,-152
294,14,77.0,49.666666666666664,>,27.333333333333336,68,14,>,54,89,80,>,9,49.333333333333336,49.333333333333336,=,0.0,39,48,<,-9,59,52,>,7,244,92,>,152
0,13,35.666666666666664,29.666666666666668,>,5.9999999999999964,13,21,<,-8,50,43,>,7,41.666666666666664,40.0,>,1.6666666666666643,39,33,>,6,43,47,<,-4,96,102,<,-6
0,13,29.666666666666668,35.666666666666664,<,-5.9999999999999964,21,13,>,8,43,50,<,-7,40.0,41.666666666666664,<,-1.6666666666666643,33,39,<,-6,47,43,>,4,102,96,>,6
0,13,35.666666666666664,56.333333333333336,<,-20.66666666666667,13,13,=,0,50,80,<,-30,41.666666666666664,41.333333333333336,>,0.3333333333333286,39,35,>,4,43,45,<,-2,96,129,<,-33
52,13,56.333333333333336,35.666666666666664,>,20.66666666666667,13,13,=,0,80,50,>,30,41.333333333333336,41.666666666666664,<,-0.3333333333333286,35,39,<,-4,45,43,>,2,129,96,>,33
0,13,35.666666666666664,23.333333333333332,>,12.333333333333332,13,13,=,0,50,40,>,10,41.666666666666664,56.0,<,-14.333333333333336,39,53,<,-14,43,60,<,-17,96,100,<,-4
103,13,23.333333333333332,35.666666666666664,<,-12.333333333333332,13,13,=,0,40,50,<,-10,56.0,41.666666666666664,>,14.333333333333336,53,39,>,14,60,43,>,17,100,96,>,4
0,13,35.666666666666664,49.333333333333336,<,-13.666666666666671,13,37,<,-24,50,65,<,-15,41.666666666666664,52.666666666666664,<,-11.0,39,51,<,-12,43,56,<,-13,96,153,<,-57
166,13,49.333333333333336,35.666666666666664,>,13.666666666666671,37,13,>,24,65,50,>,15,52.666666666666664,41.666666666666664,>,11.0,51,39,>,12,56,43,>,13,153,96,>,57
0,13,35.666666666666664,21.666666666666668,>,13.999999999999996,13,18,<,-5,50,26,>,24,41.666666666666664,48.0,<,-6.333333333333336,39,38,>,1,43,53,<,-10,96,197,<,-101
130,13,21.666666666666668,35.666666666666664,<,-13.999999999999996,18,13,>,5,26,50,<,-24,48.0,41.666666666666664,>,6.333333333333336,38,39,<,-1,53,43,>,10,197,96,>,101
0,13,35.666666666666664,49.0,<,-13.333333333333336,13,27,<,-14,50,71,<,-21,41.666666666666664,47.333333333333336,<,-5.666666666666671,39,41,<,-2,43,56,<,-13,96,245,<,-149
107,13,49.0,35.666666666666664,>,13.333333333333336,27,13,>,14,71,50,>,21,47.333333333333336,41.666666666666664,>,5.666666666666671,41,39,>,2,56,43,>,13,245,96,>,149
0,13,35.666666666666664,61.666666666666664,<,-26.0,13,23,<,-10,50,85,<,-35,41.666666666666664,46.333333333333336,<,-4.666666666666671,39,43,<,-4,43,52,<,-9,96,262,<,-166
192,13,61.666666666666664,35.666666666666664,>,26.0,23,13,>,10,85,50,>,35,46.333333333333336,41.666666666666664,>,4.666666666666671,43,39,>,4,52,43,>,9,262,96,>,166
0,13,35.666666666666664,46.333333333333336,<,-10.666666666666671,13,14,<,-1,50,63,<,-13,41.666666666666664,49.333333333333336,<,-7.666666666666671,39,44,<,-5,43,57,<,-14,96,182,<,-86
175,13,46.333333333333336,35.666666666666664,>,10.666666666666671,14,13,>,1,63,50,>,13,49.333333333333336,41.666666666666664,>,7.666666666666671,44,39,>,5,57,43,>,14,182,96,>,86
0,13,35.666666666666664,36.666666666666664,<,-1.0,13,20,<,-7,50,62,<,-12,41.666666666666664,48.333333333333336,<,-6.666666666666671,39,34,>,5,43,59,<,-16,96,184,<,-88
125,13,36.666666666666664,35.666666666666664,>,1.0,20,13,>,7,62,50,>,12,48.333333333333336,41.666666666666664,>,6.666666666666671,34,39,<,-5,59,43,>,16,184,96,>,88
0,13,35.666666666666664,49.333333333333336,<,-13.666666666666671,13,12,>,1,50,85,<,-35,41.666666666666664,38.666666666666664,>,3.0,39,35,>,4,43,41,>,2,96,112,<,-16
0,13,49.333333333333336,35.666666666666664,>,13.666666666666671,12,13,<,-1,85,50,>,35,38.666666666666664,41.666666666666664,<,-3.0,35,39,<,-4,41,43,<,-2,112,96,>,16
0,13,35.666666666666664,59.0,<,-23.333333333333336,13,20,<,-7,50,89,<,-39,41.666666666666664,49.333333333333336,<,-7.666666666666671,39,39,=,0,43,59,<,-16,96,244,<,-148
130,13,59.0,35.666666666666664,>,23.333333333333336,20,13,>,7,89,50,>,39,49.333333333333336,41.666666666666664,>,7.666666666666671,39,39,=,0,59,43,>,16,244,96,>,148
0,13,35.666666666666664,76.0,<,-40.333333333333336,13,68,<,-55,50,89,<,-39,41.666666666666664,43.333333333333336,<,-1.6666666666666714,39,36,>,3,43,50,<,-7,96,108,<,-12
275,13,76.0,35.666666666666664,>,40.333333333333336,68,13,>,55,89,50,>,39,43.333333333333336,41.666666666666664,>,1.6666666666666714,36,39,<,-3,50,43,>,7,108,96,>,12
0,12,39.333333333333336,37.0,>,2.3333333333333357,12,25,<,-13,55,43,>,12,38.666666666666664,40.0,<,-1.3333333333333357,35,33,>,2,41,47,<,-6,112,102,>,10
0,12,37.0,39.333333333333336,<,-2.3333333333333357,25,12,>,13,43,55,<,-12,40.0,38.666666666666664,>,1.3333333333333357,33,35,<,-2,47,41,>,6,102,112,<,-10
0,12,39.333333333333336,56.666666666666664,<,-17.33333333333333,12,14,<,-2,55,80,<,-25,38.666666666666664,41.333333333333336,<,-2.6666666666666714,35,35,=,0,41,45,<,-4,112,129,<,-17
102,12,56.666666666666664,39.333333333333336,>,17.33333333333333,14,12,>,2,80,55,>,25,41.333333333333336,38.666666666666664,>,2.6666666666666714,35,35,=,0,45,41,>,4,129,112,>,17
0,12,39.333333333333336,34.333333333333336,>,5.0,12,13,<,-1,55,73,<,-18,38.666666666666664,56.0,<,-17.333333333333336,35,53,<,-18,41,60,<,-19,112,100,>,12
103,12,34.333333333333336,39.333333333333336,<,-5.0,13,12,>,1,73,55,>,18,56.0,38.666666666666664,>,17.333333333333336,53,35,>,18,60,41,>,19,100,112,<,-12
0,12,39.333333333333336,29.0,>,10.333333333333336,12,11,>,1,55,49,>,6,38.666666666666664,47.333333333333336,<,-8.666666666666671,35,41,<,-6,41,56,<,-15,112,245,<,-133
107,12,29.0,39.333333333333336,<,-10.333333333333336,11,12,<,-1,49,55,<,-6,47.333333333333336,38.666666666666664,>,8.666666666666671,41,35,>,6,56,41,>,15,245,112,>,133
0,12,39.333333333333336,53.666666666666664,<,-14.333333333333329,12,20,<,-8,55,79,<,-24,38.666666666666664,48.333333333333336,<,-9.666666666666671,35,34,>,1,41,59,<,-18,112,184,<,-72
145,12,53.666666666666664,39.333333333333336,>,14.333333333333329,20,12,>,8,79,55,>,24,48.333333333333336,38.666666666666664,>,9.666666666666671,34,35,<,-1,59,41,>,18,184,112,>,72
0,12,39.333333333333336,51.666666666666664,<,-12.333333333333329,12,20,<,-8,55,68,<,-13,38.666666666666664,49.333333333333336,<,-10.666666666666671,35,39,<,-4,41,59,<,-18,112,244,<,-132
130,12,51.666666666666664,39.333333333333336,>,12.333333333333329,20,12,>,8,68,55,>,13,49.333333333333336,38.666666666666664,>,10.666666666666671,39,35,>,4,59,41,>,18,244,112,>,132
0,12,39.333333333333336,43.0,<,-3.6666666666666643,12,18,<,-6,55,90,<,-35,38.666666666666664,48.0,<,-9.333333333333336,35,38,<,-3,41,53,<,-12,112,197,<,-85
146,12,43.0,39.333333333333336,>,3.6666666666666643,18,12,>,6,90,55,>,35,48.0,38.666666666666664,>,9.333333333333336,38,35,>,3,53,41,>,12,197,112,>,85
0,12,39.333333333333336,52.333333333333336,<,-13.0,12,46,<,-34,55,65,<,-10,38.666666666666664,52.666666666666664,<,-14.0,35,51,<,-16,41,56,<,-15,112,153,<,-41
173,12,52.333333333333336,39.333333333333336,>,13.0,46,12,>,34,65,55,>,10,52.666666666666664,38.666666666666664,>,14.0,51,35,>,16,56,41,>,15,153,112,>,41
0,12,39.333333333333336,69.33333333333333,<,-29.999999999999993,12,62,<,-50,55,83,<,-28,38.666666666666664,49.333333333333336,<,-10.666666666666671,35,44,<,-9,41,57,<,-16,112,182,<,-70
175,12,69.33333333333333,39.333333333333336,>,29.999999999999993,62,12,>,50,83,55,>,28,49.333333333333336,38.666666666666664,>,10.666666666666671,44,35,>,9,57,41,>,16,182,112,>,70
0,12,39.333333333333336,59.666666666666664,<,-20.33333333333333,12,23,<,-11,55,79,<,-24,38.666666666666664,46.333333333333336,<,-7.666666666666671,35,43,<,-8,41,52,<,-11,112,262,<,-150
192,12,59.666666666666664,39.333333333333336,>,20.33333333333333,23,12,>,11,79,55,>,24,46.333333333333336,38.666666666666664,>,7.666666666666671,43,35,>,8,52,41,>,11,262,112,>,150
0,12,39.333333333333336,49.666666666666664,<,-10.333333333333329,12,10,>,2,55,71,<,-16,38.666666666666664,43.333333333333336,<,-4.666666666666671,35,36,<,-1,41,50,<,-9,112,108,>,4
0,12,49.666666666666664,39.333333333333336,>,10.333333333333329,10,12,<,-2,71,55,>,16,43.333333333333336,38.666666666666664,>,4.666666666666671,36,35,>,1,50,41,>,9,108,112,<,-4
0,11,30.666666666666668,34.333333333333336,<,-3.666666666666668,10,25,<,-15,71,43,>,28,43.333333333333336,40.0,>,3.3333333333333357,36,33,>,3,50,47,>,3,108,102,>,6
0,11,34.333333333333336,30.666666666666668,>,3.666666666666668,25,10,>,15,43,71,<,-28,40.0,43.333333333333336,<,-3.3333333333333357,33,36,<,-3,47,50,<,-3,102,108,<,-6
0,11,30.666666666666668,37.0,<,-6.333333333333332,10,14,<,-4,71,76,<,-5,43.333333333333336,41.333333333333336,>,2.0,36,35,>,1,50,45,>,5,108,129,<,-21
0,11,37.0,30.666666666666668,>,6.333333333333332,14,10,>,4,76,71,>,5,41.333333333333336,43.333333333333336,<,-2.0,35,36,<,-1,45,50,<,-5,129,108,>,21
0,11,30.666666666666668,34.333333333333336,<,-3.666666666666668,10,13,<,-3,71,73,<,-2,43.333333333333336,56.0,<,-12.666666666666664,36,53,<,-17,50,60,<,-10,108,100,>,8
103,11,34.333333333333336,30.666666666666668,>,3.666666666666668,13,10,>,3,73,71,>,2,56.0,43.333333333333336,>,12.666666666666664,53,36,>,17,60,50,>,10,100,108,<,-8
0,11,30.666666666666668,50.0,<,-19.333333333333332,10,11,<,-1,71,90,<,-19,43.333333333333336,47.333333333333336,<,-4.0,36,41,<,-5,50,56,<,-6,108,245,<,-137
223,11,50.0,30.666666666666668,>,19.333333333333332,11,10,>,1,90,71,>,19,47.333333333333336,43.333333333333336,>,4.0,41,36,>,5,56,50,>,6,245,108,>,137
0,11,30.666666666666668,48.666666666666664,<,-17.999999999999996,10,11,<,-1,71,68,>,3,43.333333333333336,49.333333333333336,<,-6.0,36,39,<,-3,50,59,<,-9,108,244,<,-136
49,11,48.666666666666664,30.666666666666668,>,17.999999999999996,11,10,>,1,68,71,<,-3,49.333333333333336,43.333333333333336,>,6.0,39,36,>,3,59,50,>,9,244,108,>,136
0,11,30.666666666666668,76.0,<,-45.33333333333333,10,62,<,-52,71,87,<,-16,43.333333333333336,48.333333333333336,<,-5.0,36,34,>,2,50,59,<,-9,108,184,<,-76
298,11,76.0,30.666666666666668,>,45.33333333333333,62,10,>,52,87,71,>,16,48.333333333333336,43.333333333333336,>,5.0,34,36,<,-2,59,50,>,9,184,108,>,76
0,11,30.666666666666668,59.666666666666664,<,-28.999999999999996,10,21,<,-11,71,90,<,-19,43.333333333333336,48.0,<,-4.666666666666664,36,38,<,-2,50,53,<,-3,108,197,<,-89
243,11,59.666666666666664,30.666666666666668,>,28.999999999999996,21,10,>,11,90,71,>,19,48.0,43.333333333333336,>,4.666666666666664,38,36,>,2,53,50,>,3,197,108,>,89
0,11,30.666666666666668,37.333333333333336,<,-6.666666666666668,10,20,<,-10,71,46,>,25,43.333333333333336,52.666666666666664,<,-9.333333333333329,36,51,<,-15,50,56,<,-6,108,153,<,-45
75,11,37.333333333333336,30.666666666666668,>,6.666666666666668,20,10,>,10,46,71,<,-25,52.666666666666664,43.333333333333336,>,9.333333333333329,51,36,>,15,56,50,>,6,153,108,>,45
0,11,30.666666666666668,52.666666666666664,<,-21.999999999999996,10,13,<,-3,71,83,<,-12,43.333333333333336,49.333333333333336,<,-6.0,36,44,<,-8,50,57,<,-7,108,182,<,-74
84,11,52.666666666666664,30.666666666666668,>,21.999999999999996,13,10,>,3,83,71,>,12,49.333333333333336,43.333333333333336,>,6.0,44,36,>,8,57,50,>,7,182,108,>,74
0,11,30.666666666666668,44.0,<,-13.333333333333332,10,23,<,-13,71,79,<,-8,43.333333333333336,46.333333333333336,<,-3.0,36,43,<,-7,50,52,<,-2,108,262,<,-154
135,11,44.0,30.666666666666668,>,13.333333333333332,23,10,>,13,79,71,>,8,46.333333333333336,43.333333333333336,>,3.0,43,36,>,7,52,50,>,2,262,108,>,154
0,10,49.333333333333336,47.666666666666664,>,1.6666666666666714,21,25,<,-4,76,83,<,-7,41.333333333333336,40.0,>,1.3333333333333357,35,33,>,2,45,47,<,-2,129,102,>,27
0,10,47.666666666666664,49.333333333333336,<,-1.6666666666666714,25,21,>,4,83,76,>,7,40.0,41.333333333333336,<,-1.3333333333333357,33,35,<,-2,47,45,>,2,102,129,<,-27
0,10,49.333333333333336,45.333333333333336,>,4.0,21,11,>,10,76,68,>,8,41.333333333333336,49.333333333333336,<,-8.0,35,39,<,-4,45,59,<,-14,129,244,<,-115
49,10,45.333333333333336,49.333333333333336,<,-4.0,11,21,<,-10,68,76,<,-8,49.333333333333336,41.333333333333336,>,8.0,39,35,>,4,59,45,>,14,244,129,>,115
0,10,49.333333333333336,35.0,>,14.333333333333336,21,20,>,1,76,46,>,30,41.333333333333336,52.666666666666664,<,-11.333333333333329,35,51,<,-16,45,56,<,-11,129,153,<,-24
75,10,35.0,49.333333333333336,<,-14.333333333333336,20,21,<,-1,46,76,<,-30,52.666666666666664,41.333333333333336,>,11.333333333333329,51,35,>,16,56,45,>,11,153,129,>,24
0,10,49.333333333333336,34.666666666666664,>,14.666666666666671,21,13,>,8,76,62,>,14,41.333333333333336,49.333333333333336,<,-8.0,35,44,<,-9,45,57,<,-12,129,182,<,-53
80,10,34.666666666666664,49.333333333333336,<,-14.666666666666671,13,21,<,-8,62,76,<,-14,49.333333333333336,41.333333333333336,>,8.0,44,35,>,9,57,45,>,12,182,129,>,53
0,10,49.333333333333336,31.333333333333332,>,18.000000000000004,21,13,>,8,76,64,>,12,41.333333333333336,56.0,<,-14.666666666666664,35,53,<,-18,45,60,<,-15,129,100,>,29
103,10,31.333333333333332,49.333333333333336,<,-18.000000000000004,13,21,<,-8,64,76,<,-12,56.0,41.333333333333336,>,14.666666666666664,53,35,>,18,60,45,>,15,100,129,<,-29
0,10,49.333333333333336,33.0,>,16.333333333333336,21,23,<,-2,76,46,>,30,41.333333333333336,46.333333333333336,<,-5.0,35,43,<,-8,45,52,<,-7,129,262,<,-133
135,10,33.0,49.333333333333336,<,-16.333333333333336,23,21,>,2,46,76,<,-30,46.333333333333336,41.333333333333336,>,5.0,43,35,>,8,52,45,>,7,262,129,>,133
0,10,49.333333333333336,72.0,<,-22.666666666666664,21,49,<,-28,76,90,<,-14,41.333333333333336,47.333333333333336,<,-6.0,35,41,<,-6,45,56,<,-11,129,245,<,-116
223,10,72.0,49.333333333333336,>,22.666666666666664,49,21,>,28,90,76,>,14,47.333333333333336,41.333333333333336,>,6.0,41,35,>,6,56,45,>,11,245,129,>,116
0,10,49.333333333333336,33.0,>,16.333333333333336,21,10,>,11,76,68,>,8,41.333333333333336,48.0,<,-6.666666666666664,35,38,<,-3,45,53,<,-8,129,197,<,-68
0,10,33.0,49.333333333333336,<,-16.333333333333336,10,21,<,-11,68,76,<,-8,48.0,41.333333333333336,>,6.666666666666664,38,35,>,3,53,45,>,8,197,129,>,68
0,10,49.333333333333336,54.666666666666664,<,-5.333333333333329,21,15,>,6,76,87,<,-11,41.333333333333336,48.333333333333336,<,-7.0,35,34,>,1,45,59,<,-14,129,184,<,-55
22,10,54.666666666666664,49.333333333333336,>,5.333333333333329,15,21,<,-6,87,76,>,11,48.333333333333336,41.333333333333336,>,7.0,34,35,<,-1,59,45,>,14,184,129,>,55
0,9,43.666666666666664,32.666666666666664,>,11.0,23,10,>,13,83,67,>,16,40.0,48.0,<,-8.0,33,38,<,-5,47,53,<,-6,102,197,<,-95
0,9,32.666666666666664,43.666666666666664,<,-11.0,10,23,<,-13,67,83,<,-16,48.0,40.0,>,8.0,38,33,>,5,53,47,>,6,197,102,>,95
0,9,43.666666666666664,54.666666666666664,<,-11.0,23,15,>,8,83,87,<,-4,40.0,48.333333333333336,<,-8.333333333333336,33,34,<,-1,47,59,<,-12,102,184,<,-82
22,9,54.666666666666664,43.666666666666664,>,11.0,15,23,<,-8,87,83,>,4,48.333333333333336,40.0,>,8.333333333333336,34,33,>,1,59,47,>,12,184,102,>,82
0,9,43.666666666666664,45.0,<,-1.3333333333333357,23,10,>,13,83,68,>,15,40.0,49.333333333333336,<,-9.333333333333336,33,39,<,-6,47,59,<,-12,102,244,<,-142
0,9,45.0,43.666666666666664,>,1.3333333333333357,10,23,<,-13,68,83,<,-15,49.333333333333336,40.0,>,9.333333333333336,39,33,>,6,59,47,>,12,244,102,>,142
0,9,43.666666666666664,50.0,<,-6.333333333333336,23,39,<,-16,83,65,>,18,40.0,52.666666666666664,<,-12.666666666666664,33,51,<,-18,47,56,<,-9,102,153,<,-51
115,9,50.0,43.666666666666664,>,6.333333333333336,39,23,>,16,65,83,<,-18,52.666666666666664,40.0,>,12.666666666666664,51,33,>,18,56,47,>,9,153,102,>,51
0,9,43.666666666666664,43.0,>,0.6666666666666643,23,29,<,-6,83,62,>,21,40.0,49.333333333333336,<,-9.333333333333336,33,44,<,-11,47,57,<,-10,102,182,<,-80
80,9,43.0,43.666666666666664,<,-0.6666666666666643,29,23,>,6,62,83,<,-21,49.333333333333336,40.0,>,9.333333333333336,44,33,>,11,57,47,>,10,182,102,>,80
0,9,43.666666666666664,53.666666666666664,<,-10.0,23,17,>,6,83,80,>,3,40.0,56.0,<,-16.0,33,53,<,-20,47,60,<,-13,102,100,>,2
107,9,53.666666666666664,43.666666666666664,>,10.0,17,23,<,-6,80,83,<,-3,56.0,40.0,>,16.0,53,33,>,20,60,47,>,13,100,102,<,-2
0,9,43.666666666666664,41.666666666666664,>,2.0,23,23,=,0,83,56,>,27,40.0,46.333333333333336,<,-6.333333333333336,33,43,<,-10,47,52,<,-5,102,262,<,-160
140,9,41.666666666666664,43.666666666666664,<,-2.0,23,23,=,0,56,83,<,-27,46.333333333333336,40.0,>,6.333333333333336,43,33,>,10,52,47,>,5,262,102,>,160
0,9,43.666666666666664,66.0,<,-22.333333333333336,23,49,<,-26,83,77,>,6,40.0,47.333333333333336,<,-7.333333333333336,33,41,<,-8,47,56,<,-9,102,245,<,-143
109,9,66.0,43.666666666666664,>,22.333333333333336,49,23,>,26,77,83,<,-6,47.333333333333336,40.0,>,7.333333333333336,41,33,>,8,56,47,>,9,245,102,>,143
0,8,49.333333333333336,43.333333333333336,>,6.0,10,10,=,0,81,67,>,14,49.333333333333336,48.0,>,1.3333333333333357,39,38,>,1,59,53,>,6,244,197,>,47
0,8,43.333333333333336,49.333333333333336,<,-6.0,10,10,=,0,67,81,<,-14,48.0,49.333333333333336,<,-1.3333333333333357,38,39,<,-1,53,59,<,-6,197,244,<,-47
0,8,49.333333333333336,40.666666666666664,>,8.666666666666671,10,15,<,-5,81,87,<,-6,49.333333333333336,48.333333333333336,>,1.0,39,34,>,5,59,59,=,0,244,184,>,60
22,8,40.666666666666664,49.333333333333336,<,-8.666666666666671,15,10,>,5,87,81,>,6,48.333333333333336,49.333333333333336,<,-1.0,34,39,<,-5,59,59,=,0,184,244,<,-60
0,8,49.333333333333336,43.0,>,6.333333333333336,10,29,<,-19,81,62,>,19,49.333333333333336,49.333333333333336,=,0.0,39,44,<,-5,59,57,>,2,244,182,>,62
80,8,43.0,49.333333333333336,<,-6.333333333333336,29,10,>,19,62,81,<,-19,49.333333333333336,49.333333333333336,=,0.0,44,39,>,5,57,59,<,-2,182,244,<,-62
0,8,49.333333333333336,51.333333333333336,<,-2.0,10,10,=,0,81,80,>,1,49.333333333333336,56.0,<,-6.666666666666664,39,53,<,-14,59,60,<,-1,244,100,>,144
0,8,51.333333333333336,49.333333333333336,>,2.0,10,10,=,0,80,81,<,-1,56.0,49.333333333333336,>,6.666666666666664,53,39,>,14,60,59,>,1,100,244,<,-144
0,8,49.333333333333336,64.0,<,-14.666666666666664,10,43,<,-33,81,77,>,4,49.333333333333336,47.333333333333336,>,2.0,39,41,<,-2,59,56,>,3,244,245,<,-1
109,8,64.0,49.333333333333336,>,14.666666666666664,43,10,>,33,77,81,<,-4,47.333333333333336,49.333333333333336,<,-2.0,41,39,>,2,56,59,<,-3,245,244,>,1
0,8,49.333333333333336,55.0,<,-5.666666666666664,10,39,<,-29,81,65,>,16,49.333333333333336,52.666666666666664,<,-3.3333333333333286,39,51,<,-12,59,56,>,3,244,153,>,91
115,8,55.0,49.333333333333336,>,5.666666666666664,39,10,>,29,65,81,<,-16,52.666666666666664,49.333333333333336,>,3.3333333333333286,51,39,>,12,56,59,<,-3,153,244,<,-91
0,8,49.333333333333336,59.333333333333336,<,-10.0,10,46,<,-36,81,76,>,5,49.333333333333336,46.333333333333336,>,3.0,39,43,<,-4,59,52,>,7,244,262,<,-18
140,8,59.333333333333336,49.333333333333336,>,10.0,46,10,>,36,76,81,<,-5,46.333333333333336,49.333333333333336,<,-3.0,43,39,>,4,52,59,<,-7,262,244,>,18
0,7,28.666666666666668,26.666666666666668,>,2.0,10,10,=,0,64,53,>,11,56.0,48.0,>,8.0,53,38,>,15,60,53,>,7,100,197,<,-97
0,7,26.666666666666668,28.666666666666668,<,-2.0,10,10,=,0,53,64,<,-11,48.0,56.0,<,-8.0,38,53,<,-15,53,60,<,-7,197,100,>,97
0,7,28.666666666666668,28.666666666666668,=,0.0,10,15,<,-5,64,51,>,13,56.0,48.333333333333336,>,7.666666666666664,53,34,>,19,60,59,>,1,100,184,<,-84
22,7,28.666666666666668,28.666666666666668,=,0.0,15,10,>,5,51,64,<,-13,48.333333333333336,56.0,<,-7.666666666666664,34,53,<,-19,59,60,<,-1,184,100,>,84
0,7,28.666666666666668,38.0,<,-9.333333333333332,10,23,<,-13,64,62,>,2,56.0,49.333333333333336,>,6.666666666666664,53,44,>,9,60,57,>,3,100,182,<,-82
48,7,38.0,28.666666666666668,>,9.333333333333332,23,10,>,13,62,64,<,-2,49.333333333333336,56.0,<,-6.666666666666664,44,53,<,-9,57,60,<,-3,182,100,>,82
0,7,28.666666666666668,45.0,<,-16.333333333333332,10,15,<,-5,64,77,<,-13,56.0,47.333333333333336,>,8.666666666666664,53,41,>,12,60,56,>,4,100,245,<,-145
0,7,45.0,28.666666666666668,>,16.333333333333332,15,10,>,5,77,64,>,13,47.333333333333336,56.0,<,-8.666666666666664,41,53,<,-12,56,60,<,-4,245,100,>,145
0,7,28.666666666666668,60.333333333333336,<,-31.666666666666668,10,39,<,-29,64,81,<,-17,56.0,52.666666666666664,>,3.3333333333333357,53,51,>,2,60,56,>,4,100,153,<,-53
79,7,60.333333333333336,28.666666666666668,>,31.666666666666668,39,10,>,29,81,64,>,17,52.666666666666664,56.0,<,-3.3333333333333357,51,53,<,-2,56,60,<,-4,153,100,>,53
0,7,28.666666666666668,69.0,<,-40.33333333333333,10,46,<,-36,64,85,<,-21,56.0,46.333333333333336,>,9.666666666666664,53,43,>,10,60,52,>,8,100,262,<,-162
96,7,69.0,28.666666666666668,>,40.33333333333333,46,10,>,36,85,64,>,21,46.333333333333336,56.0,<,-9.666666666666664,43,53,<,-10,52,60,<,-8,262,100,>,162
0,6,46.333333333333336,29.666666666666668,>,16.666666666666668,15,10,>,5,77,62,>,15,47.333333333333336,48.0,<,-0.6666666666666643,41,38,>,3,56,53,>,3,245,197,>,48
0,6,29.666666666666668,46.333333333333336,<,-16.666666666666668,10,15,<,-5,62,77,<,-15,48.0,47.333333333333336,>,0.6666666666666643,38,41,<,-3,53,56,<,-3,197,245,<,-48
0,6,46.333333333333336,27.0,>,19.333333333333336,15,15,=,0,77,51,>,26,47.333333333333336,48.333333333333336,<,-1.0,41,34,>,7,56,59,<,-3,245,184,>,61
22,6,27.0,46.333333333333336,<,-19.333333333333336,15,15,=,0,51,77,<,-26,48.333333333333336,47.333333333333336,>,1.0,34,41,<,-7,59,56,>,3,184,245,<,-61
0,6,46.333333333333336,20.666666666666668,>,25.666666666666668,15,10,>,5,77,29,>,48,47.333333333333336,49.333333333333336,<,-2.0,41,44,<,-3,56,57,<,-1,245,182,>,63
0,6,20.666666666666668,46.333333333333336,<,-25.666666666666668,10,15,<,-5,29,77,<,-48,49.333333333333336,47.333333333333336,>,2.0,44,41,>,3,57,56,>,1,182,245,<,-63
0,6,46.333333333333336,48.0,<,-1.6666666666666643,15,24,<,-9,77,81,<,-4,47.333333333333336,52.666666666666664,<,-5.333333333333329,41,51,<,-10,56,56,=,0,245,153,>,92
34,6,48.0,46.333333333333336,>,1.6666666666666643,24,15,>,9,81,77,>,4,52.666666666666664,47.333333333333336,>,5.333333333333329,51,41,>,10,56,56,=,0,153,245,<,-92
0,6,46.333333333333336,62.0,<,-15.666666666666664,15,46,<,-31,77,85,<,-8,47.333333333333336,46.333333333333336,>,1.0,41,43,<,-2,56,52,>,4,245,262,<,-17
96,6,62.0,46.333333333333336,>,15.666666666666664,46,15,>,31,85,77,>,8,46.333333333333336,47.333333333333336,<,-1.0,43,41,>,2,52,56,<,-4,262,245,>,17
0,5,17.666666666666668,41.0,<,-23.333333333333332,10,10,=,0,29,62,<,-33,49.333333333333336,48.0,>,1.3333333333333357,44,38,>,6,57,53,>,4,182,197,<,-15
0,5,41.0,17.666666666666668,>,23.333333333333332,10,10,=,0,62,29,>,33,48.0,49.333333333333336,<,-1.3333333333333357,38,44,<,-6,53,57,<,-4,197,182,>,15
0,5,17.666666666666668,15.666666666666666,>,2.0000000000000018,10,15,<,-5,29,17,>,12,49.333333333333336,48.333333333333336,>,1.0,44,34,>,10,57,59,<,-2,182,184,<,-2
22,5,15.666666666666666,17.666666666666668,<,-2.0000000000000018,15,10,>,5,17,29,<,-12,48.333333333333336,49.333333333333336,<,-1.0,34,44,<,-10,59,57,>,2,184,182,>,2
0,5,17.666666666666668,46.666666666666664,<,-28.999999999999996,10,24,<,-14,29,77,<,-48,49.333333333333336,52.666666666666664,<,-3.3333333333333286,44,51,<,-7,57,56,>,1,182,153,>,29
34,5,46.666666666666664,17.666666666666668,>,28.999999999999996,24,10,>,14,77,29,>,48,52.666666666666664,49.333333333333336,>,3.3333333333333286,51,44,>,7,56,57,<,-1,153,182,<,-29
0,5,17.666666666666668,48.0,<,-30.333333333333332,10,43,<,-33,29,55,<,-26,49.333333333333336,46.333333333333336,>,3.0,44,43,>,1,57,52,>,5,182,262,<,-80
100,5,48.0,17.666666666666668,>,30.333333333333332,43,10,>,33,55,29,>,26,46.333333333333336,49.333333333333336,<,-3.0,43,44,<,-1,52,57,<,-5,262,182,>,80
0,4,49.333333333333336,36.333333333333336,>,13.0,10,15,<,-5,87,77,>,10,48.0,48.333333333333336,<,-0.3333333333333357,38,34,>,4,53,59,<,-6,197,184,>,13
22,4,36.333333333333336,49.333333333333336,<,-13.0,15,10,>,5,77,87,<,-10,48.333333333333336,48.0,>,0.3333333333333357,34,38,<,-4,59,53,>,6,184,197,<,-13
0,4,49.333333333333336,67.0,<,-17.666666666666664,10,39,<,-29,87,85,>,2,48.0,52.666666666666664,<,-4.666666666666664,38,51,<,-13,53,56,<,-3,197,153,>,44
91,4,67.0,49.333333333333336,>,17.666666666666664,39,10,>,29,85,87,<,-2,52.666666666666664,48.0,>,4.666666666666664,51,38,>,13,56,53,>,3,153,197,<,-44
0,4,49.333333333333336,40.666666666666664,>,8.666666666666671,10,33,<,-23,87,46,>,41,48.0,46.333333333333336,>,1.6666666666666643,38,43,<,-5,53,52,>,1,197,262,<,-65
0,4,40.666666666666664,49.333333333333336,<,-8.666666666666671,33,10,>,23,46,87,<,-41,46.333333333333336,48.0,<,-1.6666666666666643,43,38,>,5,52,53,<,-1,262,197,>,65
0,3,49.0,36.666666666666664,>,12.333333333333336,33,16,>,17,71,77,<,-6,46.333333333333336,48.333333333333336,<,-2.0,43,34,>,9,52,59,<,-7,262,184,>,78
0,3,36.666666666666664,49.0,<,-12.333333333333336,16,33,<,-17,77,71,>,6,48.333333333333336,46.333333333333336,>,2.0,34,43,<,-9,59,52,>,7,184,262,<,-78
0,3,49.0,74.66666666666667,<,-25.66666666666667,33,62,<,-29,71,85,<,-14,46.333333333333336,52.666666666666664,<,-6.333333333333329,43,51,<,-8,52,56,<,-4,262,153,>,109
98,3,74.66666666666667,49.0,>,25.66666666666667,62,33,>,29,85,71,>,14,52.666666666666664,46.333333333333336,>,6.333333333333329,51,43,>,8,56,52,>,4,153,262,<,-109
0,2,19.333333333333332,69.33333333333333,<,-50.0,16,62,<,-46,25,77,<,-52,48.333333333333336,52.666666666666664,<,-4.333333333333329,34,51,<,-17,59,56,>,3,184,153,>,31
90,2,69.33333333333333,19.333333333333332,>,50.0,62,16,>,46,77,25,>,52,52.666666666666664,48.333333333333336,>,4.333333333333329,51,34,>,17,56,59,<,-3,153,184,<,-31
0,11,0.0,0.0,=,0.0,0,0,=,0,0,0,=,0,44.333333333333336,56.0,<,-11.666666666666664,35,54,<,-19,50,60,<,-10,114,148,<,-34
21,11,0.0,0.0,=,0.0,0,0,=,0,0,0,=,0,56.0,44.333333333333336,>,11.666666666666664,54,35,>,19,60,50,>,10,148,114,>,34
0,11,0.0,0.0,=,0.0,0,0,=,0,0,0,=,0,44.333333333333336,36.666666666666664,>,7.666666666666671,35,35,=,0,50,38,>,12,114,83,>,31
0,11,0.0,0.0,=,0.0,0,0,=,0,0,0,=,0,36.666666666666664,44.333333333333336,<,-7.666666666666671,35,35,=,0,38,50,<,-12,83,114,<,-31
0,11,0.0,0.0,=,0.0,0,0,=,0,0,0,=,0,44.333333333333336,49.666666666666664,<,-5.333333333333329,35,45,<,-10,50,55,<,-5,114,115,<,-1
23,11,0.0,0.0,=,0.0,0,0,=,0,0,0,=,0,49.666666666666664,44.333333333333336,>,5.333333333333329,45,35,>,10,55,50,>,5,115,114,>,1
0,11,0.0,0.0,=,0.0,0,0,=,0,0,0,=,0,44.333333333333336,42.333333333333336,>,2.0,35,34,>,1,50,54,<,-4,114,96,>,18
15,11,0.0,0.0,=,0.0,0,0,=,0,0,0,=,0,42.333333333333336,44.333333333333336,<,-2.0,34,35,<,-1,54,50,>,4,96,114,<,-18
0,11,0.0,0.0,=,0.0,0,0,=,0,0,0,=,0,44.333333333333336,52.666666666666664,<,-8.333333333333329,35,49,<,-14,50,58,<,-8,114,139,<,-25
47,11,0.0,0.0,=,0.0,0,0,=,0,0,0,=,0,52.666666666666664,44.333333333333336,>,8.333333333333329,49,35,>,14,58,50,>,8,139,114,>,25
0,11,0.0,0.0,=,0.0,0,0,=,0,0,0,=,0,44.333333333333336,46.666666666666664,<,-2.3333333333333286,35,38,<,-3,50,52,<,-2,114,68,>,46
9,11,0.0,0.0,=,0.0,0,0,=,0,0,0,=,0,46.666666666666664,44.333333333333336,>,2.3333333333333286,38,35,>,3,52,50,>,2,68,114,<,-46
0,11,0.0,0.0,=,0.0,0,0,=,0,0,0,=,0,44.333333333333336,34.333333333333336,>,10.0,35,33,>,2,50,36,>,14,114,140,<,-26
39,11,0.0,0.0,=,0.0,0,0,=,0,0,0,=,0,34.333333333333336,44.333333333333336,<,-10.0,33,35,<,-2,36,50,<,-14,140,114,>,26
0,11,0.0,0.0,=,0.0,0,0,=,0,0,0,=,0,44.333333333333336,39.0,>,5.333333333333336,35,30,>,5,50,50,=,0,114,132,<,-18
15,11,0.0,0.0,=,0.0,0,0,=,0,0,0,=,0,39.0,44.333333333333336,<,-5.333333333333336,30,35,<,-5,50,50,=,0,132,114,>,18
0,11,0.0,0.0,=,0.0,0,0,=,0,0,0,=,0,44.333333333333336,55.0,<,-10.666666666666664,35,49,<,-14,50,58,<,-8,114,174,<,-60
95,11,0.0,0.0,=,0.0,0,0,=,0,0,0,=,0,55.0,44.333333333333336,>,10.666666666666664,49,35,>,14,58,50,>,8,174,114,>,60
0,11,0.0,0.0,=,0.0,0,0,=,0,0,0,=,0,44.333333333333336,46.666666666666664,<,-2.3333333333333286,35,38,<,-3,50,56,<,-6,114,131,<,-17
0,11,0.0,0.0,=,0.0,0,0,=,0,0,0,=,0,46.666666666666664,44.333333333333336,>,2.3333333333333286,38,35,>,3,56,50,>,6,131,114,>,17
0,10,12.666666666666666,7.0,>,5.666666666666666,0,0,=,0,38,21,>,17,36.666666666666664,46.666666666666664,<,-10.0,35,38,<,-3,38,56,<,-18,83,131,<,-48
0,10,7.0,12.666666666666666,<,-5.666666666666666,0,0,=,0,21,38,<,-17,46.666666666666664,36.666666666666664,>,10.0,38,35,>,3,56,38,>,18,131,83,>,48
0,10,12.666666666666666,27.0,<,-14.333333333333334,0,0,=,0,38,81,<,-43,36.666666666666664,46.666666666666664,<,-10.0,35,38,<,-3,38,52,<,-14,83,68,>,15
9,10,27.0,12.666666666666666,>,14.333333333333334,0,0,=,0,81,38,>,43,46.666666666666664,36.666666666666664,>,10.0,38,35,>,3,52,38,>,14,68,83,<,-15
0,10,12.666666666666666,30.0,<,-17.333333333333336,0,0,=,0,38,90,<,-52,36.666666666666664,42.333333333333336,<,-5.666666666666671,35,34,>,1,38,54,<,-16,83,96,<,-13
42,10,30.0,12.666666666666666,>,17.333333333333336,0,0,=,0,90,38,>,52,42.333333333333336,36.666666666666664,>,5.666666666666671,34,35,<,-1,54,38,>,16,96,83,>,13
0,10,12.666666666666666,14.333333333333334,<,-1.6666666666666679,0,0,=,0,38,43,<,-5,36.666666666666664,39.0,<,-2.3333333333333357,35,30,>,5,38,50,<,-12,83,132,<,-49
30,10,14.333333333333334,12.666666666666666,>,1.6666666666666679,0,0,=,0,43,38,>,5,39.0,36.666666666666664,>,2.3333333333333357,30,35,<,-5,50,38,>,12,132,83,>,49
0,10,12.666666666666666,25.0,<,-12.333333333333334,0,0,=,0,38,75,<,-37,36.666666666666664,56.0,<,-19.333333333333336,35,54,<,-19,38,60,<,-22,83,148,<,-65
52,10,25.0,12.666666666666666,>,12.333333333333334,0,0,=,0,75,38,>,37,56.0,36.666666666666664,>,19.333333333333336,54,35,>,19,60,38,>,22,148,83,>,65
0,10,12.666666666666666,6.0,>,6.666666666666666,0,0,=,0,38,18,>,20,36.666666666666664,49.666666666666664,<,-13.0,35,45,<,-10,38,55,<,-17,83,115,<,-32
0,10,6.0,12.666666666666666,<,-6.666666666666666,0,0,=,0,18,38,<,-20,49.666666666666664,36.666666666666664,>,13.0,45,35,>,10,55,38,>,17,115,83,>,32
0,10,12.666666666666666,25.333333333333332,<,-12.666666666666666,0,0,=,0,38,76,<,-38,36.666666666666664,34.333333333333336,>,2.3333333333333286,35,33,>,2,38,36,>,2,83,140,<,-57
39,10,25.333333333333332,12.666666666666666,>,12.666666666666666,0,0,=,0,76,38,>,38,34.333333333333336,36.666666666666664,<,-2.3333333333333286,33,35,<,-2,36,38,<,-2,140,83,>,57
0,10,12.666666666666666,10.0,>,2.666666666666666,0,0,=,0,38,30,>,8,36.666666666666664,52.666666666666664,<,-16.0,35,49,<,-14,38,58,<,-20,83,139,<,-56
52,10,10.0,12.666666666666666,<,-2.666666666666666,0,0,=,0,30,38,<,-8,52.666666666666664,36.666666666666664,>,16.0,49,35,>,14,58,38,>,20,139,83,>,56
0,10,12.666666666666666,3.6666666666666665,>,9.0,0,0,=,0,38,11,>,27,36.666666666666664,55.0,<,-18.333333333333336,35,49,<,-14,38,58,<,-20,83,174,<,-91
95,10,3.6666666666666665,12.666666666666666,<,-9.0,0,0,=,0,11,38,<,-27,55.0,36.666666666666664,>,18.333333333333336,49,35,>,14,58,38,>,20,174,83,>,91
0,9,15.0,20.333333333333332,<,-5.333333333333332,0,0,=,0,27,40,<,-13,49.666666666666664,46.666666666666664,>,3.0,45,38,>,7,55,56,<,-1,115,131,<,-16
0,9,20.333333333333332,15.0,>,5.333333333333332,0,0,=,0,40,27,>,13,46.666666666666664,49.666666666666664,<,-3.0,38,45,<,-7,56,55,>,1,131,115,>,16
0,9,15.0,55.666666666666664,<,-40.666666666666664,0,0,=,0,27,86,<,-59,49.666666666666664,46.666666666666664,>,3.0,45,38,>,7,55,52,>,3,115,68,>,47
9,9,55.666666666666664,15.0,>,40.666666666666664,0,0,=,0,86,27,>,59,46.666666666666664,49.666666666666664,<,-3.0,38,45,<,-7,52,55,<,-3,68,115,<,-47
0,9,15.0,29.0,<,-14.0,0,0,=,0,27,44,<,-17,49.666666666666664,39.0,>,10.666666666666664,45,30,>,15,55,50,>,5,115,132,<,-17
0,9,29.0,15.0,>,14.0,0,0,=,0,44,27,>,17,39.0,49.666666666666664,<,-10.666666666666664,30,45,<,-15,50,55,<,-5,132,115,>,17
0,9,15.0,43.0,<,-28.0,0,0,=,0,27,76,<,-49,49.666666666666664,34.333333333333336,>,15.333333333333329,45,33,>,12,55,36,>,19,115,140,<,-25
83,9,43.0,15.0,>,28.0,0,0,=,0,76,27,>,49,34.333333333333336,49.666666666666664,<,-15.333333333333329,33,45,<,-12,36,55,<,-19,140,115,>,25
0,9,15.0,53.666666666666664,<,-38.666666666666664,0,0,=,0,27,90,<,-63,49.666666666666664,42.333333333333336,>,7.333333333333329,45,34,>,11,55,54,>,1,115,96,>,19
42,9,53.666666666666664,15.0,>,38.666666666666664,0,0,=,0,90,27,>,63,42.333333333333336,49.666666666666664,<,-7.333333333333329,34,45,<,-11,54,55,<,-1,96,115,<,-19
0,9,15.0,54.333333333333336,<,-39.333333333333336,0,0,=,0,27,88,<,-61,49.666666666666664,56.0,<,-6.333333333333336,45,54,<,-9,55,60,<,-5,115,148,<,-33
114,9,54.333333333333336,15.0,>,39.333333333333336,0,0,=,0,88,27,>,61,56.0,49.666666666666664,>,6.333333333333336,54,45,>,9,60,55,>,5,148,115,>,33
0,9,15.0,21.333333333333332,<,-6.333333333333332,0,0,=,0,27,34,<,-7,49.666666666666664,52.666666666666664,<,-3.0,45,49,<,-4,55,58,<,-3,115,139,<,-24
64,9,21.333333333333332,15.0,>,6.333333333333332,0,0,=,0,34,27,>,7,52.666666666666664,49.666666666666664,>,3.0,49,45,>,4,58,55,>,3,139,115,>,24
0,9,15.0,32.333333333333336,<,-17.333333333333336,0,0,=,0,27,86,<,-59,49.666666666666664,55.0,<,-5.333333333333336,45,49,<,-4,55,58,<,-3,115,174,<,-59
95,9,32.333333333333336,15.0,>,17.333333333333336,0,0,=,0,86,27,>,59,55.0,49.666666666666664,>,5.333333333333336,49,45,>,4,58,55,>,3,174,115,>,59
0,8,41.333333333333336,40.0,>,1.3333333333333357,0,0,=,0,80,80,=,0,39.0,46.666666666666664,<,-7.666666666666664,30,38,<,-8,50,56,<,-6,132,131,>,1
0,8,40.0,41.333333333333336,<,-1.3333333333333357,0,0,=,0,80,80,=,0,46.666666666666664,39.0,>,7.666666666666664,38,30,>,8,56,50,>,6,131,132,<,-1
0,8,41.333333333333336,34.333333333333336,>,7.0,0,0,=,0,80,86,<,-6,39.0,46.666666666666664,<,-7.666666666666664,30,38,<,-8,50,52,<,-2,132,68,>,64
9,8,34.333333333333336,41.333333333333336,<,-7.0,0,0,=,0,86,80,>,6,46.666666666666664,39.0,>,7.666666666666664,38,30,>,8,52,50,>,2,68,132,<,-64
0,8,41.333333333333336,36.666666666666664,>,4.666666666666671,0,0,=,0,80,71,>,9,39.0,42.333333333333336,<,-3.3333333333333357,30,34,<,-4,50,54,<,-4,132,96,>,36
42,8,36.666666666666664,41.333333333333336,<,-4.666666666666671,0,0,=,0,71,80,<,-9,42.333333333333336,39.0,>,3.3333333333333357,34,30,>,4,54,50,>,4,96,132,<,-36
0,8,41.333333333333336,15.333333333333334,>,26.0,0,0,=,0,80,34,>,46,39.0,52.666666666666664,<,-13.666666666666664,30,49,<,-19,50,58,<,-8,132,139,<,-7
0,8,15.333333333333334,41.333333333333336,<,-26.0,0,0,=,0,34,80,<,-46,52.666666666666664,39.0,>,13.666666666666664,49,30,>,19,58,50,>,8,139,132,>,7
0,8,41.333333333333336,36.0,>,5.333333333333336,0,0,=,0,80,55,>,25,39.0,34.333333333333336,>,4.666666666666664,30,33,<,-3,50,36,>,14,132,140,<,-8
69,8,36.0,41.333333333333336,<,-5.333333333333336,0,0,=,0,55,80,<,-25,34.333333333333336,39.0,<,-4.666666666666664,33,30,>,3,36,50,<,-14,140,132,>,8
0,8,41.333333333333336,58.666666666666664,<,-17.33333333333333,0,0,=,0,80,90,<,-10,39.0,55.0,<,-16.0,30,49,<,-19,50,58,<,-8,132,174,<,-42
95,8,58.666666666666664,41.333333333333336,>,17.33333333333333,0,0,=,0,90,80,>,10,55.0,39.0,>,16.0,49,30,>,19,58,50,>,8,174,132,>,42
0,8,41.333333333333336,49.0,<,-7.666666666666664,0,0,=,0,80,88,<,-8,39.0,56.0,<,-17.0,30,54,<,-24,50,60,<,-10,132,148,<,-16
64,8,49.0,41.333333333333336,>,7.666666666666664,0,0,=,0,88,80,>,8,56.0,39.0,>,17.0,54,30,>,24,60,50,>,10,148,132,>,16
0,7,33.0,32.0,>,1.0,0,0,=,0,87,80,>,7,52.666666666666664,46.666666666666664,>,6.0,49,38,>,11,58,56,>,2,139,131,>,8
0,7,32.0,33.0,<,-1.0,0,0,=,0,80,87,<,-7,46.666666666666664,52.666666666666664,<,-6.0,38,49,<,-11,56,58,<,-2,131,139,<,-8
0,7,33.0,24.666666666666668,>,8.333333333333332,0,0,=,0,87,57,>,30,52.666666666666664,46.666666666666664,>,6.0,49,38,>,11,58,52,>,6,139,68,>,71
9,7,24.666666666666668,33.0,<,-8.333333333333332,0,0,=,0,57,87,<,-30,46.666666666666664,52.666666666666664,<,-6.0,38,49,<,-11,52,58,<,-6,68,139,<,-71
0,7,33.0,29.0,>,4.0,0,0,=,0,87,48,>,39,52.666666666666664,42.333333333333336,>,10.333333333333329,49,34,>,15,58,54,>,4,139,96,>,43
43,7,29.0,33.0,<,-4.0,0,0,=,0,48,87,<,-39,42.333333333333336,52.666666666666664,<,-10.333333333333329,34,49,<,-15,54,58,<,-4,96,139,<,-43
0,7,33.0,47.666666666666664,<,-14.666666666666664,0,0,=,0,87,84,>,3,52.666666666666664,56.0,<,-3.3333333333333357,49,54,<,-5,58,60,<,-2,139,148,<,-9
64,7,47.666666666666664,33.0,>,14.666666666666664,0,0,=,0,84,87,<,-3,56.0,52.666666666666664,>,3.3333333333333357,54,49,>,5,60,58,>,2,148,139,>,9
0,7,33.0,23.666666666666668,>,9.333333333333332,0,0,=,0,87,55,>,32,52.666666666666664,34.333333333333336,>,18.33333333333333,49,33,>,16,58,36,>,22,139,140,<,-1
0,7,23.666666666666668,33.0,<,-9.333333333333332,0,0,=,0,55,87,<,-32,34.333333333333336,52.666666666666664,<,-18.33333333333333,33,49,<,-16,36,58,<,-22,140,139,>,1
0,7,33.0,44.666666666666664,<,-11.666666666666664,0,0,=,0,87,90,<,-3,52.666666666666664,55.0,<,-2.3333333333333357,49,49,=,0,58,58,=,0,139,174,<,-35
38,7,44.666666666666664,33.0,>,11.666666666666664,0,0,=,0,90,87,>,3,55.0,52.666666666666664,>,2.3333333333333357,49,49,=,0,58,58,=,0,174,139,>,35
0,6,15.0,24.333333333333332,<,-9.333333333333332,0,0,=,0,29,57,<,-28,34.333333333333336,46.666666666666664,<,-12.333333333333329,33,38,<,-5,36,56,<,-20,140,131,>,9
0,6,24.333333333333332,15.0,>,9.333333333333332,0,0,=,0,57,29,>,28,46.666666666666664,34.333333333333336,>,12.333333333333329,38,33,>,5,56,36,>,20,131,140,<,-9
0,6,15.0,29.0,<,-14.0,0,0,=,0,29,57,<,-28,34.333333333333336,46.666666666666664,<,-12.333333333333329,33,38,<,-5,36,52,<,-16,140,68,>,72
9,6,29.0,15.0,>,14.0,0,0,=,0,57,29,>,28,46.666666666666664,34.333333333333336,>,12.333333333333329,38,33,>,5,52,36,>,16,68,140,<,-72
0,6,15.0,37.0,<,-22.0,0,0,=,0,29,67,<,-38,34.333333333333336,55.0,<,-20.666666666666664,33,49,<,-16,36,58,<,-22,140,174,<,-34
38,6,37.0,15.0,>,22.0,0,0,=,0,67,29,>,38,55.0,34.333333333333336,>,20.666666666666664,49,33,>,16,58,36,>,22,174,140,>,34
0,6,15.0,27.0,<,-12.0,0,0,=,0,29,48,<,-19,34.333333333333336,42.333333333333336,<,-8.0,33,34,<,-1,36,54,<,-18,140,96,>,44
43,6,27.0,15.0,>,12.0,0,0,=,0,48,29,>,19,42.333333333333336,34.333333333333336,>,8.0,34,33,>,1,54,36,>,18,96,140,<,-44
0,6,15.0,31.333333333333332,<,-16.333333333333332,0,0,=,0,29,84,<,-55,34.333333333333336,56.0,<,-21.666666666666664,33,54,<,-21,36,60,<,-24,140,148,<,-8
0,6,31.333333333333332,15.0,>,16.333333333333332,0,0,=,0,84,29,>,55,56.0,34.333333333333336,>,21.666666666666664,54,33,>,21,60,36,>,24,148,140,>,8
0,5,33.333333333333336,39.0,<,-5.666666666666664,0,0,=,0,90,60,>,30,56.0,46.666666666666664,>,9.333333333333336,54,38,>,16,60,56,>,4,148,131,>,17
0,5,39.0,33.333333333333336,>,5.666666666666664,0,0,=,0,60,90,<,-30,46.666666666666664,56.0,<,-9.333333333333336,38,54,<,-16,56,60,<,-4,131,148,<,-17
0,5,33.333333333333336,15.0,>,18.333333333333336,0,0,=,0,90,30,>,60,56.0,46.666666666666664,>,9.333333333333336,54,38,>,16,60,52,>,8,148,68,>,80
9,5,15.0,33.333333333333336,<,-18.333333333333336,0,0,=,0,30,90,<,-60,46.666666666666664,56.0,<,-9.333333333333336,38,54,<,-16,52,60,<,-8,68,148,<,-80
0,5,33.333333333333336,49.0,<,-15.666666666666664,0,0,=,0,90,80,>,10,56.0,55.0,>,1.0,54,49,>,5,60,58,>,2,148,174,<,-26
42,5,49.0,33.333333333333336,>,15.666666666666664,0,0,=,0,80,90,<,-10,55.0,56.0,<,-1.0,49,54,<,-5,58,60,<,-2,174,148,>,26
0,5,33.333333333333336,38.666666666666664,<,-5.333333333333329,0,0,=,0,90,83,>,7,56.0,42.333333333333336,>,13.666666666666664,54,34,>,20,60,54,>,6,148,96,>,52
98,5,38.666666666666664,33.333333333333336,>,5.333333333333329,0,0,=,0,83,90,<,-7,42.333333333333336,56.0,<,-13.666666666666664,34,54,<,-20,54,60,<,-6,96,148,<,-52
0,4,26.333333333333332,15.666666666666666,>,10.666666666666666,0,0,=,0,60,32,>,28,46.666666666666664,46.666666666666664,=,0.0,38,38,=,0,56,52,>,4,131,68,>,63
9,4,15.666666666666666,26.333333333333332,<,-10.666666666666666,0,0,=,0,32,60,<,-28,46.666666666666664,46.666666666666664,=,0.0,38,38,=,0,52,56,<,-4,68,131,<,-63
0,4,26.333333333333332,52.666666666666664,<,-26.333333333333332,0,0,=,0,60,80,<,-20,46.666666666666664,55.0,<,-8.333333333333336,38,49,<,-11,56,58,<,-2,131,174,<,-43
42,4,52.666666666666664,26.333333333333332,>,26.333333333333332,0,0,=,0,80,60,>,20,55.0,46.666666666666664,>,8.333333333333336,49,38,>,11,58,56,>,2,174,131,>,43
0,4,26.333333333333332,46.333333333333336,<,-20.000000000000004,0,0,=,0,60,83,<,-23,46.666666666666664,42.333333333333336,>,4.333333333333329,38,34,>,4,56,54,>,2,131,96,>,35
98,4,46.333333333333336,26.333333333333332,>,20.000000000000004,0,0,=,0,83,60,>,23,42.333333333333336,46.666666666666664,<,-4.333333333333329,34,38,<,-4,54,56,<,-2,96,131,<,-35
0,3,19.666666666666668,75.33333333333333,<,-55.66666666666666,12,68,<,-56,32,80,<,-48,46.666666666666664,55.0,<,-8.333333333333336,38,49,<,-11,52,58,<,-6,68,174,<,-106
83,3,75.33333333333333,19.666666666666668,>,55.66666666666666,68,12,>,56,80,32,>,48,55.0,46.666666666666664,>,8.333333333333336,49,38,>,11,58,52,>,6,174,68,>,106
0,3,19.666666666666668,75.66666666666667,<,-56.0,12,56,<,-44,32,88,<,-56,46.666666666666664,42.333333333333336,>,4.333333333333329,38,34,>,4,52,54,<,-2,68,96,<,-28
187,3,75.66666666666667,19.666666666666668,>,56.0,56,12,>,44,88,32,>,56,42.333333333333336,46.666666666666664,<,-4.333333333333329,34,38,<,-4,54,52,>,2,96,68,>,28
0,2,50.0,82.0,<,-32.0,11,78,<,-67,83,88,<,-5,42.333333333333336,55.0,<,-12.666666666666664,34,49,<,-15,54,58,<,-4,96,174,<,-78
83,2,82.0,50.0,>,32.0,78,11,>,67,88,83,>,5,55.0,42.333333333333336,>,12.666666666666664,49,34,>,15,58,54,>,4,174,96,>,78
0,20,0.0,0.0,=,0.0,0,0,=,0,0,0,=,0,36.666666666666664,45.666666666666664,<,-9.0,32,33,<,-1,42,54,<,-12,119,261,<,-142
16,20,0.0,0.0,=,0.0,0,0,=,0,0,0,=,0,45.666666666666664,36.666666666666664,>,9.0,33,32,>,1,54,42,>,12,261,119,>,142
0,20,0.0,0.0,=,0.0,0,0,=,0,0,0,=,0,36.666666666666664,48.333333333333336,<,-11.666666666666671,32,31,>,1,42,60,<,-18,119,286,<,-167
51,20,0.0,0.0,=,0.0,0,0,=,0,0,0,=,0,48.333333333333336,36.666666666666664,>,11.666666666666671,31,32,<,-1,60,42,>,18,286,119,>,167
0,20,0.0,0.0,=,0.0,0,0,=,0,0,0,=,0,36.666666666666664,49.333333333333336,<,-12.666666666666671,32,39,<,-7,42,59,<,-17,119,236,<,-117
72,20,0.0,0.0,=,0.0,0,0,=,0,0,0,=,0,49.333333333333336,36.666666666666664,>,12.666666666666671,39,32,>,7,59,42,>,17,236,119,>,117
0,20,0.0,0.0,=,0.0,0,0,=,0,0,0,=,0,36.666666666666664,40.666666666666664,<,-4.0,32,31,>,1,42,52,<,-10,119,302,<,-183
75,20,0.0,0.0,=,0.0,0,0,=,0,0,0,=,0,40.666666666666664,36.666666666666664,>,4.0,31,32,<,-1,52,42,>,10,302,119,>,183
0,20,0.0,0.0,=,0.0,0,0,=,0,0,0,=,0,36.666666666666664,52.333333333333336,<,-15.666666666666671,32,50,<,-18,42,56,<,-14,119,246,<,-127
19,20,0.0,0.0,=,0.0,0,0,=,0,0,0,=,0,52.333333333333336,36.666666666666664,>,15.666666666666671,50,32,>,18,56,42,>,14,246,119,>,127
0,20,0.0,0.0,=,0.0,0,0,=,0,0,0,=,0,36.666666666666664,46.333333333333336,<,-9.666666666666671,32,41,<,-9,42,51,<,-9,119,295,<,-176
46,20,0.0,0.0,=,0.0,0,0,=,0,0,0,=,0,46.333333333333336,36.666666666666664,>,9.666666666666671,41,32,>,9,51,42,>,9,295,119,>,176
0,20,0.0,0.0,=,0.0,0,0,=,0,0,0,=,0,36.666666666666664,46.0,<,-9.333333333333336,32,33,<,-1,42,54,<,-12,119,277,<,-158
7,20,0.0,0.0,=,0.0,0,0,=,0,0,0,=,0,46.0,36.666666666666664,>,9.333333333333336,33,32,>,1,54,42,>,12,277,119,>,158
0,20,0.0,0.0,=,0.0,0,0,=,0,0,0,=,0,36.666666666666664,44.666666666666664,<,-8.0,32,41,<,-9,42,51,<,-9,119,209,<,-90
36,20,0.0,0.0,=,0.0,0,0,=,0,0,0,=,0,44.666666666666664,36.666666666666664,>,8.0,41,32,>,9,51,42,>,9,209,119,>,90
0,20,0.0,0.0,=,0.0,0,0,=,0,0,0,=,0,36.666666666666664,38.0,<,-1.3333333333333357,32,34,<,-2,42,43,<,-1,119,273,<,-154
42,20,0.0,0.0,=,0.0,0,0,=,0,0,0,=,0,38.0,36.666666666666664,>,1.3333333333333357,34,32,>,2,43,42,>,1,273,119,>,154
0,20,0.0,0.0,=,0.0,0,0,=,0,0,0,=,0,36.666666666666664,41.666666666666664,<,-5.0,32,30,>,2,42,55,<,-13,119,120,<,-1
7,20,0.0,0.0,=,0.0,0,0,=,0,0,0,=,0,41.666666666666664,36.666666666666664,>,5.0,30,32,<,-2,55,42,>,13,120,119,>,1
0,20,0.0,0.0,=,0.0,0,0,=,0,0,0,=,0,36.666666666666664,41.333333333333336,<,-4.666666666666671,32,31,>,1,42,48,<,-6,119,255,<,-136
36,20,0.0,0.0,=,0.0,0,0,=,0,0,0,=,0,41.333333333333336,36.666666666666664,>,4.666666666666671,31,32,<,-1,48,42,>,6,255,119,>,136
0,20,0.0,0.0,=,0.0,0,0,=,0,0,0,=,0,36.666666666666664,41.0,<,-4.333333333333336,32,31,>,1,42,46,<,-4,119,286,<,-167
92,20,0.0,0.0,=,0.0,0,0,=,0,0,0,=,0,41.0,36.666666666666664,>,4.333333333333336,31,32,<,-1,46,42,>,4,286,119,>,167
0,20,0.0,0.0,=,0.0,0,0,=,0,0,0,=,0,36.666666666666664,41.666666666666664,<,-5.0,32,34,<,-2,42,48,<,-6,119,181,<,-62
25,20,0.0,0.0,=,0.0,0,0,=,0,0,0,=,0,41.666666666666664,36.666666666666664,>,5.0,34,32,>,2,48,42,>,6,181,119,>,62
0,20,0.0,0.0,=,0.0,0,0,=,0,0,0,=,0,36.666666666666664,37.666666666666664,<,-1.0,32,32,=,0,42,48,<,-6,119,216,<,-97
52,20,0.0,0.0,=,0.0,0,0,=,0,0,0,=,0,37.666666666666664,36.666666666666664,>,1.0,32,32,=,0,48,42,>,6,216,119,>,97
0,20,0.0,0.0,=,0.0,0,0,=,0,0,0,=,0,36.666666666666664,41.0,<,-4.333333333333336,32,35,<,-3,42,50,<,-8,119,319,<,-200
79,20,0.0,0.0,=,0.0,0,0,=,0,0,0,=,0,41.0,36.666666666666664,>,4.333333333333336,35,32,>,3,50,42,>,8,319,119,>,200
0,20,0.0,0.0,=,0.0,0,0,=,0,0,0,=,0,36.666666666666664,52.333333333333336,<,-15.666666666666671,32,52,<,-20,42,53,<,-11,119,255,<,-136
49,20,0.0,0.0,=,0.0,0,0,=,0,0,0,=,0,52.333333333333336,36.666666666666664,>,15.666666666666671,52,32,>,20,53,42,>,11,255,119,>,136
0,20,0.0,0.0,=,0.0,0,0,=,0,0,0,=,0,36.666666666666664,47.333333333333336,<,-10.666666666666671,32,40,<,-8,42,57,<,-15,119,218,<,-99
43,20,0.0,0.0,=,0.0,0,0,=,0,0,0,=,0,47.333333333333336,36.666666666666664,>,10.666666666666671,40,32,>,8,57,42,>,15,218,119,>,99
0,20,0.0,0.0,=,0.0,0,0,=,0,0,0,=,0,36.666666666666664,52.666666666666664,<,-16.0,32,50,<,-18,42,56,<,-14,119,235,<,-116
21,20,0.0,0.0,=,0.0,0,0,=,0,0,0,=,0,52.666666666666664,36.666666666666664,>,16.0,50,32,>,18,56,42,>,14,235,119,>,116
0,20,0.0,0.0,=,0.0,0,0,=,0,0,0,=,0,36.666666666666664,37.0,<,-0.3333333333333357,32,31,>,1,42,43,<,-1,119,168,<,-49
0,20,0.0,0.0,=,0.0,0,0,=,0,0,0,=,0,37.0,36.666666666666664,>,0.3333333333333357,31,32,<,-1,43,42,>,1,168,119,>,49
0,19,24.666666666666668,10.333333333333334,>,14.333333333333334,0,0,=,0,74,31,>,43,37.0,46.0,<,-9.0,31,33,<,-2,43,54,<,-11,168,277,<,-109
56,19,10.333333333333334,24.666666666666668,<,-14.333333333333334,0,0,=,0,31,74,<,-43,46.0,37.0,>,9.0,33,31,>,2,54,43,>,11,277,168,>,109
0,19,24.666666666666668,4.0,>,20.666666666666668,0,0,=,0,74,12,>,62,37.0,41.666666666666664,<,-4.666666666666664,31,30,>,1,43,55,<,-12,168,120,>,48
43,19,4.0,24.666666666666668,<,-20.666666666666668,0,0,=,0,12,74,<,-62,41.666666666666664,37.0,>,4.666666666666664,30,31,<,-1,55,43,>,12,120,168,<,-48
0,19,24.666666666666668,11.333333333333334,>,13.333333333333334,0,0,=,0,74,34,>,40,37.0,45.666666666666664,<,-8.666666666666664,31,33,<,-2,43,54,<,-11,168,261,<,-93
16,19,11.333333333333334,24.666666666666668,<,-13.333333333333334,0,0,=,0,34,74,<,-40,45.666666666666664,37.0,>,8.666666666666664,33,31,>,2,54,43,>,11,261,168,>,93
0,19,24.666666666666668,28.333333333333332,<,-3.6666666666666643,0,0,=,0,74,85,<,-11,37.0,52.333333333333336,<,-15.333333333333336,31,50,<,-19,43,56,<,-13,168,246,<,-78
19,19,28.333333333333332,24.666666666666668,>,3.6666666666666643,0,0,=,0,85,74,>,11,52.333333333333336,37.0,>,15.333333333333336,50,31,>,19,56,43,>,13,246,168,>,78
0,19,24.666666666666668,14.0,>,10.666666666666668,0,0,=,0,74,42,>,32,37.0,52.666666666666664,<,-15.666666666666664,31,50,<,-19,43,56,<,-13,168,235,<,-67
53,19,14.0,24.666666666666668,<,-10.666666666666668,0,0,=,0,42,74,<,-32,52.666666666666664,37.0,>,15.666666666666664,50,31,>,19,56,43,>,13,235,168,>,67
0,19,24.666666666666668,21.333333333333332,>,3.3333333333333357,0,0,=,0,74,64,>,10,37.0,41.666666666666664,<,-4.666666666666664,31,34,<,-3,43,48,<,-5,168,181,<,-13
101,19,21.333333333333332,24.666666666666668,<,-3.3333333333333357,0,0,=,0,64,74,<,-10,41.666666666666664,37.0,>,4.666666666666664,34,31,>,3,48,43,>,5,181,168,>,13
0,19,24.666666666666668,29.666666666666668,<,-5.0,0,0,=,0,74,89,<,-15,37.0,44.666666666666664,<,-7.666666666666664,31,41,<,-10,43,51,<,-8,168,209,<,-41
129,19,29.666666666666668,24.666666666666668,>,5.0,0,0,=,0,89,74,>,15,44.666666666666664,37.0,>,7.666666666666664,41,31,>,10,51,43,>,8,209,168,>,41
0,19,24.666666666666668,17.333333333333332,>,7.333333333333336,0,0,=,0,74,52,>,22,37.0,41.333333333333336,<,-4.333333333333336,31,31,=,0,43,48,<,-5,168,255,<,-87
98,19,17.333333333333332,24.666666666666668,<,-7.333333333333336,0,0,=,0,52,74,<,-22,41.333333333333336,37.0,>,4.333333333333336,31,31,=,0,48,43,>,5,255,168,>,87
0,19,24.666666666666668,29.333333333333332,<,-4.666666666666664,0,0,=,0,74,88,<,-14,37.0,38.0,<,-1.0,31,34,<,-3,43,43,=,0,168,273,<,-105
42,19,29.333333333333332,24.666666666666668,>,4.666666666666664,0,0,=,0,88,74,>,14,38.0,37.0,>,1.0,34,31,>,3,43,43,=,0,273,168,>,105
0,19,24.666666666666668,7.333333333333333,>,17.333333333333336,0,0,=,0,74,22,>,52,37.0,47.333333333333336,<,-10.333333333333336,31,40,<,-9,43,57,<,-14,168,218,<,-50
43,19,7.333333333333333,24.666666666666668,<,-17.333333333333336,0,0,=,0,22,74,<,-52,47.333333333333336,37.0,>,10.333333333333336,40,31,>,9,57,43,>,14,218,168,>,50
0,19,24.666666666666668,5.666666666666667,>,19.0,0,0,=,0,74,17,>,57,37.0,46.333333333333336,<,-9.333333333333336,31,41,<,-10,43,51,<,-8,168,295,<,-127
46,19,5.666666666666667,24.666666666666668,<,-19.0,0,0,=,0,17,74,<,-57,46.333333333333336,37.0,>,9.333333333333336,41,31,>,10,51,43,>,8,295,168,>,127
0,19,24.666666666666668,9.0,>,15.666666666666668,0,0,=,0,74,27,>,47,37.0,52.333333333333336,<,-15.333333333333336,31,52,<,-21,43,53,<,-10,168,255,<,-87
77,19,9.0,24.666666666666668,<,-15.666666666666668,0,0,=,0,27,74,<,-47,52.333333333333336,37.0,>,15.333333333333336,52,31,>,21,53,43,>,10,255,168,>,87
0,19,24.666666666666668,26.0,<,-1.3333333333333321,0,0,=,0,74,78,<,-4,37.0,48.333333333333336,<,-11.333333333333336,31,31,=,0,43,60,<,-17,168,286,<,-118
51,19,26.0,24.666666666666668,>,1.3333333333333321,0,0,=,0,78,74,>,4,48.333333333333336,37.0,>,11.333333333333336,31,31,=,0,60,43,>,17,286,168,>,118
0,19,24.666666666666668,9.666666666666666,>,15.000000000000002,0,0,=,0,74,29,>,45,37.0,37.666666666666664,<,-0.6666666666666643,31,32,<,-1,43,48,<,-5,168,216,<,-48
101,19,9.666666666666666,24.666666666666668,<,-15.000000000000002,0,0,=,0,29,74,<,-45,37.666666666666664,37.0,>,0.6666666666666643,32,31,>,1,48,43,>,5,216,168,>,48
0,19,24.666666666666668,17.0,>,7.666666666666668,0,0,=,0,74,51,>,23,37.0,49.333333333333336,<,-12.333333333333336,31,39,<,-8,43,59,<,-16,168,236,<,-68
90,19,17.0,24.666666666666668,<,-7.666666666666668,0,0,=,0,51,74,<,-23,49.333333333333336,37.0,>,12.333333333333336,39,31,>,8,59,43,>,16,236,168,>,68
0,19,24.666666666666668,18.666666666666668,>,6.0,0,0,=,0,74,56,>,18,37.0,40.666666666666664,<,-3.6666666666666643,31,31,=,0,43,52,<,-9,168,302,<,-134
68,19,18.666666666666668,24.666666666666668,<,-6.0,0,0,=,0,56,74,<,-18,40.666666666666664,37.0,>,3.6666666666666643,31,31,=,0,52,43,>,9,302,168,>,134
0,19,24.666666666666668,21.666666666666668,>,3.0,0,0,=,0,74,65,>,9,37.0,41.0,<,-4.0,31,35,<,-4,43,50,<,-7,168,319,<,-151
116,19,21.666666666666668,24.666666666666668,<,-3.0,0,0,=,0,65,74,<,-9,41.0,37.0,>,4.0,35,31,>,4,50,43,>,7,319,168,>,151
0,19,24.666666666666668,24.666666666666668,=,0.0,0,0,=,0,74,74,=,0,37.0,41.0,<,-4.0,31,31,=,0,43,46,<,-3,168,286,<,-118
92,19,24.666666666666668,24.666666666666668,=,0.0,0,0,=,0,74,74,=,0,41.0,37.0,>,4.0,31,31,=,0,46,43,>,3,286,168,>,118
0,18,19.666666666666668,39.333333333333336,<,-19.666666666666668,0,0,=,0,37,84,<,-47,47.333333333333336,45.666666666666664,>,1.6666666666666714,40,33,>,7,57,54,>,3,218,261,<,-43
16,18,39.333333333333336,19.666666666666668,>,19.666666666666668,0,0,=,0,84,37,>,47,45.666666666666664,47.333333333333336,<,-1.6666666666666714,33,40,<,-7,54,57,<,-3,261,218,>,43
0,18,19.666666666666668,39.333333333333336,<,-19.666666666666668,0,0,=,0,37,85,<,-48,47.333333333333336,52.333333333333336,<,-5.0,40,50,<,-10,57,56,>,1,218,246,<,-28
19,18,39.333333333333336,19.666666666666668,>,19.666666666666668,0,0,=,0,85,37,>,48,52.333333333333336,47.333333333333336,>,5.0,50,40,>,10,56,57,<,-1,246,218,>,28
0,18,19.666666666666668,41.0,<,-21.333333333333332,0,0,=,0,37,88,<,-51,47.333333333333336,38.0,>,9.333333333333336,40,34,>,6,57,43,>,14,218,273,<,-55
42,18,41.0,19.666666666666668,>,21.333333333333332,0,0,=,0,88,37,>,51,38.0,47.333333333333336,<,-9.333333333333336,34,40,<,-6,43,57,<,-14,273,218,>,55
0,18,19.666666666666668,14.666666666666666,>,5.000000000000002,0,0,=,0,37,32,>,5,47.333333333333336,41.666666666666664,>,5.666666666666671,40,30,>,10,57,55,>,2,218,120,>,98
43,18,14.666666666666666,19.666666666666668,<,-5.000000000000002,0,0,=,0,32,37,<,-5,41.666666666666664,47.333333333333336,<,-5.666666666666671,30,40,<,-10,55,57,<,-2,120,218,<,-98
0,18,19.666666666666668,29.666666666666668,<,-10.0,0,0,=,0,37,72,<,-35,47.333333333333336,46.333333333333336,>,1.0,40,41,<,-1,57,51,>,6,218,295,<,-77
47,18,29.666666666666668,19.666666666666668,>,10.0,0,0,=,0,72,37,>,35,46.333333333333336,47.333333333333336,<,-1.0,41,40,>,1,51,57,<,-6,295,218,>,77
0,18,19.666666666666668,41.666666666666664,<,-21.999999999999996,0,0,=,0,37,78,<,-41,47.333333333333336,48.333333333333336,<,-1.0,40,31,>,9,57,60,<,-3,218,286,<,-68
51,18,41.666666666666664,19.666666666666668,>,21.999999999999996,0,0,=,0,78,37,>,41,48.333333333333336,47.333333333333336,>,1.0,31,40,<,-9,60,57,>,3,286,218,>,68
0,18,19.666666666666668,32.333333333333336,<,-12.666666666666668,0,0,=,0,37,55,<,-18,47.333333333333336,52.666666666666664,<,-5.333333333333329,40,50,<,-10,57,56,>,1,218,235,<,-17
53,18,32.333333333333336,19.666666666666668,>,12.666666666666668,0,0,=,0,55,37,>,18,52.666666666666664,47.333333333333336,>,5.333333333333329,50,40,>,10,56,57,<,-1,235,218,>,17
0,18,19.666666666666668,27.333333333333332,<,-7.666666666666664,0,0,=,0,37,51,<,-14,47.333333333333336,46.0,>,1.3333333333333357,40,33,>,7,57,54,>,3,218,277,<,-59
56,18,27.333333333333332,19.666666666666668,>,7.666666666666664,0,0,=,0,51,37,>,14,46.0,47.333333333333336,<,-1.3333333333333357,33,40,<,-7,54,57,<,-3,277,218,>,59
0,18,19.666666666666668,33.666666666666664,<,-13.999999999999996,0,0,=,0,37,56,<,-19,47.333333333333336,40.666666666666664,>,6.666666666666671,40,31,>,9,57,52,>,5,218,302,<,-84
68,18,33.666666666666664,19.666666666666668,>,13.999999999999996,0,0,=,0,56,37,>,19,40.666666666666664,47.333333333333336,<,-6.666666666666671,31,40,<,-9,52,57,<,-5,302,218,>,84
0,18,19.666666666666668,38.0,<,-18.333333333333332,0,0,=,0,37,87,<,-50,47.333333333333336,52.333333333333336,<,-5.0,40,52,<,-12,57,53,>,4,218,255,<,-37
77,18,38.0,19.666666666666668,>,18.333333333333332,0,0,=,0,87,37,>,50,52.333333333333336,47.333333333333336,>,5.0,52,40,>,12,53,57,<,-4,255,218,>,37
0,18,19.666666666666668,40.333333333333336,<,-20.666666666666668,0,0,=,0,37,70,<,-33,47.333333333333336,49.333333333333336,<,-2.0,40,39,>,1,57,59,<,-2,218,236,<,-18
101,18,40.333333333333336,19.666666666666668,>,20.666666666666668,0,0,=,0,70,37,>,33,49.333333333333336,47.333333333333336,>,2.0,39,40,<,-1,59,57,>,2,236,218,>,18
0,18,19.666666666666668,45.666666666666664,<,-25.999999999999996,0,0,=,0,37,74,<,-37,47.333333333333336,41.0,>,6.333333333333336,40,31,>,9,57,46,>,11,218,286,<,-68
92,18,45.666666666666664,19.666666666666668,>,25.999999999999996,0,0,=,0,74,37,>,37,41.0,47.333333333333336,<,-6.333333333333336,31,40,<,-9,46,57,<,-11,286,218,>,68
0,18,19.666666666666668,21.333333333333332,<,-1.6666666666666643,0,0,=,0,37,52,<,-15,47.333333333333336,41.333333333333336,>,6.0,40,31,>,9,57,48,>,9,218,255,<,-37
0,18,21.333333333333332,19.666666666666668,>,1.6666666666666643,0,0,=,0,52,37,>,15,41.333333333333336,47.333333333333336,<,-6.0,31,40,<,-9,48,57,<,-9,255,218,>,37
0,18,19.666666666666668,44.333333333333336,<,-24.666666666666668,0,0,=,0,37,69,<,-32,47.333333333333336,41.666666666666664,>,5.666666666666671,40,34,>,6,57,48,>,9,218,181,>,37
66,18,44.333333333333336,19.666666666666668,>,24.666666666666668,0,0,=,0,69,37,>,32,41.666666666666664,47.333333333333336,<,-5.666666666666671,34,40,<,-6,48,57,<,-9,181,218,<,-37
0,18,19.666666666666668,38.333333333333336,<,-18.666666666666668,0,0,=,0,37,86,<,-49,47.333333333333336,37.666666666666664,>,9.666666666666671,40,32,>,8,57,48,>,9,218,216,>,2
141,18,38.333333333333336,19.666666666666668,>,18.666666666666668,0,0,=,0,86,37,>,49,37.666666666666664,47.333333333333336,<,-9.666666666666671,32,40,<,-8,48,57,<,-9,216,218,<,-2
0,18,19.666666666666668,46.666666666666664,<,-26.999999999999996,0,0,=,0,37,75,<,-38,47.333333333333336,41.0,>,6.333333333333336,40,35,>,5,57,50,>,7,218,319,<,-101
116,18,46.666666666666664,19.666666666666668,>,26.999999999999996,0,0,=,0,75,37,>,38,41.0,47.333333333333336,<,-6.333333333333336,35,40,<,-5,50,57,<,-7,319,218,>,101
0,18,19.666666666666668,47.333333333333336,<,-27.666666666666668,0,0,=,0,37,89,<,-52,47.333333333333336,44.666666666666664,>,2.6666666666666714,40,41,<,-1,57,51,>,6,218,209,>,9
104,18,47.333333333333336,19.666666666666668,>,27.666666666666668,0,0,=,0,89,37,>,52,44.666666666666664,47.333333333333336,<,-2.6666666666666714,41,40,>,1,51,57,<,-6,209,218,<,-9
0,17,49.333333333333336,48.666666666666664,>,0.6666666666666714,12,28,<,-16,84,84,=,0,41.333333333333336,45.666666666666664,<,-4.333333333333329,31,33,<,-2,48,54,<,-6,255,261,<,-6
50,17,48.666666666666664,49.333333333333336,<,-0.6666666666666714,28,12,>,16,84,84,=,0,45.666666666666664,41.333333333333336,>,4.333333333333329,33,31,>,2,54,48,>,6,261,255,>,6
0,17,49.333333333333336,47.333333333333336,>,2.0,12,24,<,-12,84,85,<,-1,41.333333333333336,52.333333333333336,<,-11.0,31,50,<,-19,48,56,<,-8,255,246,>,9
0,17,47.333333333333336,49.333333333333336,<,-2.0,24,12,>,12,85,84,>,1,52.333333333333336,41.333333333333336,>,11.0,50,31,>,19,56,48,>,8,246,255,<,-9
0,17,49.333333333333336,66.66666666666667,<,-17.333333333333336,12,35,<,-23,84,88,<,-4,41.333333333333336,38.0,>,3.3333333333333357,31,34,<,-3,48,43,>,5,255,273,<,-18
85,17,66.66666666666667,49.333333333333336,>,17.333333333333336,35,12,>,23,88,84,>,4,38.0,41.333333333333336,<,-3.3333333333333357,34,31,>,3,43,48,<,-5,273,255,>,18
0,17,49.333333333333336,36.333333333333336,>,13.0,12,12,=,0,84,65,>,19,41.333333333333336,41.666666666666664,<,-0.3333333333333286,31,30,>,1,48,55,<,-7,255,120,>,135
0,17,36.333333333333336,49.333333333333336,<,-13.0,12,12,=,0,65,84,<,-19,41.666666666666664,41.333333333333336,>,0.3333333333333286,30,31,<,-1,55,48,>,7,120,255,<,-135
0,17,49.333333333333336,57.666666666666664,<,-8.333333333333329,12,17,<,-5,84,84,=,0,41.333333333333336,46.333333333333336,<,-5.0,31,41,<,-10,48,51,<,-3,255,295,<,-40
133,17,57.666666666666664,49.333333333333336,>,8.333333333333329,17,12,>,5,84,84,=,0,46.333333333333336,41.333333333333336,>,5.0,41,31,>,10,51,48,>,3,295,255,>,40
0,17,49.333333333333336,64.33333333333333,<,-14.999999999999993,12,47,<,-35,84,78,>,6,41.333333333333336,48.333333333333336,<,-7.0,31,31,=,0,48,60,<,-12,255,286,<,-31
188,17,64.33333333333333,49.333333333333336,>,14.999999999999993,47,12,>,35,78,84,<,-6,48.333333333333336,41.333333333333336,>,7.0,31,31,=,0,60,48,>,12,286,255,>,31
0,17,49.333333333333336,37.666666666666664,>,11.666666666666671,12,16,<,-4,84,55,>,29,41.333333333333336,52.666666666666664,<,-11.333333333333329,31,50,<,-19,48,56,<,-8,255,235,>,20
43,17,37.666666666666664,49.333333333333336,<,-11.666666666666671,16,12,>,4,55,84,<,-29,52.666666666666664,41.333333333333336,>,11.333333333333329,50,31,>,19,56,48,>,8,235,255,<,-20
0,17,49.333333333333336,40.666666666666664,>,8.666666666666671,12,31,<,-19,84,51,>,33,41.333333333333336,46.0,<,-4.666666666666664,31,33,<,-2,48,54,<,-6,255,277,<,-22
94,17,40.666666666666664,49.333333333333336,<,-8.666666666666671,31,12,>,19,51,84,<,-33,46.0,41.333333333333336,>,4.666666666666664,33,31,>,2,54,48,>,6,277,255,>,22
0,17,49.333333333333336,50.0,<,-0.6666666666666643,12,17,<,-5,84,69,>,15,41.333333333333336,41.666666666666664,<,-0.3333333333333286,31,34,<,-3,48,48,=,0,255,181,>,74
77,17,50.0,49.333333333333336,>,0.6666666666666643,17,12,>,5,69,84,<,-15,41.666666666666664,41.333333333333336,>,0.3333333333333286,34,31,>,3,48,48,=,0,181,255,<,-74
0,17,49.333333333333336,52.0,<,-2.6666666666666643,12,45,<,-33,84,56,>,28,41.333333333333336,40.666666666666664,>,0.6666666666666714,31,31,=,0,48,52,<,-4,255,302,<,-47
106,17,52.0,49.333333333333336,>,2.6666666666666643,45,12,>,33,56,84,<,-28,40.666666666666664,41.333333333333336,<,-0.6666666666666714,31,31,=,0,52,48,>,4,302,255,>,47
0,17,49.333333333333336,65.33333333333333,<,-15.999999999999993,12,27,<,-15,84,87,<,-3,41.333333333333336,52.333333333333336,<,-11.0,31,52,<,-21,48,53,<,-5,255,255,=,0
104,17,65.33333333333333,49.333333333333336,>,15.999999999999993,27,12,>,15,87,84,>,3,52.333333333333336,41.333333333333336,>,11.0,52,31,>,21,53,48,>,5,255,255,=,0
0,17,49.333333333333336,71.0,<,-21.666666666666664,12,63,<,-51,84,76,>,8,41.333333333333336,41.0,>,0.3333333333333357,31,31,=,0,48,46,>,2,255,286,<,-31
206,17,71.0,49.333333333333336,>,21.666666666666664,63,12,>,51,76,84,<,-8,41.0,41.333333333333336,<,-0.3333333333333357,31,31,=,0,46,48,<,-2,286,255,>,31
0,17,49.333333333333336,63.333333333333336,<,-14.0,12,51,<,-39,84,70,>,14,41.333333333333336,49.333333333333336,<,-8.0,31,39,<,-8,48,59,<,-11,255,236,>,19
172,17,63.333333333333336,49.333333333333336,>,14.0,51,12,>,39,70,84,<,-14,49.333333333333336,41.333333333333336,>,8.0,39,31,>,8,59,48,>,11,236,255,<,-19
0,17,49.333333333333336,65.33333333333333,<,-15.999999999999993,12,53,<,-41,84,89,<,-5,41.333333333333336,44.666666666666664,<,-3.3333333333333286,31,41,<,-10,48,51,<,-3,255,209,>,46
163,17,65.33333333333333,49.333333333333336,>,15.999999999999993,53,12,>,41,89,84,>,5,44.666666666666664,41.333333333333336,>,3.3333333333333286,41,31,>,10,51,48,>,3,209,255,<,-46
0,17,49.333333333333336,65.0,<,-15.666666666666664,12,55,<,-43,84,75,>,9,41.333333333333336,41.0,>,0.3333333333333357,31,35,<,-4,48,50,<,-2,255,319,<,-64
213,17,65.0,49.333333333333336,>,15.666666666666664,55,12,>,43,75,84,<,-9,41.0,41.333333333333336,<,-0.3333333333333357,35,31,>,4,50,48,>,2,319,255,>,64
0,17,49.333333333333336,48.333333333333336,>,1.0,12,29,<,-17,84,86,<,-2,41.333333333333336,37.666666666666664,>,3.6666666666666714,31,32,<,-1,48,48,=,0,255,216,>,39
146,17,48.333333333333336,49.333333333333336,<,-1.0,29,12,>,17,86,84,>,2,37.666666666666664,41.333333333333336,<,-3.6666666666666714,32,31,>,1,48,48,=,0,216,255,<,-39
0,16,63.0,39.666666666666664,>,23.333333333333336,24,12,>,12,85,65,>,20,52.333333333333336,41.666666666666664,>,10.666666666666671,50,30,>,20,56,55,>,1,246,120,>,126
0,16,39.666666666666664,63.0,<,-23.333333333333336,12,24,<,-12,65,85,<,-20,41.666666666666664,52.333333333333336,<,-10.666666666666671,30,50,<,-20,55,56,<,-1,120,246,<,-126
0,16,63.0,35.666666666666664,>,27.333333333333336,24,16,>,8,85,49,>,36,52.333333333333336,52.666666666666664,<,-0.3333333333333286,50,50,=,0,56,56,=,0,246,235,>,11
43,16,35.666666666666664,63.0,<,-27.333333333333336,16,24,<,-8,49,85,<,-36,52.666666666666664,52.333333333333336,>,0.3333333333333286,50,50,=,0,56,56,=,0,235,246,<,-11
0,16,63.0,42.666666666666664,>,20.333333333333336,24,28,<,-4,85,66,>,19,52.333333333333336,45.666666666666664,>,6.666666666666671,50,33,>,17,56,54,>,2,246,261,<,-15
50,16,42.666666666666664,63.0,<,-20.333333333333336,28,24,>,4,66,85,<,-19,45.666666666666664,52.333333333333336,<,-6.666666666666671,33,50,<,-17,54,56,<,-2,261,246,>,15
0,16,63.0,37.0,>,26.0,24,17,>,7,85,64,>,21,52.333333333333336,41.666666666666664,>,10.666666666666671,50,34,>,16,56,48,>,8,246,181,>,65
77,16,37.0,63.0,<,-26.0,17,24,<,-7,64,85,<,-21,41.666666666666664,52.333333333333336,<,-10.666666666666671,34,50,<,-16,48,56,<,-8,181,246,<,-65
0,16,63.0,73.0,<,-10.0,24,54,<,-30,85,88,<,-3,52.333333333333336,38.0,>,14.333333333333336,50,34,>,16,56,43,>,13,246,273,<,-27
121,16,73.0,63.0,>,10.0,54,24,>,30,88,85,>,3,38.0,52.333333333333336,<,-14.333333333333336,34,50,<,-16,43,56,<,-13,273,246,>,27
0,16,63.0,52.666666666666664,>,10.333333333333336,24,31,<,-7,85,87,<,-2,52.333333333333336,46.0,>,6.333333333333336,50,33,>,17,56,54,>,2,246,277,<,-31
94,16,52.666666666666664,63.0,<,-10.333333333333336,31,24,>,7,87,85,>,2,46.0,52.333333333333336,<,-6.333333333333336,33,50,<,-17,54,56,<,-2,277,246,>,31
0,16,63.0,57.666666666666664,>,5.333333333333336,24,27,<,-3,85,82,>,3,52.333333333333336,52.333333333333336,=,0.0,50,52,<,-2,56,53,>,3,246,255,<,-9
104,16,57.666666666666664,63.0,<,-5.333333333333336,27,24,>,3,82,85,<,-3,52.333333333333336,52.333333333333336,=,0.0,52,50,>,2,53,56,<,-3,255,246,>,9
0,16,63.0,61.0,>,2.0,24,55,<,-31,85,72,>,13,52.333333333333336,40.666666666666664,>,11.666666666666671,50,31,>,19,56,52,>,4,246,302,<,-56
106,16,61.0,63.0,<,-2.0,55,24,>,31,72,85,<,-13,40.666666666666664,52.333333333333336,<,-11.666666666666671,31,50,<,-19,52,56,<,-4,302,246,>,56
0,16,63.0,44.666666666666664,>,18.333333333333336,24,17,>,7,85,84,>,1,52.333333333333336,46.333333333333336,>,6.0,50,41,>,9,56,51,>,5,246,295,<,-49
68,16,44.666666666666664,63.0,<,-18.333333333333336,17,24,<,-7,84,85,<,-1,46.333333333333336,52.333333333333336,<,-6.0,41,50,<,-9,51,56,<,-5,295,246,>,49
0,16,63.0,23.0,>,40.0,24,10,>,14,85,30,>,55,52.333333333333336,37.666666666666664,>,14.666666666666671,50,32,>,18,56,48,>,8,246,216,>,30
0,16,23.0,63.0,<,-40.0,10,24,<,-14,30,85,<,-55,37.666666666666664,52.333333333333336,<,-14.666666666666671,32,50,<,-18,48,56,<,-8,216,246,<,-30
0,16,63.0,54.666666666666664,>,8.333333333333336,24,21,>,3,85,89,<,-4,52.333333333333336,44.666666666666664,>,7.666666666666671,50,41,>,9,56,51,>,5,246,209,>,37
163,16,54.666666666666664,63.0,<,-8.333333333333336,21,24,<,-3,89,85,>,4,44.666666666666664,52.333333333333336,<,-7.666666666666671,41,50,<,-9,51,56,<,-5,209,246,<,-37
0,16,63.0,66.66666666666667,<,-3.6666666666666714,24,51,<,-27,85,80,>,5,52.333333333333336,49.333333333333336,>,3.0,50,39,>,11,56,59,<,-3,246,236,>,10
194,16,66.66666666666667,63.0,>,3.6666666666666714,51,24,>,27,80,85,<,-5,49.333333333333336,52.333333333333336,<,-3.0,39,50,<,-11,59,56,>,3,236,246,<,-10
0,16,63.0,57.333333333333336,>,5.666666666666664,24,26,<,-2,85,78,>,7,52.333333333333336,48.333333333333336,>,4.0,50,31,>,19,56,60,<,-4,246,286,<,-40
153,16,57.333333333333336,63.0,<,-5.666666666666664,26,24,>,2,78,85,<,-7,48.333333333333336,52.333333333333336,<,-4.0,31,50,<,-19,60,56,>,4,286,246,>,40
0,16,63.0,66.33333333333333,<,-3.3333333333333286,24,49,<,-25,85,76,>,9,52.333333333333336,41.0,>,11.333333333333336,50,31,>,19,56,46,>,10,246,286,<,-40
173,16,66.33333333333333,63.0,>,3.3333333333333286,49,24,>,25,76,85,<,-9,41.0,52.333333333333336,<,-11.333333333333336,31,50,<,-19,46,56,<,-10,286,246,>,40
0,16,63.0,65.33333333333333,<,-2.3333333333333286,24,55,<,-31,85,76,>,9,52.333333333333336,41.0,>,11.333333333333336,50,35,>,15,56,50,>,6,246,319,<,-73
213,16,65.33333333333333,63.0,>,2.3333333333333286,55,24,>,31,76,85,<,-9,41.0,52.333333333333336,<,-11.333333333333336,35,50,<,-15,50,56,<,-6,319,246,>,73
0,15,32.0,39.666666666666664,<,-7.666666666666664,12,10,>,2,42,80,<,-38,41.666666666666664,37.666666666666664,>,4.0,30,32,<,-2,55,48,>,7,120,216,<,-96
0,15,39.666666666666664,32.0,>,7.666666666666664,10,12,<,-2,80,42,>,38,37.666666666666664,41.666666666666664,<,-4.0,32,30,>,2,48,55,<,-7,216,120,>,96
0,15,32.0,48.0,<,-16.0,12,42,<,-30,42,53,<,-11,41.666666666666664,52.666666666666664,<,-11.0,30,50,<,-20,55,56,<,-1,120,235,<,-115
126,15,48.0,32.0,>,16.0,42,12,>,30,53,42,>,11,52.666666666666664,41.666666666666664,>,11.0,50,30,>,20,56,55,>,1,235,120,>,115
0,15,32.0,36.666666666666664,<,-4.666666666666664,12,10,>,2,42,66,<,-24,41.666666666666664,45.666666666666664,<,-4.0,30,33,<,-3,55,54,>,1,120,261,<,-141
0,15,36.666666666666664,32.0,>,4.666666666666664,10,12,<,-2,66,42,>,24,45.666666666666664,41.666666666666664,>,4.0,33,30,>,3,54,55,<,-1,261,120,>,141
0,15,32.0,23.0,>,9.0,12,17,<,-5,42,33,>,9,41.666666666666664,46.333333333333336,<,-4.666666666666671,30,41,<,-11,55,51,>,4,120,295,<,-175
68,15,23.0,32.0,<,-9.0,17,12,>,5,33,42,<,-9,46.333333333333336,41.666666666666664,>,4.666666666666671,41,30,>,11,51,55,<,-4,295,120,>,175
0,15,32.0,52.666666666666664,<,-20.666666666666664,12,30,<,-18,42,64,<,-22,41.666666666666664,41.666666666666664,=,0.0,30,34,<,-4,55,48,>,7,120,181,<,-61
199,15,52.666666666666664,32.0,>,20.666666666666664,30,12,>,18,64,42,>,22,41.666666666666664,41.666666666666664,=,0.0,34,30,>,4,48,55,<,-7,181,120,>,61
0,15,32.0,54.0,<,-22.0,12,31,<,-19,42,87,<,-45,41.666666666666664,46.0,<,-4.333333333333336,30,33,<,-3,55,54,>,1,120,277,<,-157
133,15,54.0,32.0,>,22.0,31,12,>,19,87,42,>,45,46.0,41.666666666666664,>,4.333333333333336,33,30,>,3,54,55,<,-1,277,120,>,157
0,15,32.0,41.333333333333336,<,-9.333333333333336,12,27,<,-15,42,64,<,-22,41.666666666666664,52.333333333333336,<,-10.666666666666671,30,52,<,-22,55,53,>,2,120,255,<,-135
83,15,41.333333333333336,32.0,>,9.333333333333336,27,12,>,15,64,42,>,22,52.333333333333336,41.666666666666664,>,10.666666666666671,52,30,>,22,53,55,<,-2,255,120,>,135
0,15,32.0,72.0,<,-40.0,12,56,<,-44,42,88,<,-46,41.666666666666664,40.666666666666664,>,1.0,30,31,<,-1,55,52,>,3,120,302,<,-182
229,15,72.0,32.0,>,40.0,56,12,>,44,88,42,>,46,40.666666666666664,41.666666666666664,<,-1.0,31,30,>,1,52,55,<,-3,302,120,>,182
0,15,32.0,76.33333333333333,<,-44.33333333333333,12,54,<,-42,42,88,<,-46,41.666666666666664,38.0,>,3.6666666666666643,30,34,<,-4,55,43,>,12,120,273,<,-153
121,15,76.33333333333333,32.0,>,44.33333333333333,54,12,>,42,88,42,>,46,38.0,41.666666666666664,<,-3.6666666666666643,34,30,>,4,43,55,<,-12,273,120,>,153
0,15,32.0,53.666666666666664,<,-21.666666666666664,12,26,<,-14,42,78,<,-36,41.666666666666664,48.333333333333336,<,-6.666666666666671,30,31,<,-1,55,60,<,-5,120,286,<,-166
153,15,53.666666666666664,32.0,>,21.666666666666664,26,12,>,14,78,42,>,36,48.333333333333336,41.666666666666664,>,6.666666666666671,31,30,>,1,60,55,>,5,286,120,>,166
0,15,32.0,48.666666666666664,<,-16.666666666666664,12,21,<,-9,42,89,<,-47,41.666666666666664,44.666666666666664,<,-3.0,30,41,<,-11,55,51,>,4,120,209,<,-89
149,15,48.666666666666664,32.0,>,16.666666666666664,21,12,>,9,89,42,>,47,44.666666666666664,41.666666666666664,>,3.0,41,30,>,11,51,55,<,-4,209,120,>,89
0,15,32.0,70.0,<,-38.0,12,49,<,-37,42,87,<,-45,41.666666666666664,41.0,>,0.6666666666666643,30,31,<,-1,55,46,>,9,120,286,<,-166
173,15,70.0,32.0,>,38.0,49,12,>,37,87,42,>,45,41.0,41.666666666666664,<,-0.6666666666666643,31,30,>,1,46,55,<,-9,286,120,>,166
0,15,32.0,73.66666666666667,<,-41.66666666666667,12,51,<,-39,42,90,<,-48,41.666666666666664,49.333333333333336,<,-7.666666666666671,30,39,<,-9,55,59,<,-4,120,236,<,-116
167,15,73.66666666666667,32.0,>,41.66666666666667,51,12,>,39,90,42,>,48,49.333333333333336,41.666666666666664,>,7.666666666666671,39,30,>,9,59,55,>,4,236,120,>,116
0,15,32.0,65.0,<,-33.0,12,54,<,-42,42,76,<,-34,41.666666666666664,41.0,>,0.6666666666666643,30,35,<,-5,55,50,>,5,120,319,<,-199
248,15,65.0,32.0,>,33.0,54,12,>,42,76,42,>,34,41.0,41.666666666666664,<,-0.6666666666666643,35,30,>,5,50,55,<,-5,319,120,>,199
0,14,38.666666666666664,46.666666666666664,<,-8.0,10,10,=,0,66,80,<,-14,45.666666666666664,37.666666666666664,>,8.0,33,32,>,1,54,48,>,6,261,216,>,45
0,14,46.666666666666664,38.666666666666664,>,8.0,10,10,=,0,80,66,>,14,37.666666666666664,45.666666666666664,<,-8.0,32,33,<,-1,48,54,<,-6,216,261,<,-45
0,14,38.666666666666664,27.333333333333332,>,11.333333333333332,10,19,<,-9,66,33,>,33,45.666666666666664,46.333333333333336,<,-0.6666666666666714,33,41,<,-8,54,51,>,3,261,295,<,-34
68,14,27.333333333333332,38.666666666666664,<,-11.333333333333332,19,10,>,9,33,66,<,-33,46.333333333333336,45.666666666666664,>,0.6666666666666714,41,33,>,8,51,54,<,-3,295,261,>,34
0,14,38.666666666666664,47.0,<,-8.333333333333336,10,33,<,-23,66,64,>,2,45.666666666666664,52.333333333333336,<,-6.666666666666671,33,52,<,-19,54,53,>,1,261,255,>,6
83,14,47.0,38.666666666666664,>,8.333333333333336,33,10,>,23,64,66,<,-2,52.333333333333336,45.666666666666664,>,6.666666666666671,52,33,>,19,53,54,<,-1,255,261,<,-6
0,14,38.666666666666664,65.33333333333333,<,-26.666666666666664,10,54,<,-44,66,87,<,-21,45.666666666666664,38.0,>,7.666666666666664,33,34,<,-1,54,43,>,11,261,273,<,-12
121,14,65.33333333333333,38.666666666666664,>,26.666666666666664,54,10,>,44,87,66,>,21,38.0,45.666666666666664,<,-7.666666666666664,34,33,>,1,43,54,<,-11,273,261,>,12
0,14,38.666666666666664,57.0,<,-18.333333333333336,10,49,<,-39,66,69,<,-3,45.666666666666664,52.666666666666664,<,-7.0,33,50,<,-17,54,56,<,-2,261,235,>,26
126,14,57.0,38.666666666666664,>,18.333333333333336,49,10,>,39,69,66,>,3,52.666666666666664,45.666666666666664,>,7.0,50,33,>,17,56,54,>,2,235,261,<,-26
0,14,38.666666666666664,59.333333333333336,<,-20.66666666666667,10,44,<,-34,66,87,<,-21,45.666666666666664,46.0,<,-0.3333333333333357,33,33,=,0,54,54,=,0,261,277,<,-16
133,14,59.333333333333336,38.666666666666664,>,20.66666666666667,44,10,>,34,87,66,>,21,46.0,45.666666666666664,>,0.3333333333333357,33,33,=,0,54,54,=,0,277,261,>,16
0,14,38.666666666666664,22.333333333333332,>,16.333333333333332,10,10,=,0,66,36,>,30,45.666666666666664,44.666666666666664,>,1.0,33,41,<,-8,54,51,>,3,261,209,>,52
0,14,22.333333333333332,38.666666666666664,<,-16.333333333333332,10,10,=,0,36,66,<,-30,44.666666666666664,45.666666666666664,<,-1.0,41,33,>,8,51,54,<,-3,209,261,<,-52
0,14,38.666666666666664,35.0,>,3.6666666666666643,10,22,<,-12,66,57,>,9,45.666666666666664,48.333333333333336,<,-2.6666666666666714,33,31,>,2,54,60,<,-6,261,286,<,-25
153,14,35.0,38.666666666666664,<,-3.6666666666666643,22,10,>,12,57,66,<,-9,48.333333333333336,45.666666666666664,>,2.6666666666666714,31,33,<,-2,60,54,>,6,286,261,>,25
0,14,38.666666666666664,86.66666666666667,<,-48.00000000000001,10,80,<,-70,66,90,<,-24,45.666666666666664,49.333333333333336,<,-3.6666666666666714,33,39,<,-6,54,59,<,-5,261,236,>,25
167,14,86.66666666666667,38.666666666666664,>,48.00000000000001,80,10,>,70,90,66,>,24,49.333333333333336,45.666666666666664,>,3.6666666666666714,39,33,>,6,59,54,>,5,236,261,<,-25
0,14,38.666666666666664,52.0,<,-13.333333333333336,10,20,<,-10,66,87,<,-21,45.666666666666664,41.0,>,4.666666666666664,33,31,>,2,54,46,>,8,261,286,<,-25
164,14,52.0,38.666666666666664,>,13.333333333333336,20,10,>,10,87,66,>,21,41.0,45.666666666666664,<,-4.666666666666664,31,33,<,-2,46,54,<,-8,286,261,>,25
0,14,38.666666666666664,52.666666666666664,<,-14.0,10,30,<,-20,66,64,>,2,45.666666666666664,41.666666666666664,>,4.0,33,34,<,-1,54,48,>,6,261,181,>,80
208,14,52.666666666666664,38.666666666666664,>,14.0,30,10,>,20,64,66,<,-2,41.666666666666664,45.666666666666664,<,-4.0,34,33,>,1,48,54,<,-6,181,261,<,-80
0,14,38.666666666666664,66.33333333333333,<,-27.666666666666664,10,39,<,-29,66,88,<,-22,45.666666666666664,40.666666666666664,>,5.0,33,31,>,2,54,52,>,2,261,302,<,-41
173,14,66.33333333333333,38.666666666666664,>,27.666666666666664,39,10,>,29,88,66,>,22,40.666666666666664,45.666666666666664,<,-5.0,31,33,<,-2,52,54,<,-2,302,261,>,41
0,14,38.666666666666664,64.0,<,-25.333333333333336,10,54,<,-44,66,76,<,-10,45.666666666666664,41.0,>,4.666666666666664,33,35,<,-2,54,50,>,4,261,319,<,-58
248,14,64.0,38.666666666666664,>,25.333333333333336,54,10,>,44,76,66,>,10,41.0,45.666666666666664,<,-4.666666666666664,35,33,>,2,50,54,<,-4,319,261,>,58
0,13,26.666666666666668,48.333333333333336,<,-21.666666666666668,10,10,=,0,49,85,<,-36,44.666666666666664,37.666666666666664,>,7.0,41,32,>,9,51,48,>,3,209,216,<,-7
0,13,48.333333333333336,26.666666666666668,>,21.666666666666668,10,10,=,0,85,49,>,36,37.666666666666664,44.666666666666664,<,-7.0,32,41,<,-9,48,51,<,-3,216,209,>,7
0,13,26.666666666666668,42.666666666666664,<,-15.999999999999996,10,30,<,-20,49,65,<,-16,44.666666666666664,46.333333333333336,<,-1.6666666666666714,41,41,=,0,51,51,=,0,209,295,<,-86
68,13,42.666666666666664,26.666666666666668,>,15.999999999999996,30,10,>,20,65,49,>,16,46.333333333333336,44.666666666666664,>,1.6666666666666714,41,41,=,0,51,51,=,0,295,209,>,86
0,13,26.666666666666668,51.666666666666664,<,-24.999999999999996,10,44,<,-34,49,64,<,-15,44.666666666666664,52.333333333333336,<,-7.666666666666671,41,52,<,-11,51,53,<,-2,209,255,<,-46
89,13,51.666666666666664,26.666666666666668,>,24.999999999999996,44,10,>,34,64,49,>,15,52.333333333333336,44.666666666666664,>,7.666666666666671,52,41,>,11,53,51,>,2,255,209,>,46
0,13,26.666666666666668,63.333333333333336,<,-36.66666666666667,10,54,<,-44,49,81,<,-32,44.666666666666664,38.0,>,6.666666666666664,41,34,>,7,51,43,>,8,209,273,<,-64
121,13,63.333333333333336,26.666666666666668,>,36.66666666666667,54,10,>,44,81,49,>,32,38.0,44.666666666666664,<,-6.666666666666664,34,41,<,-7,43,51,<,-8,273,209,>,64
0,13,26.666666666666668,45.666666666666664,<,-18.999999999999996,10,19,<,-9,49,69,<,-20,44.666666666666664,52.666666666666664,<,-8.0,41,50,<,-9,51,56,<,-5,209,235,<,-26
0,13,45.666666666666664,26.666666666666668,>,18.999999999999996,19,10,>,9,69,49,>,20,52.666666666666664,44.666666666666664,>,8.0,50,41,>,9,56,51,>,5,235,209,>,26
0,13,26.666666666666668,69.0,<,-42.33333333333333,10,47,<,-37,49,87,<,-38,44.666666666666664,46.0,<,-1.3333333333333357,41,33,>,8,51,54,<,-3,209,277,<,-68
144,13,69.0,26.666666666666668,>,42.33333333333333,47,10,>,37,87,49,>,38,46.0,44.666666666666664,>,1.3333333333333357,33,41,<,-8,54,51,>,3,277,209,>,68
0,13,26.666666666666668,19.666666666666668,>,7.0,10,11,<,-1,49,26,>,23,44.666666666666664,48.333333333333336,<,-3.6666666666666714,41,31,>,10,51,60,<,-9,209,286,<,-77
45,13,19.666666666666668,26.666666666666668,<,-7.0,11,10,>,1,26,49,<,-23,48.333333333333336,44.666666666666664,>,3.6666666666666714,31,41,<,-10,60,51,>,9,286,209,>,77
0,13,26.666666666666668,27.0,<,-0.33333333333333215,10,12,<,-2,49,49,=,0,44.666666666666664,41.0,>,3.6666666666666643,41,31,>,10,51,46,>,5,209,286,<,-77
139,13,27.0,26.666666666666668,>,0.33333333333333215,12,10,>,2,49,49,=,0,41.0,44.666666666666664,<,-3.6666666666666643,31,41,<,-10,46,51,<,-5,286,209,>,77
0,13,26.666666666666668,64.66666666666667,<,-38.0,10,24,<,-14,49,90,<,-41,44.666666666666664,49.333333333333336,<,-4.666666666666671,41,39,>,2,51,59,<,-8,209,236,<,-27
115,13,64.66666666666667,26.666666666666668,>,38.0,24,10,>,14,90,49,>,41,49.333333333333336,44.666666666666664,>,4.666666666666671,39,41,<,-2,59,51,>,8,236,209,>,27
0,13,26.666666666666668,60.0,<,-33.33333333333333,10,39,<,-29,49,72,<,-23,44.666666666666664,40.666666666666664,>,4.0,41,31,>,10,51,52,<,-1,209,302,<,-93
173,13,60.0,26.666666666666668,>,33.33333333333333,39,10,>,29,72,49,>,23,40.666666666666664,44.666666666666664,<,-4.0,31,41,<,-10,52,51,>,1,302,209,>,93
0,13,26.666666666666668,40.666666666666664,<,-13.999999999999996,10,28,<,-18,49,64,<,-15,44.666666666666664,41.666666666666664,>,3.0,41,34,>,7,51,48,>,3,209,181,>,28
208,13,40.666666666666664,26.666666666666668,>,13.999999999999996,28,10,>,18,64,49,>,15,41.666666666666664,44.666666666666664,<,-3.0,34,41,<,-7,48,51,<,-3,181,209,<,-28
0,13,26.666666666666668,52.0,<,-25.333333333333332,10,18,<,-8,49,76,<,-27,44.666666666666664,41.0,>,3.6666666666666643,41,35,>,6,51,50,>,1,209,319,<,-110
155,13,52.0,26.666666666666668,>,25.333333333333332,18,10,>,8,76,49,>,27,41.0,44.666666666666664,<,-3.6666666666666643,35,41,<,-6,50,51,<,-1,319,209,>,110
0,12,54.666666666666664,46.333333333333336,>,8.333333333333329,10,19,<,-9,85,71,>,14,37.666666666666664,52.666666666666664,<,-15.0,32,50,<,-18,48,56,<,-8,216,235,<,-19
0,12,46.333333333333336,54.666666666666664,<,-8.333333333333329,19,10,>,9,71,85,<,-14,52.666666666666664,37.666666666666664,>,15.0,50,32,>,18,56,48,>,8,235,216,>,19
0,12,54.666666666666664,30.333333333333332,>,24.333333333333332,10,11,<,-1,85,54,>,31,37.666666666666664,48.333333333333336,<,-10.666666666666671,32,31,>,1,48,60,<,-12,216,286,<,-70
45,12,30.333333333333332,54.666666666666664,<,-24.333333333333332,11,10,>,1,54,85,<,-31,48.333333333333336,37.666666666666664,>,10.666666666666671,31,32,<,-1,60,48,>,12,286,216,>,70
0,12,54.666666666666664,55.666666666666664,<,-1.0,10,33,<,-23,85,69,>,16,37.666666666666664,46.333333333333336,<,-8.666666666666671,32,41,<,-9,48,51,<,-3,216,295,<,-79
68,12,55.666666666666664,54.666666666666664,>,1.0,33,10,>,23,69,85,<,-16,46.333333333333336,37.666666666666664,>,8.666666666666671,41,32,>,9,51,48,>,3,295,216,>,79
0,12,54.666666666666664,49.0,>,5.666666666666664,10,36,<,-26,85,64,>,21,37.666666666666664,52.333333333333336,<,-14.666666666666671,32,52,<,-20,48,53,<,-5,216,255,<,-39
89,12,49.0,54.666666666666664,<,-5.666666666666664,36,10,>,26,64,85,<,-21,52.333333333333336,37.666666666666664,>,14.666666666666671,52,32,>,20,53,48,>,5,255,216,>,39
0,12,54.666666666666664,44.0,>,10.666666666666664,10,24,<,-14,85,80,>,5,37.666666666666664,49.333333333333336,<,-11.666666666666671,32,39,<,-7,48,59,<,-11,216,236,<,-20
115,12,44.0,54.666666666666664,<,-10.666666666666664,24,10,>,14,80,85,<,-5,49.333333333333336,37.666666666666664,>,11.666666666666671,39,32,>,7,59,48,>,11,236,216,>,20
0,12,54.666666666666664,71.33333333333333,<,-16.666666666666664,10,54,<,-44,85,81,>,4,37.666666666666664,38.0,<,-0.3333333333333357,32,34,<,-2,48,43,>,5,216,273,<,-57
121,12,71.33333333333333,54.666666666666664,>,16.666666666666664,54,10,>,44,81,85,<,-4,38.0,37.666666666666664,>,0.3333333333333357,34,32,>,2,43,48,<,-5,273,216,>,57
0,12,54.666666666666664,25.0,>,29.666666666666664,10,12,<,-2,85,49,>,36,37.666666666666664,41.0,<,-3.3333333333333357,32,31,>,1,48,46,>,2,216,286,<,-70
95,12,25.0,54.666666666666664,<,-29.666666666666664,12,10,>,2,49,85,<,-36,41.0,37.666666666666664,>,3.3333333333333357,31,32,<,-1,46,48,<,-2,286,216,>,70
0,12,54.666666666666664,58.333333333333336,<,-3.6666666666666714,10,15,<,-5,85,87,<,-2,37.666666666666664,46.0,<,-8.333333333333336,32,33,<,-1,48,54,<,-6,216,277,<,-61
140,12,58.333333333333336,54.666666666666664,>,3.6666666666666714,15,10,>,5,87,85,>,2,46.0,37.666666666666664,>,8.333333333333336,33,32,>,1,54,48,>,6,277,216,>,61
0,12,54.666666666666664,60.0,<,-5.333333333333336,10,18,<,-8,85,86,<,-1,37.666666666666664,41.0,<,-3.3333333333333357,32,35,<,-3,48,50,<,-2,216,319,<,-103
155,12,60.0,54.666666666666664,>,5.333333333333336,18,10,>,8,86,85,>,1,41.0,37.666666666666664,>,3.3333333333333357,35,32,>,3,50,48,>,2,319,216,>,103
0,12,54.666666666666664,53.333333333333336,>,1.3333333333333286,10,19,<,-9,85,72,>,13,37.666666666666664,40.666666666666664,<,-3.0,32,31,>,1,48,52,<,-4,216,302,<,-86
61,12,53.333333333333336,54.666666666666664,<,-1.3333333333333286,19,10,>,9,72,85,<,-13,40.666666666666664,37.666666666666664,>,3.0,31,32,<,-1,52,48,>,4,302,216,>,86
0,12,54.666666666666664,22.666666666666668,>,31.999999999999996,10,10,=,0,85,30,>,55,37.666666666666664,41.666666666666664,<,-4.0,32,34,<,-2,48,48,=,0,216,181,>,35
0,12,22.666666666666668,54.666666666666664,<,-31.999999999999996,10,10,=,0,30,85,<,-55,41.666666666666664,37.666666666666664,>,4.0,34,32,>,2,48,48,=,0,181,216,<,-35
0,11,27.666666666666668,45.333333333333336,<,-17.666666666666668,10,19,<,-9,45,71,<,-26,41.666666666666664,52.666666666666664,<,-11.0,34,50,<,-16,48,56,<,-8,181,235,<,-54
0,11,45.333333333333336,27.666666666666668,>,17.666666666666668,19,10,>,9,71,45,>,26,52.666666666666664,41.666666666666664,>,11.0,50,34,>,16,56,48,>,8,235,181,>,54
0,11,27.666666666666668,33.333333333333336,<,-5.666666666666668,10,11,<,-1,45,54,<,-9,41.666666666666664,48.333333333333336,<,-6.666666666666671,34,31,>,3,48,60,<,-12,181,286,<,-105
45,11,33.333333333333336,27.666666666666668,>,5.666666666666668,11,10,>,1,54,45,>,9,48.333333333333336,41.666666666666664,>,6.666666666666671,31,34,<,-3,60,48,>,12,286,181,>,105
0,11,27.666666666666668,42.0,<,-14.333333333333332,10,19,<,-9,45,69,<,-24,41.666666666666664,40.666666666666664,>,1.0,34,31,>,3,48,52,<,-4,181,302,<,-121
61,11,42.0,27.666666666666668,>,14.333333333333332,19,10,>,9,69,45,>,24,40.666666666666664,41.666666666666664,<,-1.0,31,34,<,-3,52,48,>,4,302,181,>,121
0,11,27.666666666666668,67.0,<,-39.33333333333333,10,65,<,-55,45,69,<,-24,41.666666666666664,46.333333333333336,<,-4.666666666666671,34,41,<,-7,48,51,<,-3,181,295,<,-114
153,11,67.0,27.666666666666668,>,39.33333333333333,65,10,>,55,69,45,>,24,46.333333333333336,41.666666666666664,>,4.666666666666671,41,34,>,7,51,48,>,3,295,181,>,114
0,11,27.666666666666668,52.333333333333336,<,-24.666666666666668,10,36,<,-26,45,74,<,-29,41.666666666666664,52.333333333333336,<,-10.666666666666671,34,52,<,-18,48,53,<,-5,181,255,<,-74
89,11,52.333333333333336,27.666666666666668,>,24.666666666666668,36,10,>,26,74,45,>,29,52.333333333333336,41.666666666666664,>,10.666666666666671,52,34,>,18,53,48,>,5,255,181,>,74
0,11,27.666666666666668,17.0,>,10.666666666666668,10,12,<,-2,45,25,>,20,41.666666666666664,41.0,>,0.6666666666666643,34,31,>,3,48,46,>,2,181,286,<,-105
76,11,17.0,27.666666666666668,<,-10.666666666666668,12,10,>,2,25,45,<,-20,41.0,41.666666666666664,<,-0.6666666666666643,31,34,<,-3,46,48,<,-2,286,181,>,105
0,11,27.666666666666668,30.666666666666668,<,-3.0,10,24,<,-14,45,40,>,5,41.666666666666664,49.333333333333336,<,-7.666666666666671,34,39,<,-5,48,59,<,-11,181,236,<,-55
68,11,30.666666666666668,27.666666666666668,>,3.0,24,10,>,14,40,45,<,-5,49.333333333333336,41.666666666666664,>,7.666666666666671,39,34,>,5,59,48,>,11,236,181,>,55
0,11,27.666666666666668,59.333333333333336,<,-31.666666666666668,10,18,<,-8,45,81,<,-36,41.666666666666664,38.0,>,3.6666666666666643,34,34,=,0,48,43,>,5,181,273,<,-92
0,11,59.333333333333336,27.666666666666668,>,31.666666666666668,18,10,>,8,81,45,>,36,38.0,41.666666666666664,<,-3.6666666666666643,34,34,=,0,43,48,<,-5,273,181,>,92
0,11,27.666666666666668,56.666666666666664,<,-28.999999999999996,10,15,<,-5,45,82,<,-37,41.666666666666664,46.0,<,-4.333333333333336,34,33,>,1,48,54,<,-6,181,277,<,-96
140,11,56.666666666666664,27.666666666666668,>,28.999999999999996,15,10,>,5,82,45,>,37,46.0,41.666666666666664,>,4.333333333333336,33,34,<,-1,54,48,>,6,277,181,>,96
0,11,27.666666666666668,40.0,<,-12.333333333333332,10,16,<,-6,45,86,<,-41,41.666666666666664,41.0,>,0.6666666666666643,34,35,<,-1,48,50,<,-2,181,319,<,-138
107,11,40.0,27.666666666666668,>,12.333333333333332,16,10,>,6,86,45,>,41,41.0,41.666666666666664,<,-0.6666666666666643,35,34,>,1,50,48,>,2,319,181,>,138
0,10,43.0,27.333333333333332,>,15.666666666666668,18,17,>,1,81,46,>,35,38.0,52.666666666666664,<,-14.666666666666664,34,50,<,-16,43,56,<,-13,273,235,>,38
0,10,27.333333333333332,43.0,<,-15.666666666666668,17,18,<,-1,46,81,<,-35,52.666666666666664,38.0,>,14.666666666666664,50,34,>,16,56,43,>,13,235,273,<,-38
0,10,43.0,26.333333333333332,>,16.666666666666668,18,11,>,7,81,35,>,46,38.0,48.333333333333336,<,-10.333333333333336,34,31,>,3,43,60,<,-17,273,286,<,-13
45,10,26.333333333333332,43.0,<,-16.666666666666668,11,18,<,-7,35,81,<,-46,48.333333333333336,38.0,>,10.333333333333336,31,34,<,-3,60,43,>,17,286,273,>,13
0,10,43.0,54.666666666666664,<,-11.666666666666664,18,38,<,-20,81,69,>,12,38.0,40.666666666666664,<,-2.6666666666666643,34,31,>,3,43,52,<,-9,273,302,<,-29
106,10,54.666666666666664,43.0,>,11.666666666666664,38,18,>,20,69,81,<,-12,40.666666666666664,38.0,>,2.6666666666666643,31,34,<,-3,52,43,>,9,302,273,>,29
0,10,43.0,48.333333333333336,<,-5.333333333333336,18,24,<,-6,81,81,=,0,38.0,49.333333333333336,<,-11.333333333333336,34,39,<,-5,43,59,<,-16,273,236,>,37
68,10,48.333333333333336,43.0,>,5.333333333333336,24,18,>,6,81,81,=,0,49.333333333333336,38.0,>,11.333333333333336,39,34,>,5,59,43,>,16,236,273,<,-37
0,10,43.0,36.666666666666664,>,6.333333333333336,18,12,>,6,81,73,>,8,38.0,41.0,<,-3.0,34,31,>,3,43,46,<,-3,273,286,<,-13
76,10,36.666666666666664,43.0,<,-6.333333333333336,12,18,<,-6,73,81,<,-8,41.0,38.0,>,3.0,31,34,<,-3,46,43,>,3,286,273,>,13
0,10,43.0,49.0,<,-6.0,18,26,<,-8,81,74,>,7,38.0,52.333333333333336,<,-14.333333333333336,34,52,<,-18,43,53,<,-10,273,255,>,18
18,10,49.0,43.0,>,6.0,26,18,>,8,74,81,<,-7,52.333333333333336,38.0,>,14.333333333333336,52,34,>,18,53,43,>,10,255,273,<,-18
0,10,43.0,25.0,>,18.0,18,16,>,2,81,41,>,40,38.0,41.0,<,-3.0,34,35,<,-1,43,50,<,-7,273,319,<,-46
88,10,25.0,43.0,<,-18.0,16,18,<,-2,41,81,<,-40,41.0,38.0,>,3.0,35,34,>,1,50,43,>,7,319,273,>,46
0,10,43.0,72.0,<,-29.0,18,61,<,-43,81,82,<,-1,38.0,46.0,<,-8.0,34,33,>,1,43,54,<,-11,273,277,<,-4
143,10,72.0,43.0,>,29.0,61,18,>,43,82,81,>,1,46.0,38.0,>,8.0,33,34,<,-1,54,43,>,11,277,273,>,4
0,10,43.0,53.333333333333336,<,-10.333333333333336,18,28,<,-10,81,67,>,14,38.0,46.333333333333336,<,-8.333333333333336,34,41,<,-7,43,51,<,-8,273,295,<,-22
0,10,53.333333333333336,43.0,>,10.333333333333336,28,18,>,10,67,81,<,-14,46.333333333333336,38.0,>,8.333333333333336,41,34,>,7,51,43,>,8,295,273,>,22
0,9,45.0,41.0,>,4.0,28,17,>,11,65,87,<,-22,46.333333333333336,52.666666666666664,<,-6.333333333333329,41,50,<,-9,51,56,<,-5,295,235,>,60
0,9,41.0,45.0,<,-4.0,17,28,<,-11,87,65,>,22,52.666666666666664,46.333333333333336,>,6.333333333333329,50,41,>,9,56,51,>,5,235,295,<,-60
0,9,45.0,32.0,>,13.0,28,23,>,5,65,47,>,18,46.333333333333336,52.333333333333336,<,-6.0,41,52,<,-11,51,53,<,-2,295,255,>,40
18,9,32.0,45.0,<,-13.0,23,28,<,-5,47,65,<,-18,52.333333333333336,46.333333333333336,>,6.0,52,41,>,11,53,51,>,2,255,295,<,-40
0,9,45.0,35.666666666666664,>,9.333333333333336,28,11,>,17,65,63,>,2,46.333333333333336,48.333333333333336,<,-2.0,41,31,>,10,51,60,<,-9,295,286,>,9
45,9,35.666666666666664,45.0,<,-9.333333333333336,11,28,<,-17,63,65,<,-2,48.333333333333336,46.333333333333336,>,2.0,31,41,<,-10,60,51,>,9,286,295,<,-9
0,9,45.0,40.0,>,5.0,28,15,>,13,65,81,<,-16,46.333333333333336,49.333333333333336,<,-3.0,41,39,>,2,51,59,<,-8,295,236,>,59
0,9,40.0,45.0,<,-5.0,15,28,<,-13,81,65,>,16,49.333333333333336,46.333333333333336,>,3.0,39,41,<,-2,59,51,>,8,236,295,<,-59
0,9,45.0,43.333333333333336,>,1.6666666666666643,28,12,>,16,65,73,<,-8,46.333333333333336,41.0,>,5.333333333333336,41,31,>,10,51,46,>,5,295,286,>,9
137,9,43.333333333333336,45.0,<,-1.6666666666666643,12,28,<,-16,73,65,>,8,41.0,46.333333333333336,<,-5.333333333333336,31,41,<,-10,46,51,<,-5,286,295,<,-9
0,9,45.0,29.333333333333332,>,15.666666666666668,28,18,>,10,65,41,>,24,46.333333333333336,41.0,>,5.333333333333336,41,35,>,6,51,50,>,1,295,319,<,-24
88,9,29.333333333333332,45.0,<,-15.666666666666668,18,28,<,-10,41,65,<,-24,41.0,46.333333333333336,<,-5.333333333333336,35,41,<,-6,50,51,<,-1,319,295,>,24
0,9,45.0,53.0,<,-8.0,28,33,<,-5,65,69,<,-4,46.333333333333336,40.666666666666664,>,5.666666666666671,41,31,>,10,51,52,<,-1,295,302,<,-7
106,9,53.0,45.0,>,8.0,33,28,>,5,69,65,>,4,40.666666666666664,46.333333333333336,<,-5.666666666666671,31,41,<,-10,52,51,>,1,302,295,>,7
0,9,45.0,58.666666666666664,<,-13.666666666666664,28,42,<,-14,65,73,<,-8,46.333333333333336,46.0,>,0.3333333333333357,41,33,>,8,51,54,<,-3,295,277,>,18
143,9,58.666666666666664,45.0,>,13.666666666666664,42,28,>,14,73,65,>,8,46.0,46.333333333333336,<,-0.3333333333333357,33,41,<,-8,54,51,>,3,277,295,<,-18
0,8,35.0,50.333333333333336,<,-15.333333333333336,15,19,<,-4,66,87,<,-21,49.333333333333336,52.666666666666664,<,-3.3333333333333286,39,50,<,-11,59,56,>,3,236,235,>,1
0,8,50.333333333333336,35.0,>,15.333333333333336,19,15,>,4,87,66,>,21,52.666666666666664,49.333333333333336,>,3.3333333333333286,50,39,>,11,56,59,<,-3,235,236,<,-1
0,8,35.0,27.0,>,8.0,15,11,>,4,66,47,>,19,49.333333333333336,52.333333333333336,<,-3.0,39,52,<,-13,59,53,>,6,236,255,<,-19
0,8,27.0,35.0,<,-8.0,11,15,<,-4,47,66,<,-19,52.333333333333336,49.333333333333336,>,3.0,52,39,>,13,53,59,<,-6,255,236,>,19
0,8,35.0,50.666666666666664,<,-15.666666666666664,15,11,>,4,66,78,<,-12,49.333333333333336,48.333333333333336,>,1.0,39,31,>,8,59,60,<,-1,236,286,<,-50
45,8,50.666666666666664,35.0,>,15.666666666666664,11,15,<,-4,78,66,>,12,48.333333333333336,49.333333333333336,<,-1.0,31,39,<,-8,60,59,>,1,286,236,>,50
0,8,35.0,28.0,>,7.0,15,18,<,-3,66,37,>,29,49.333333333333336,41.0,>,8.333333333333336,39,35,>,4,59,50,>,9,236,319,<,-83
76,8,28.0,35.0,<,-7.0,18,15,>,3,37,66,<,-29,41.0,49.333333333333336,<,-8.333333333333336,35,39,<,-4,50,59,<,-9,319,236,>,83
0,8,35.0,55.333333333333336,<,-20.333333333333336,15,33,<,-18,66,69,<,-3,49.333333333333336,40.666666666666664,>,8.666666666666671,39,31,>,8,59,52,>,7,236,302,<,-66
79,8,55.333333333333336,35.0,>,20.333333333333336,33,15,>,18,69,66,>,3,40.666666666666664,49.333333333333336,<,-8.666666666666671,31,39,<,-8,52,59,<,-7,302,236,>,66
0,8,35.0,29.0,>,6.0,15,12,>,3,66,45,>,21,49.333333333333336,41.0,>,8.333333333333336,39,31,>,8,59,46,>,13,236,286,<,-50
70,8,29.0,35.0,<,-6.0,12,15,<,-3,45,66,<,-21,41.0,49.333333333333336,<,-8.333333333333336,31,39,<,-8,46,59,<,-13,286,236,>,50
0,8,35.0,44.333333333333336,<,-9.333333333333336,15,18,<,-3,66,73,<,-7,49.333333333333336,46.0,>,3.3333333333333357,39,33,>,6,59,54,>,5,236,277,<,-41
52,8,44.333333333333336,35.0,>,9.333333333333336,18,15,>,3,73,66,>,7,46.0,49.333333333333336,<,-3.3333333333333357,33,39,<,-6,54,59,<,-5,277,236,>,41
0,7,33.0,49.0,<,-16.0,11,19,<,-8,47,83,<,-36,52.333333333333336,52.666666666666664,<,-0.3333333333333286,52,50,>,2,53,56,<,-3,255,235,>,20
0,7,49.0,33.0,>,16.0,19,11,>,8,83,47,>,36,52.666666666666664,52.333333333333336,>,0.3333333333333286,50,52,<,-2,56,53,>,3,235,255,<,-20
0,7,33.0,44.0,<,-11.0,11,11,=,0,47,78,<,-31,52.333333333333336,48.333333333333336,>,4.0,52,31,>,21,53,60,<,-7,255,286,<,-31
45,7,44.0,33.0,>,11.0,11,11,=,0,78,47,>,31,48.333333333333336,52.333333333333336,<,-4.0,31,52,<,-21,60,53,>,7,286,255,>,31
0,7,33.0,38.666666666666664,<,-5.666666666666664,11,18,<,-7,47,73,<,-26,52.333333333333336,46.0,>,6.333333333333336,52,33,>,19,53,54,<,-1,255,277,<,-22
52,7,38.666666666666664,33.0,>,5.666666666666664,18,11,>,7,73,47,>,26,46.0,52.333333333333336,<,-6.333333333333336,33,52,<,-19,54,53,>,1,277,255,>,22
0,7,33.0,19.0,>,14.0,11,12,<,-1,47,30,>,17,52.333333333333336,41.0,>,11.333333333333336,52,31,>,21,53,46,>,7,255,286,<,-31
0,7,19.0,33.0,<,-14.0,12,11,>,1,30,47,<,-17,41.0,52.333333333333336,<,-11.333333333333336,31,52,<,-21,46,53,<,-7,286,255,>,31
0,7,33.0,28.0,>,5.0,11,18,<,-7,47,37,>,10,52.333333333333336,41.0,>,11.333333333333336,52,35,>,17,53,50,>,3,255,319,<,-64
60,7,28.0,33.0,<,-5.0,18,11,>,7,37,47,<,-10,41.0,52.333333333333336,<,-11.333333333333336,35,52,<,-17,50,53,<,-3,319,255,>,64
0,7,33.0,56.666666666666664,<,-23.666666666666664,11,37,<,-26,47,69,<,-22,52.333333333333336,40.666666666666664,>,11.666666666666671,52,31,>,21,53,52,>,1,255,302,<,-47
63,7,56.666666666666664,33.0,>,23.666666666666664,37,11,>,26,69,47,>,22,40.666666666666664,52.333333333333336,<,-11.666666666666671,31,52,<,-21,52,53,<,-1,302,255,>,47
0,6,14.666666666666666,54.333333333333336,<,-39.66666666666667,12,19,<,-7,17,83,<,-66,41.0,52.666666666666664,<,-11.666666666666664,31,50,<,-19,46,56,<,-10,286,235,>,51
0,6,54.333333333333336,14.666666666666666,>,39.66666666666667,19,12,>,7,83,17,>,66,52.666666666666664,41.0,>,11.666666666666664,50,31,>,19,56,46,>,10,235,286,<,-51
0,6,14.666666666666666,32.0,<,-17.333333333333336,12,11,>,1,17,43,<,-26,41.0,48.333333333333336,<,-7.333333333333336,31,31,=,0,46,60,<,-14,286,286,=,0
45,6,32.0,14.666666666666666,>,17.333333333333336,11,12,<,-1,43,17,>,26,48.333333333333336,41.0,>,7.333333333333336,31,31,=,0,60,46,>,14,286,286,=,0
0,6,14.666666666666666,54.666666666666664,<,-40.0,12,25,<,-13,17,73,<,-56,41.0,46.0,<,-5.0,31,33,<,-2,46,54,<,-8,286,277,>,9
61,6,54.666666666666664,14.666666666666666,>,40.0,25,12,>,13,73,17,>,56,46.0,41.0,>,5.0,33,31,>,2,54,46,>,8,277,286,<,-9
0,6,14.666666666666666,28.666666666666668,<,-14.000000000000002,12,18,<,-6,17,39,<,-22,41.0,41.0,=,0.0,31,35,<,-4,46,50,<,-4,286,319,<,-33
60,6,28.666666666666668,14.666666666666666,>,14.000000000000002,18,12,>,6,39,17,>,22,41.0,41.0,=,0.0,35,31,>,4,50,46,>,4,319,286,>,33
0,6,14.666666666666666,41.333333333333336,<,-26.66666666666667,12,18,<,-6,17,69,<,-52,41.0,40.666666666666664,>,0.3333333333333357,31,31,=,0,46,52,<,-6,286,302,<,-16
0,6,41.333333333333336,14.666666666666666,>,26.66666666666667,18,12,>,6,69,17,>,52,40.666666666666664,41.0,<,-0.3333333333333357,31,31,=,0,52,46,>,6,302,286,>,16
0,5,46.0,54.0,<,-8.0,18,19,<,-1,69,82,<,-13,40.666666666666664,52.666666666666664,<,-12.0,31,50,<,-19,52,56,<,-4,302,235,>,67
0,5,54.0,46.0,>,8.0,19,18,>,1,82,69,>,13,52.666666666666664,40.666666666666664,>,12.0,50,31,>,19,56,52,>,4,235,302,<,-67
0,5,46.0,41.666666666666664,>,4.333333333333336,18,11,>,7,69,72,<,-3,40.666666666666664,48.333333333333336,<,-7.666666666666671,31,31,=,0,52,60,<,-8,302,286,>,16
45,5,41.666666666666664,46.0,<,-4.333333333333336,11,18,<,-7,72,69,>,3,48.333333333333336,40.666666666666664,>,7.666666666666671,31,31,=,0,60,52,>,8,286,302,<,-16
0,5,46.0,22.666666666666668,>,23.333333333333332,18,11,>,7,69,39,>,30,40.666666666666664,41.0,<,-0.3333333333333357,31,35,<,-4,52,50,>,2,302,319,<,-17
0,5,22.666666666666668,46.0,<,-23.333333333333332,11,18,<,-7,39,69,<,-30,41.0,40.666666666666664,>,0.3333333333333357,35,31,>,4,50,52,<,-2,319,302,>,17
0,5,46.0,68.33333333333333,<,-22.33333333333333,18,66,<,-48,69,73,<,-4,40.666666666666664,46.0,<,-5.333333333333336,31,33,<,-2,52,54,<,-2,302,277,>,25
75,5,68.33333333333333,46.0,>,22.33333333333333,66,18,>,48,73,69,>,4,46.0,40.666666666666664,>,5.333333333333336,33,31,>,2,54,52,>,2,277,302,<,-25
0,4,32.0,50.0,<,-18.0,11,19,<,-8,67,82,<,-15,41.0,52.666666666666664,<,-11.666666666666664,35,50,<,-15,50,56,<,-6,319,235,>,84
0,4,50.0,32.0,>,18.0,19,11,>,8,82,67,>,15,52.666666666666664,41.0,>,11.666666666666664,50,35,>,15,56,50,>,6,235,319,<,-84
0,4,32.0,35.0,<,-3.0,11,11,=,0,67,72,<,-5,41.0,48.333333333333336,<,-7.333333333333336,35,31,>,4,50,60,<,-10,319,286,>,33
45,4,35.0,32.0,>,3.0,11,11,=,0,72,67,>,5,48.333333333333336,41.0,>,7.333333333333336,31,35,<,-4,60,50,>,10,286,319,<,-33
0,4,32.0,70.66666666666667,<,-38.66666666666667,11,66,<,-55,67,73,<,-6,41.0,46.0,<,-5.0,35,33,>,2,50,54,<,-4,319,277,>,42
110,4,70.66666666666667,32.0,>,38.66666666666667,66,11,>,55,73,67,>,6,46.0,41.0,>,5.0,33,35,<,-2,54,50,>,4,277,319,<,-42
0,3,43.333333333333336,17.0,>,26.333333333333336,19,11,>,8,62,22,>,40,52.666666666666664,48.333333333333336,>,4.333333333333329,50,31,>,19,56,60,<,-4,235,286,<,-51
45,3,17.0,43.333333333333336,<,-26.333333333333336,11,19,<,-8,22,62,<,-40,48.333333333333336,52.666666666666664,<,-4.333333333333329,31,50,<,-19,60,56,>,4,286,235,>,51
0,3,43.333333333333336,59.666666666666664,<,-16.33333333333333,19,33,<,-14,62,73,<,-11,52.666666666666664,46.0,>,6.666666666666664,50,33,>,17,56,54,>,2,235,277,<,-42
97,3,59.666666666666664,43.333333333333336,>,16.33333333333333,33,19,>,14,73,62,>,11,46.0,52.666666666666664,<,-6.666666666666664,33,50,<,-17,54,56,<,-2,277,235,>,42
0,2,40.333333333333336,24.0,>,16.333333333333336,15,18,<,-3,73,32,>,41,46.0,48.333333333333336,<,-2.3333333333333357,33,31,>,2,54,60,<,-6,277,286,<,-9
70,2,24.0,40.333333333333336,<,-16.333333333333336,18,15,>,3,32,73,<,-41,48.333333333333336,46.0,>,2.3333333333333357,31,33,<,-2,60,54,>,6,286,277,>,9
0,11,0.0,0.0,=,0.0,0,0,=,0,0,0,=,0,41.0,44.0,<,-3.0,31,32,<,-1,46,52,<,-6,67,85,<,-18
24,11,0.0,0.0,=,0.0,0,0,=,0,0,0,=,0,44.0,41.0,>,3.0,32,31,>,1,52,46,>,6,85,67,>,18
0,11,0.0,0.0,=,0.0,0,0,=,0,0,0,=,0,41.0,39.333333333333336,>,1.6666666666666643,31,33,<,-2,46,43,>,3,67,79,<,-12
2,11,0.0,0.0,=,0.0,0,0,=,0,0,0,=,0,39.333333333333336,41.0,<,-1.6666666666666643,33,31,>,2,43,46,<,-3,79,67,>,12
0,11,0.0,0.0,=,0.0,0,0,=,0,0,0,=,0,41.0,38.0,>,3.0,31,32,<,-1,46,46,=,0,67,139,<,-72
28,11,0.0,0.0,=,0.0,0,0,=,0,0,0,=,0,38.0,41.0,<,-3.0,32,31,>,1,46,46,=,0,139,67,>,72
0,11,0.0,0.0,=,0.0,0,0,=,0,0,0,=,0,41.0,48.0,<,-7.0,31,42,<,-11,46,58,<,-12,67,131,<,-64
12,11,0.0,0.0,=,0.0,0,0,=,0,0,0,=,0,48.0,41.0,>,7.0,42,31,>,11,58,46,>,12,131,67,>,64
0,11,0.0,0.0,=,0.0,0,0,=,0,0,0,=,0,41.0,43.333333333333336,<,-2.3333333333333357,31,39,<,-8,46,52,<,-6,67,75,<,-8
19,11,0.0,0.0,=,0.0,0,0,=,0,0,0,=,0,43.333333333333336,41.0,>,2.3333333333333357,39,31,>,8,52,46,>,6,75,67,>,8
0,11,0.0,0.0,=,0.0,0,0,=,0,0,0,=,0,41.0,43.333333333333336,<,-2.3333333333333357,31,42,<,-11,46,45,>,1,67,173,<,-106
63,11,0.0,0.0,=,0.0,0,0,=,0,0,0,=,0,43.333333333333336,41.0,>,2.3333333333333357,42,31,>,11,45,46,<,-1,173,67,>,106
0,11,0.0,0.0,=,0.0,0,0,=,0,0,0,=,0,41.0,41.666666666666664,<,-0.6666666666666643,31,34,<,-3,46,52,<,-6,67,164,<,-97
0,11,0.0,0.0,=,0.0,0,0,=,0,0,0,=,0,41.666666666666664,41.0,>,0.6666666666666643,34,31,>,3,52,46,>,6,164,67,>,97
0,11,0.0,0.0,=,0.0,0,0,=,0,0,0,=,0,41.0,37.666666666666664,>,3.3333333333333357,31,31,=,0,46,41,>,5,67,89,<,-22
0,11,0.0,0.0,=,0.0,0,0,=,0,0,0,=,0,37.666666666666664,41.0,<,-3.3333333333333357,31,31,=,0,41,46,<,-5,89,67,>,22
0,11,0.0,0.0,=,0.0,0,0,=,0,0,0,=,0,41.0,37.333333333333336,>,3.6666666666666643,31,33,<,-2,46,40,>,6,67,132,<,-65
62,11,0.0,0.0,=,0.0,0,0,=,0,0,0,=,0,37.333333333333336,41.0,<,-3.6666666666666643,33,31,>,2,40,46,<,-6,132,67,>,65
0,11,0.0,0.0,=,0.0,0,0,=,0,0,0,=,0,41.0,50.333333333333336,<,-9.333333333333336,31,38,<,-7,46,59,<,-13,67,142,<,-75
55,11,0.0,0.0,=,0.0,0,0,=,0,0,0,=,0,50.333333333333336,41.0,>,9.333333333333336,38,31,>,7,59,46,>,13,142,67,>,75
0,10,27.0,22.0,>,5.0,0,0,=,0,81,66,>,15,41.666666666666664,37.666666666666664,>,4.0,34,31,>,3,52,41,>,11,164,89,>,75
0,10,22.0,27.0,<,-5.0,0,0,=,0,66,81,<,-15,37.666666666666664,41.666666666666664,<,-4.0,31,34,<,-3,41,52,<,-11,89,164,<,-75
0,10,27.0,10.666666666666666,>,16.333333333333336,0,0,=,0,81,32,>,49,41.666666666666664,39.333333333333336,>,2.3333333333333286,34,33,>,1,52,43,>,9,164,79,>,85
2,10,10.666666666666666,27.0,<,-16.333333333333336,0,0,=,0,32,81,<,-49,39.333333333333336,41.666666666666664,<,-2.3333333333333286,33,34,<,-1,43,52,<,-9,79,164,<,-85
0,10,27.0,6.333333333333333,>,20.666666666666668,0,0,=,0,81,19,>,62,41.666666666666664,48.0,<,-6.333333333333336,34,42,<,-8,52,58,<,-6,164,131,>,33
12,10,6.333333333333333,27.0,<,-20.666666666666668,0,0,=,0,19,81,<,-62,48.0,41.666666666666664,>,6.333333333333336,42,34,>,8,58,52,>,6,131,164,<,-33
0,10,27.0,7.0,>,20.0,0,0,=,0,81,21,>,60,41.666666666666664,43.333333333333336,<,-1.6666666666666714,34,39,<,-5,52,52,=,0,164,75,>,89
0,10,7.0,27.0,<,-20.0,0,0,=,0,21,81,<,-60,43.333333333333336,41.666666666666664,>,1.6666666666666714,39,34,>,5,52,52,=,0,75,164,<,-89
0,10,27.0,22.0,>,5.0,0,0,=,0,81,66,>,15,41.666666666666664,44.0,<,-2.3333333333333357,34,32,>,2,52,52,=,0,164,85,>,79
24,10,22.0,27.0,<,-5.0,0,0,=,0,66,81,<,-15,44.0,41.666666666666664,>,2.3333333333333357,32,34,<,-2,52,52,=,0,85,164,<,-79
0,10,27.0,22.333333333333332,>,4.666666666666668,0,0,=,0,81,67,>,14,41.666666666666664,38.0,>,3.6666666666666643,34,32,>,2,52,46,>,6,164,139,>,25
28,10,22.333333333333332,27.0,<,-4.666666666666668,0,0,=,0,67,81,<,-14,38.0,41.666666666666664,<,-3.6666666666666643,32,34,<,-2,46,52,<,-6,139,164,<,-25
0,10,27.0,16.333333333333332,>,10.666666666666668,0,0,=,0,81,49,>,32,41.666666666666664,50.333333333333336,<,-8.666666666666671,34,38,<,-4,52,59,<,-7,164,142,>,22
68,10,16.333333333333332,27.0,<,-10.666666666666668,0,0,=,0,49,81,<,-32,50.333333333333336,41.666666666666664,>,8.666666666666671,38,34,>,4,59,52,>,7,142,164,<,-22
0,10,27.0,21.333333333333332,>,5.666666666666668,0,0,=,0,81,64,>,17,41.666666666666664,37.333333333333336,>,4.333333333333329,34,33,>,1,52,40,>,12,164,132,>,32
84,10,21.333333333333332,27.0,<,-5.666666666666668,0,0,=,0,64,81,<,-17,37.333333333333336,41.666666666666664,<,-4.333333333333329,33,34,<,-1,40,52,<,-12,132,164,<,-32
0,10,27.0,11.0,>,16.0,0,0,=,0,81,33,>,48,41.666666666666664,43.333333333333336,<,-1.6666666666666714,34,42,<,-8,52,45,>,7,164,173,<,-9
63,10,11.0,27.0,<,-16.0,0,0,=,0,33,81,<,-48,43.333333333333336,41.666666666666664,>,1.6666666666666714,42,34,>,8,45,52,<,-7,173,164,>,9
0,9,11.333333333333334,52.0,<,-40.666666666666664,0,0,=,0,21,90,<,-69,43.333333333333336,37.666666666666664,>,5.666666666666671,39,31,>,8,52,41,>,11,75,89,<,-14
0,9,52.0,11.333333333333334,>,40.666666666666664,0,0,=,0,90,21,>,69,37.666666666666664,43.333333333333336,<,-5.666666666666671,31,39,<,-8,41,52,<,-11,89,75,>,14
0,9,11.333333333333334,14.333333333333334,<,-3.0,0,0,=,0,21,32,<,-11,43.333333333333336,39.333333333333336,>,4.0,39,33,>,6,52,43,>,9,75,79,<,-4
0,9,14.333333333333334,11.333333333333334,>,3.0,0,0,=,0,32,21,>,11,39.333333333333336,43.333333333333336,<,-4.0,33,39,<,-6,43,52,<,-9,79,75,>,4
0,9,11.333333333333334,32.0,<,-20.666666666666664,0,0,=,0,21,77,<,-56,43.333333333333336,48.0,<,-4.666666666666664,39,42,<,-3,52,58,<,-6,75,131,<,-56
43,9,32.0,11.333333333333334,>,20.666666666666664,0,0,=,0,77,21,>,56,48.0,43.333333333333336,>,4.666666666666664,42,39,>,3,58,52,>,6,131,75,>,56
0,9,11.333333333333334,35.666666666666664,<,-24.33333333333333,0,0,=,0,21,66,<,-45,43.333333333333336,44.0,<,-0.6666666666666643,39,32,>,7,52,52,=,0,75,85,<,-10
85,9,35.666666666666664,11.333333333333334,>,24.33333333333333,0,0,=,0,66,21,>,45,44.0,43.333333333333336,>,0.6666666666666643,32,39,<,-7,52,52,=,0,85,75,>,10
0,9,11.333333333333334,48.666666666666664,<,-37.33333333333333,0,0,=,0,21,79,<,-58,43.333333333333336,38.0,>,5.333333333333336,39,32,>,7,52,46,>,6,75,139,<,-64
95,9,48.666666666666664,11.333333333333334,>,37.33333333333333,0,0,=,0,79,21,>,58,38.0,43.333333333333336,<,-5.333333333333336,32,39,<,-7,46,52,<,-6,139,75,>,64
0,9,11.333333333333334,24.333333333333332,<,-12.999999999999998,0,0,=,0,21,40,<,-19,43.333333333333336,43.333333333333336,=,0.0,39,42,<,-3,52,45,>,7,75,173,<,-98
96,9,24.333333333333332,11.333333333333334,>,12.999999999999998,0,0,=,0,40,21,>,19,43.333333333333336,43.333333333333336,=,0.0,42,39,>,3,45,52,<,-7,173,75,>,98
0,9,11.333333333333334,29.333333333333332,<,-18.0,0,0,=,0,21,49,<,-28,43.333333333333336,50.333333333333336,<,-7.0,39,38,>,1,52,59,<,-7,75,142,<,-67
142,9,29.333333333333332,11.333333333333334,>,18.0,0,0,=,0,49,21,>,28,50.333333333333336,43.333333333333336,>,7.0,38,39,<,-1,59,52,>,7,142,75,>,67
0,9,11.333333333333334,25.0,<,-13.666666666666666,0,0,=,0,21,64,<,-43,43.333333333333336,37.333333333333336,>,6.0,39,33,>,6,52,40,>,12,75,132,<,-57
57,9,25.0,11.333333333333334,>,13.666666666666666,0,0,=,0,64,21,>,43,37.333333333333336,43.333333333333336,<,-6.0,33,39,<,-6,40,52,<,-12,132,75,>,57
0,8,12.666666666666666,40.0,<,-27.333333333333336,0,0,=,0,27,90,<,-63,39.333333333333336,37.666666666666664,>,1.6666666666666714,33,31,>,2,43,41,>,2,79,89,<,-10
0,8,40.0,12.666666666666666,>,27.333333333333336,0,0,=,0,90,27,>,63,37.666666666666664,39.333333333333336,<,-1.6666666666666714,31,33,<,-2,41,43,<,-2,89,79,>,10
0,8,12.666666666666666,38.333333333333336,<,-25.66666666666667,0,0,=,0,27,77,<,-50,39.333333333333336,48.0,<,-8.666666666666664,33,42,<,-9,43,58,<,-15,79,131,<,-52
44,8,38.333333333333336,12.666666666666666,>,25.66666666666667,0,0,=,0,77,27,>,50,48.0,39.333333333333336,>,8.666666666666664,42,33,>,9,58,43,>,15,131,79,>,52
0,8,12.666666666666666,12.666666666666666,=,0.0,0,0,=,0,27,27,=,0,39.333333333333336,37.333333333333336,>,2.0,33,33,=,0,43,40,>,3,79,132,<,-53
0,8,12.666666666666666,12.666666666666666,=,0.0,0,0,=,0,27,27,=,0,37.333333333333336,39.333333333333336,<,-2.0,33,33,=,0,40,43,<,-3,132,79,>,53
0,8,12.666666666666666,30.666666666666668,<,-18.0,0,0,=,0,27,51,<,-24,39.333333333333336,44.0,<,-4.666666666666664,33,32,>,1,43,52,<,-9,79,85,<,-6
85,8,30.666666666666668,12.666666666666666,>,18.0,0,0,=,0,51,27,>,24,44.0,39.333333333333336,>,4.666666666666664,32,33,<,-1,52,43,>,9,85,79,>,6
0,8,12.666666666666666,45.666666666666664,<,-33.0,0,0,=,0,27,79,<,-52,39.333333333333336,38.0,>,1.3333333333333357,33,32,>,1,43,46,<,-3,79,139,<,-60
53,8,45.666666666666664,12.666666666666666,>,33.0,0,0,=,0,79,27,>,52,38.0,39.333333333333336,<,-1.3333333333333357,32,33,<,-1,46,43,>,3,139,79,>,60
0,8,12.666666666666666,42.0,<,-29.333333333333336,0,0,=,0,27,86,<,-59,39.333333333333336,43.333333333333336,<,-4.0,33,42,<,-9,43,45,<,-2,79,173,<,-94
96,8,42.0,12.666666666666666,>,29.333333333333336,0,0,=,0,86,27,>,59,43.333333333333336,39.333333333333336,>,4.0,42,33,>,9,45,43,>,2,173,79,>,94
0,8,12.666666666666666,25.333333333333332,<,-12.666666666666666,0,0,=,0,27,39,<,-12,39.333333333333336,50.333333333333336,<,-11.0,33,38,<,-5,43,59,<,-16,79,142,<,-63
85,8,25.333333333333332,12.666666666666666,>,12.666666666666666,0,0,=,0,39,27,>,12,50.333333333333336,39.333333333333336,>,11.0,38,33,>,5,59,43,>,16,142,79,>,63
0,7,37.0,16.666666666666668,>,20.333333333333332,0,0,=,0,81,27,>,54,37.666666666666664,37.333333333333336,>,0.3333333333333286,31,33,<,-2,41,40,>,1,89,132,<,-43
0,7,16.666666666666668,37.0,<,-20.333333333333332,0,0,=,0,27,81,<,-54,37.333333333333336,37.666666666666664,<,-0.3333333333333286,33,31,>,2,40,41,<,-1,132,89,>,43
0,7,37.0,31.666666666666668,>,5.333333333333332,0,0,=,0,81,57,>,24,37.666666666666664,48.0,<,-10.333333333333336,31,42,<,-11,41,58,<,-17,89,131,<,-42
44,7,31.666666666666668,37.0,<,-5.333333333333332,0,0,=,0,57,81,<,-24,48.0,37.666666666666664,>,10.333333333333336,42,31,>,11,58,41,>,17,131,89,>,42
0,7,37.0,23.666666666666668,>,13.333333333333332,0,0,=,0,81,58,>,23,37.666666666666664,38.0,<,-0.3333333333333357,31,32,<,-1,41,46,<,-5,89,139,<,-50
0,7,23.666666666666668,37.0,<,-13.333333333333332,0,0,=,0,58,81,<,-23,38.0,37.666666666666664,>,0.3333333333333357,32,31,>,1,46,41,>,5,139,89,>,50
0,7,37.0,37.333333333333336,<,-0.3333333333333357,0,0,=,0,81,61,>,20,37.666666666666664,44.0,<,-6.333333333333336,31,32,<,-1,41,52,<,-11,89,85,>,4
97,7,37.333333333333336,37.0,>,0.3333333333333357,0,0,=,0,61,81,<,-20,44.0,37.666666666666664,>,6.333333333333336,32,31,>,1,52,41,>,11,85,89,<,-4
0,7,37.0,16.0,>,21.0,0,0,=,0,81,37,>,44,37.666666666666664,50.333333333333336,<,-12.666666666666671,31,38,<,-7,41,59,<,-18,89,142,<,-53
71,7,16.0,37.0,<,-21.0,0,0,=,0,37,81,<,-44,50.333333333333336,37.666666666666664,>,12.666666666666671,38,31,>,7,59,41,>,18,142,89,>,53
0,7,37.0,40.333333333333336,<,-3.3333333333333357,0,0,=,0,81,86,<,-5,37.666666666666664,43.333333333333336,<,-5.666666666666671,31,42,<,-11,41,45,<,-4,89,173,<,-84
52,7,40.333333333333336,37.0,>,3.3333333333333357,0,0,=,0,86,81,>,5,43.333333333333336,37.666666666666664,>,5.666666666666671,42,31,>,11,45,41,>,4,173,89,>,84
0,6,36.333333333333336,26.0,>,10.333333333333336,13,23,<,-10,58,28,>,30,38.0,37.333333333333336,>,0.6666666666666643,32,33,<,-1,46,40,>,6,139,132,>,7
0,6,26.0,36.333333333333336,<,-10.333333333333336,23,13,>,10,28,58,<,-30,37.333333333333336,38.0,<,-0.6666666666666643,33,32,>,1,40,46,<,-6,132,139,<,-7
0,6,36.333333333333336,50.666666666666664,<,-14.333333333333329,13,38,<,-25,58,57,>,1,38.0,48.0,<,-10.0,32,42,<,-10,46,58,<,-12,139,131,>,8
44,6,50.666666666666664,36.333333333333336,>,14.333333333333329,38,13,>,25,57,58,<,-1,48.0,38.0,>,10.0,42,32,>,10,58,46,>,12,131,139,<,-8
0,6,36.333333333333336,56.333333333333336,<,-20.0,13,35,<,-22,58,86,<,-28,38.0,43.333333333333336,<,-5.333333333333336,32,42,<,-10,46,45,>,1,139,173,<,-34
52,6,56.333333333333336,36.333333333333336,>,20.0,35,13,>,22,86,58,>,28,43.333333333333336,38.0,>,5.333333333333336,42,32,>,10,45,46,<,-1,173,139,>,34
0,6,36.333333333333336,43.333333333333336,<,-7.0,13,11,>,2,58,82,<,-24,38.0,50.333333333333336,<,-12.333333333333336,32,38,<,-6,46,59,<,-13,139,142,<,-3
71,6,43.333333333333336,36.333333333333336,>,7.0,11,13,<,-2,82,58,>,24,50.333333333333336,38.0,>,12.333333333333336,38,32,>,6,59,46,>,13,142,139,>,3
0,6,36.333333333333336,43.0,<,-6.666666666666664,13,17,<,-4,58,61,<,-3,38.0,44.0,<,-6.0,32,32,=,0,46,52,<,-6,139,85,>,54
0,6,43.0,36.333333333333336,>,6.666666666666664,17,13,>,4,61,58,>,3,44.0,38.0,>,6.0,32,32,=,0,52,46,>,6,85,139,<,-54
0,5,34.666666666666664,39.0,<,-4.333333333333336,17,27,<,-10,51,62,<,-11,44.0,37.333333333333336,>,6.666666666666664,32,33,<,-1,52,40,>,12,85,132,<,-47
0,5,39.0,34.666666666666664,>,4.333333333333336,27,17,>,10,62,51,>,11,37.333333333333336,44.0,<,-6.666666666666664,33,32,>,1,40,52,<,-12,132,85,>,47
0,5,34.666666666666664,52.333333333333336,<,-17.66666666666667,17,38,<,-21,51,62,<,-11,44.0,48.0,<,-4.0,32,42,<,-10,52,58,<,-6,85,131,<,-46
41,5,52.333333333333336,34.666666666666664,>,17.66666666666667,38,17,>,21,62,51,>,11,48.0,44.0,>,4.0,42,32,>,10,58,52,>,6,131,85,>,46
0,5,34.666666666666664,55.333333333333336,<,-20.66666666666667,17,32,<,-15,51,86,<,-35,44.0,43.333333333333336,>,0.6666666666666643,32,42,<,-10,52,45,>,7,85,173,<,-88
34,5,55.333333333333336,34.666666666666664,>,20.66666666666667,32,17,>,15,86,51,>,35,43.333333333333336,44.0,<,-0.6666666666666643,42,32,>,10,45,52,<,-7,173,85,>,88
0,5,34.666666666666664,63.0,<,-28.333333333333336,17,37,<,-20,51,82,<,-31,44.0,50.333333333333336,<,-6.333333333333336,32,38,<,-6,52,59,<,-7,85,142,<,-57
112,5,63.0,34.666666666666664,>,28.333333333333336,37,17,>,20,82,51,>,31,50.333333333333336,44.0,>,6.333333333333336,38,32,>,6,59,52,>,7,142,85,>,57
0,4,47.333333333333336,54.666666666666664,<,-7.333333333333329,27,32,<,-5,62,86,<,-24,37.333333333333336,43.333333333333336,<,-6.0,33,42,<,-9,40,45,<,-5,132,173,<,-41
34,4,54.666666666666664,47.333333333333336,>,7.333333333333329,32,27,>,5,86,62,>,24,43.333333333333336,37.333333333333336,>,6.0,42,33,>,9,45,40,>,5,173,132,>,41
0,4,47.333333333333336,55.0,<,-7.666666666666664,27,38,<,-11,62,65,<,-3,37.333333333333336,48.0,<,-10.666666666666664,33,42,<,-9,40,58,<,-18,132,131,>,1
41,4,55.0,47.333333333333336,>,7.666666666666664,38,27,>,11,65,62,>,3,48.0,37.333333333333336,>,10.666666666666664,42,33,>,9,58,40,>,18,131,132,<,-1
0,4,47.333333333333336,42.0,>,5.333333333333336,27,19,>,8,62,70,<,-8,37.333333333333336,50.333333333333336,<,-13.0,33,38,<,-5,40,59,<,-19,132,142,<,-10
0,4,42.0,47.333333333333336,<,-5.333333333333336,19,27,<,-8,70,62,>,8,50.333333333333336,37.333333333333336,>,13.0,38,33,>,5,59,40,>,19,142,132,>,10
0,3,46.0,40.0,>,6.0,19,32,<,-13,70,46,>,24,50.333333333333336,43.333333333333336,>,7.0,38,42,<,-4,59,45,>,14,142,173,<,-31
34,3,40.0,46.0,<,-6.0,32,19,>,13,46,70,<,-24,43.333333333333336,50.333333333333336,<,-7.0,42,38,>,4,45,59,<,-14,173,142,>,31
0,3,46.0,48.666666666666664,<,-2.6666666666666643,19,19,=,0,70,65,>,5,50.333333333333336,48.0,>,2.3333333333333357,38,42,<,-4,59,58,>,1,142,131,>,11
0,3,48.666666666666664,46.0,>,2.6666666666666643,19,19,=,0,65,70,<,-5,48.0,50.333333333333336,<,-2.3333333333333357,42,38,>,4,58,59,<,-1,131,142,<,-11
0,2,33.666666666666664,28.333333333333332,>,5.333333333333332,19,11,>,8,62,42,>,20,48.0,43.333333333333336,>,4.666666666666664,42,42,=,0,58,45,>,13,131,173,<,-42
0,2,28.333333333333332,33.666666666666664,<,-5.333333333333332,11,19,<,-8,42,62,<,-20,43.333333333333336,48.0,<,-4.666666666666664,42,42,=,0,45,58,<,-13,173,131,>,42
0,17,0.0,0.0,=,0.0,0,0,=,0,0,0,=,0,49.666666666666664,37.666666666666664,>,12.0,49,32,>,17,50,41,>,9,129,106,>,23
44,17,0.0,0.0,=,0.0,0,0,=,0,0,0,=,0,37.666666666666664,49.666666666666664,<,-12.0,32,49,<,-17,41,50,<,-9,106,129,<,-23
0,17,0.0,0.0,=,0.0,0,0,=,0,0,0,=,0,49.666666666666664,57.0,<,-7.333333333333336,49,52,<,-3,50,60,<,-10,129,247,<,-118
126,17,0.0,0.0,=,0.0,0,0,=,0,0,0,=,0,57.0,49.666666666666664,>,7.333333333333336,52,49,>,3,60,50,>,10,247,129,>,118
0,17,0.0,0.0,=,0.0,0,0,=,0,0,0,=,0,49.666666666666664,37.333333333333336,>,12.333333333333329,49,30,>,19,50,44,>,6,129,201,<,-72
113,17,0.0,0.0,=,0.0,0,0,=,0,0,0,=,0,37.333333333333336,49.666666666666664,<,-12.333333333333329,30,49,<,-19,44,50,<,-6,201,129,>,72
0,17,0.0,0.0,=,0.0,0,0,=,0,0,0,=,0,49.666666666666664,36.0,>,13.666666666666664,49,31,>,18,50,44,>,6,129,171,<,-42
11,17,0.0,0.0,=,0.0,0,0,=,0,0,0,=,0,36.0,49.666666666666664,<,-13.666666666666664,31,49,<,-18,44,50,<,-6,171,129,>,42
0,17,0.0,0.0,=,0.0,0,0,=,0,0,0,=,0,49.666666666666664,43.333333333333336,>,6.333333333333329,49,38,>,11,50,53,<,-3,129,218,<,-89
64,17,0.0,0.0,=,0.0,0,0,=,0,0,0,=,0,43.333333333333336,49.666666666666664,<,-6.333333333333329,38,49,<,-11,53,50,>,3,218,129,>,89
0,17,0.0,0.0,=,0.0,0,0,=,0,0,0,=,0,49.666666666666664,34.0,>,15.666666666666664,49,30,>,19,50,38,>,12,129,197,<,-68
71,17,0.0,0.0,=,0.0,0,0,=,0,0,0,=,0,34.0,49.666666666666664,<,-15.666666666666664,30,49,<,-19,38,50,<,-12,197,129,>,68
0,17,0.0,0.0,=,0.0,0,0,=,0,0,0,=,0,49.666666666666664,47.333333333333336,>,2.3333333333333286,49,42,>,7,50,57,<,-7,129,180,<,-51
48,17,0.0,0.0,=,0.0,0,0,=,0,0,0,=,0,47.333333333333336,49.666666666666664,<,-2.3333333333333286,42,49,<,-7,57,50,>,7,180,129,>,51
0,17,0.0,0.0,=,0.0,0,0,=,0,0,0,=,0,49.666666666666664,45.333333333333336,>,4.333333333333329,49,31,>,18,50,56,<,-6,129,189,<,-60
12,17,0.0,0.0,=,0.0,0,0,=,0,0,0,=,0,45.333333333333336,49.666666666666664,<,-4.333333333333329,31,49,<,-18,56,50,>,6,189,129,>,60
0,17,0.0,0.0,=,0.0,0,0,=,0,0,0,=,0,49.666666666666664,52.333333333333336,<,-2.6666666666666714,49,47,>,2,50,59,<,-9,129,114,>,15
0,17,0.0,0.0,=,0.0,0,0,=,0,0,0,=,0,52.333333333333336,49.666666666666664,>,2.6666666666666714,47,49,<,-2,59,50,>,9,114,129,<,-15
0,17,0.0,0.0,=,0.0,0,0,=,0,0,0,=,0,49.666666666666664,37.0,>,12.666666666666664,49,32,>,17,50,41,>,9,129,149,<,-20
38,17,0.0,0.0,=,0.0,0,0,=,0,0,0,=,0,37.0,49.666666666666664,<,-12.666666666666664,32,49,<,-17,41,50,<,-9,149,129,>,20
0,17,0.0,0.0,=,0.0,0,0,=,0,0,0,=,0,49.666666666666664,47.0,>,2.6666666666666643,49,34,>,15,50,58,<,-8,129,98,>,31
12,17,0.0,0.0,=,0.0,0,0,=,0,0,0,=,0,47.0,49.666666666666664,<,-2.6666666666666643,34,49,<,-15,58,50,>,8,98,129,<,-31
0,17,0.0,0.0,=,0.0,0,0,=,0,0,0,=,0,49.666666666666664,51.0,<,-1.3333333333333357,49,38,>,11,50,59,<,-9,129,199,<,-70
35,17,0.0,0.0,=,0.0,0,0,=,0,0,0,=,0,51.0,49.666666666666664,>,1.3333333333333357,38,49,<,-11,59,50,>,9,199,129,>,70
0,17,0.0,0.0,=,0.0,0,0,=,0,0,0,=,0,49.666666666666664,49.0,>,0.6666666666666643,49,44,>,5,50,52,<,-2,129,197,<,-68
79,17,0.0,0.0,=,0.0,0,0,=,0,0,0,=,0,49.0,49.666666666666664,<,-0.6666666666666643,44,49,<,-5,52,50,>,2,197,129,>,68
0,17,0.0,0.0,=,0.0,0,0,=,0,0,0,=,0,49.666666666666664,40.666666666666664,>,9.0,49,33,>,16,50,45,>,5,129,255,<,-126
106,17,0.0,0.0,=,0.0,0,0,=,0,0,0,=,0,40.666666666666664,49.666666666666664,<,-9.0,33,49,<,-16,45,50,<,-5,255,129,>,126
0,17,0.0,0.0,=,0.0,0,0,=,0,0,0,=,0,49.666666666666664,44.333333333333336,>,5.333333333333329,49,37,>,12,50,50,=,0,129,220,<,-91
98,17,0.0,0.0,=,0.0,0,0,=,0,0,0,=,0,44.333333333333336,49.666666666666664,<,-5.333333333333329,37,49,<,-12,50,50,=,0,220,129,>,91
0,17,0.0,0.0,=,0.0,0,0,=,0,0,0,=,0,49.666666666666664,38.0,>,11.666666666666664,49,33,>,16,50,41,>,9,129,92,>,37
24,17,0.0,0.0,=,0.0,0,0,=,0,0,0,=,0,38.0,49.666666666666664,<,-11.666666666666664,33,49,<,-16,41,50,<,-9,92,129,<,-37
0,16,17.0,12.666666666666666,>,4.333333333333334,0,0,=,0,51,38,>,13,52.333333333333336,36.0,>,16.333333333333336,47,31,>,16,59,44,>,15,114,171,<,-57
35,16,12.666666666666666,17.0,<,-4.333333333333334,0,0,=,0,38,51,<,-13,36.0,52.333333333333336,<,-16.333333333333336,31,47,<,-16,44,59,<,-15,171,114,>,57
0,16,17.0,9.0,>,8.0,0,0,=,0,51,27,>,24,52.333333333333336,45.333333333333336,>,7.0,47,31,>,16,59,56,>,3,114,189,<,-75
21,16,9.0,17.0,<,-8.0,0,0,=,0,27,51,<,-24,45.333333333333336,52.333333333333336,<,-7.0,31,47,<,-16,56,59,<,-3,189,114,>,75
0,16,17.0,6.666666666666667,>,10.333333333333332,0,0,=,0,51,20,>,31,52.333333333333336,47.0,>,5.333333333333336,47,34,>,13,59,58,>,1,114,98,>,16
0,16,6.666666666666667,17.0,<,-10.333333333333332,0,0,=,0,20,51,<,-31,47.0,52.333333333333336,<,-5.333333333333336,34,47,<,-13,58,59,<,-1,98,114,<,-16
0,16,17.0,7.666666666666667,>,9.333333333333332,0,0,=,0,51,23,>,28,52.333333333333336,38.0,>,14.333333333333336,47,33,>,14,59,41,>,18,114,92,>,22
0,16,7.666666666666667,17.0,<,-9.333333333333332,0,0,=,0,23,51,<,-28,38.0,52.333333333333336,<,-14.333333333333336,33,47,<,-14,41,59,<,-18,92,114,<,-22
0,16,17.0,29.333333333333332,<,-12.333333333333332,0,0,=,0,51,88,<,-37,52.333333333333336,51.0,>,1.3333333333333357,47,38,>,9,59,59,=,0,114,199,<,-85
55,16,29.333333333333332,17.0,>,12.333333333333332,0,0,=,0,88,51,>,37,51.0,52.333333333333336,<,-1.3333333333333357,38,47,<,-9,59,59,=,0,199,114,>,85
0,16,17.0,9.0,>,8.0,0,0,=,0,51,27,>,24,52.333333333333336,37.0,>,15.333333333333336,47,32,>,15,59,41,>,18,114,149,<,-35
53,16,9.0,17.0,<,-8.0,0,0,=,0,27,51,<,-24,37.0,52.333333333333336,<,-15.333333333333336,32,47,<,-15,41,59,<,-18,149,114,>,35
0,16,17.0,24.333333333333332,<,-7.333333333333332,0,0,=,0,51,73,<,-22,52.333333333333336,37.666666666666664,>,14.666666666666671,47,32,>,15,59,41,>,18,114,106,>,8
44,16,24.333333333333332,17.0,>,7.333333333333332,0,0,=,0,73,51,>,22,37.666666666666664,52.333333333333336,<,-14.666666666666671,32,47,<,-15,41,59,<,-18,106,114,<,-8
0,16,17.0,6.0,>,11.0,0,0,=,0,51,18,>,33,52.333333333333336,47.333333333333336,>,5.0,47,42,>,5,59,57,>,2,114,180,<,-66
0,16,6.0,17.0,<,-11.0,0,0,=,0,18,51,<,-33,47.333333333333336,52.333333333333336,<,-5.0,42,47,<,-5,57,59,<,-2,180,114,>,66
0,16,17.0,4.0,>,13.0,0,0,=,0,51,12,>,39,52.333333333333336,43.333333333333336,>,9.0,47,38,>,9,59,53,>,6,114,218,<,-104
66,16,4.0,17.0,<,-13.0,0,0,=,0,12,51,<,-39,43.333333333333336,52.333333333333336,<,-9.0,38,47,<,-9,53,59,<,-6,218,114,>,104
0,16,17.0,21.666666666666668,<,-4.666666666666668,0,0,=,0,51,65,<,-14,52.333333333333336,34.0,>,18.333333333333336,47,30,>,17,59,38,>,21,114,197,<,-83
86,16,21.666666666666668,17.0,>,4.666666666666668,0,0,=,0,65,51,>,14,34.0,52.333333333333336,<,-18.333333333333336,30,47,<,-17,38,59,<,-21,197,114,>,83
0,16,17.0,18.0,<,-1.0,0,0,=,0,51,54,<,-3,52.333333333333336,49.0,>,3.3333333333333357,47,44,>,3,59,52,>,7,114,197,<,-83
79,16,18.0,17.0,>,1.0,0,0,=,0,54,51,>,3,49.0,52.333333333333336,<,-3.3333333333333357,44,47,<,-3,52,59,<,-7,197,114,>,83
0,16,17.0,20.333333333333332,<,-3.333333333333332,0,0,=,0,51,61,<,-10,52.333333333333336,44.333333333333336,>,8.0,47,37,>,10,59,50,>,9,114,220,<,-106
98,16,20.333333333333332,17.0,>,3.333333333333332,0,0,=,0,61,51,>,10,44.333333333333336,52.333333333333336,<,-8.0,37,47,<,-10,50,59,<,-9,220,114,>,106
0,16,17.0,11.0,>,6.0,0,0,=,0,51,33,>,18,52.333333333333336,40.666666666666664,>,11.666666666666671,47,33,>,14,59,45,>,14,114,255,<,-141
107,16,11.0,17.0,<,-6.0,0,0,=,0,33,51,<,-18,40.666666666666664,52.333333333333336,<,-11.666666666666671,33,47,<,-14,45,59,<,-14,255,114,>,141
0,16,17.0,18.0,<,-1.0,0,0,=,0,51,54,<,-3,52.333333333333336,37.333333333333336,>,15.0,47,30,>,17,59,44,>,15,114,201,<,-87
139,16,18.0,17.0,>,1.0,0,0,=,0,54,51,>,3,37.333333333333336,52.333333333333336,<,-15.0,30,47,<,-17,44,59,<,-15,201,114,>,87
0,16,17.0,24.0,<,-7.0,0,0,=,0,51,72,<,-21,52.333333333333336,57.0,<,-4.666666666666664,47,52,<,-5,59,60,<,-1,114,247,<,-133
121,16,24.0,17.0,>,7.0,0,0,=,0,72,51,>,21,57.0,52.333333333333336,>,4.666666666666664,52,47,>,5,60,59,>,1,247,114,>,133
0,15,13.0,29.333333333333332,<,-16.333333333333332,0,0,=,0,21,68,<,-47,47.333333333333336,47.0,>,0.3333333333333357,42,34,>,8,57,58,<,-1,180,98,>,82
0,15,29.333333333333332,13.0,>,16.333333333333332,0,0,=,0,68,21,>,47,47.0,47.333333333333336,<,-0.3333333333333357,34,42,<,-8,58,57,>,1,98,180,<,-82
0,15,13.0,27.333333333333332,<,-14.333333333333332,0,0,=,0,21,59,<,-38,47.333333333333336,38.0,>,9.333333333333336,42,33,>,9,57,41,>,16,180,92,>,88
0,15,27.333333333333332,13.0,>,14.333333333333332,0,0,=,0,59,21,>,38,38.0,47.333333333333336,<,-9.333333333333336,33,42,<,-9,41,57,<,-16,92,180,<,-88
0,15,13.0,18.0,<,-5.0,0,0,=,0,21,27,<,-6,47.333333333333336,45.333333333333336,>,2.0,42,31,>,11,57,56,>,1,180,189,<,-9
21,15,18.0,13.0,>,5.0,0,0,=,0,27,21,>,6,45.333333333333336,47.333333333333336,<,-2.0,31,42,<,-11,56,57,<,-1,189,180,>,9
0,15,13.0,23.333333333333332,<,-10.333333333333332,0,0,=,0,21,38,<,-17,47.333333333333336,36.0,>,11.333333333333336,42,31,>,11,57,44,>,13,180,171,>,9
66,15,23.333333333333332,13.0,>,10.333333333333332,0,0,=,0,38,21,>,17,36.0,47.333333333333336,<,-11.333333333333336,31,42,<,-11,44,57,<,-13,171,180,<,-9
0,15,13.0,29.666666666666668,<,-16.666666666666668,0,0,=,0,21,73,<,-52,47.333333333333336,37.666666666666664,>,9.666666666666671,42,32,>,10,57,41,>,16,180,106,>,74
0,15,29.666666666666668,13.0,>,16.666666666666668,0,0,=,0,73,21,>,52,37.666666666666664,47.333333333333336,<,-9.666666666666671,32,42,<,-10,41,57,<,-16,106,180,<,-74
0,15,13.0,34.333333333333336,<,-21.333333333333336,0,0,=,0,21,76,<,-55,47.333333333333336,37.0,>,10.333333333333336,42,32,>,10,57,41,>,16,180,149,>,31
53,15,34.333333333333336,13.0,>,21.333333333333336,0,0,=,0,76,21,>,55,37.0,47.333333333333336,<,-10.333333333333336,32,42,<,-10,41,57,<,-16,149,180,<,-31
0,15,13.0,58.666666666666664,<,-45.666666666666664,0,0,=,0,21,88,<,-67,47.333333333333336,51.0,<,-3.6666666666666643,42,38,>,4,57,59,<,-2,180,199,<,-19
120,15,58.666666666666664,13.0,>,45.666666666666664,0,0,=,0,88,21,>,67,51.0,47.333333333333336,>,3.6666666666666643,38,42,<,-4,59,57,>,2,199,180,>,19
0,15,13.0,10.666666666666666,>,2.333333333333334,0,0,=,0,21,20,>,1,47.333333333333336,43.333333333333336,>,4.0,42,38,>,4,57,53,>,4,180,218,<,-38
66,15,10.666666666666666,13.0,<,-2.333333333333334,0,0,=,0,20,21,<,-1,43.333333333333336,47.333333333333336,<,-4.0,38,42,<,-4,53,57,<,-4,218,180,>,38
0,15,13.0,36.333333333333336,<,-23.333333333333336,0,0,=,0,21,55,<,-34,47.333333333333336,49.0,<,-1.6666666666666643,42,44,<,-2,57,52,>,5,180,197,<,-17
52,15,36.333333333333336,13.0,>,23.333333333333336,0,0,=,0,55,21,>,34,49.0,47.333333333333336,>,1.6666666666666643,44,42,>,2,52,57,<,-5,197,180,>,17
0,15,13.0,33.666666666666664,<,-20.666666666666664,0,0,=,0,21,65,<,-44,47.333333333333336,34.0,>,13.333333333333336,42,30,>,12,57,38,>,19,180,197,<,-17
65,15,33.666666666666664,13.0,>,20.666666666666664,0,0,=,0,65,21,>,44,34.0,47.333333333333336,<,-13.333333333333336,30,42,<,-12,38,57,<,-19,197,180,>,17
0,15,13.0,35.666666666666664,<,-22.666666666666664,0,0,=,0,21,61,<,-40,47.333333333333336,44.333333333333336,>,3.0,42,37,>,5,57,50,>,7,180,220,<,-40
98,15,35.666666666666664,13.0,>,22.666666666666664,0,0,=,0,61,21,>,40,44.333333333333336,47.333333333333336,<,-3.0,37,42,<,-5,50,57,<,-7,220,180,>,40
0,15,13.0,18.333333333333332,<,-5.333333333333332,0,0,=,0,21,33,<,-12,47.333333333333336,40.666666666666664,>,6.666666666666671,42,33,>,9,57,45,>,12,180,255,<,-75
128,15,18.333333333333332,13.0,>,5.333333333333332,0,0,=,0,33,21,>,12,40.666666666666664,47.333333333333336,<,-6.666666666666671,33,42,<,-9,45,57,<,-12,255,180,>,75
0,15,13.0,46.333333333333336,<,-33.333333333333336,0,0,=,0,21,72,<,-51,47.333333333333336,57.0,<,-9.666666666666664,42,52,<,-10,57,60,<,-3,180,247,<,-67
137,15,46.333333333333336,13.0,>,33.333333333333336,0,0,=,0,72,21,>,51,57.0,47.333333333333336,>,9.666666666666664,52,42,>,10,60,57,>,3,247,180,>,67
0,15,13.0,24.666666666666668,<,-11.666666666666668,0,0,=,0,21,54,<,-33,47.333333333333336,37.333333333333336,>,10.0,42,30,>,12,57,44,>,13,180,201,<,-21
155,15,24.666666666666668,13.0,>,11.666666666666668,0,0,=,0,54,21,>,33,37.333333333333336,47.333333333333336,<,-10.0,30,42,<,-12,44,57,<,-13,201,180,>,21
0,14,55.0,52.333333333333336,>,2.6666666666666643,16,20,<,-4,76,69,>,7,37.666666666666664,47.0,<,-9.333333333333336,32,34,<,-2,41,58,<,-17,106,98,>,8
0,14,52.333333333333336,55.0,<,-2.6666666666666643,20,16,>,4,69,76,<,-7,47.0,37.666666666666664,>,9.333333333333336,34,32,>,2,58,41,>,17,98,106,<,-8
0,14,55.0,33.0,>,22.0,16,17,<,-1,76,59,>,17,37.666666666666664,38.0,<,-0.3333333333333357,32,33,<,-1,41,41,=,0,106,92,>,14
0,14,33.0,55.0,<,-22.0,17,16,>,1,59,76,<,-17,38.0,37.666666666666664,>,0.3333333333333357,33,32,>,1,41,41,=,0,92,106,<,-14
0,14,55.0,31.0,>,24.0,16,27,<,-11,76,39,>,37,37.666666666666664,45.333333333333336,<,-7.666666666666671,32,31,>,1,41,56,<,-15,106,189,<,-83
146,14,31.0,55.0,<,-24.0,27,16,>,11,39,76,<,-37,45.333333333333336,37.666666666666664,>,7.666666666666671,31,32,<,-1,56,41,>,15,189,106,>,83
0,14,55.0,57.333333333333336,<,-2.3333333333333357,16,54,<,-38,76,63,>,13,37.666666666666664,49.0,<,-11.333333333333336,32,44,<,-12,41,52,<,-11,106,197,<,-91
186,14,57.333333333333336,55.0,>,2.3333333333333357,54,16,>,38,63,76,<,-13,49.0,37.666666666666664,>,11.333333333333336,44,32,>,12,52,41,>,11,197,106,>,91
0,14,55.0,40.0,>,15.0,16,17,<,-1,76,76,=,0,37.666666666666664,37.0,>,0.6666666666666643,32,32,=,0,41,41,=,0,106,149,<,-43
41,14,40.0,55.0,<,-15.0,17,16,>,1,76,76,=,0,37.0,37.666666666666664,<,-0.6666666666666643,32,32,=,0,41,41,=,0,149,106,>,43
0,14,55.0,46.666666666666664,>,8.333333333333336,16,36,<,-20,76,65,>,11,37.666666666666664,34.0,>,3.6666666666666643,32,30,>,2,41,38,>,3,106,197,<,-91
82,14,46.666666666666664,55.0,<,-8.333333333333336,36,16,>,20,65,76,<,-11,34.0,37.666666666666664,<,-3.6666666666666643,30,32,<,-2,38,41,<,-3,197,106,>,91
0,14,55.0,35.333333333333336,>,19.666666666666664,16,32,<,-16,76,38,>,38,37.666666666666664,36.0,>,1.6666666666666643,32,31,>,1,41,44,<,-3,106,171,<,-65
116,14,35.333333333333336,55.0,<,-19.666666666666664,32,16,>,16,38,76,<,-38,36.0,37.666666666666664,<,-1.6666666666666643,31,32,<,-1,44,41,>,3,171,106,>,65
0,14,55.0,26.0,>,29.0,16,12,>,4,76,46,>,30,37.666666666666664,43.333333333333336,<,-5.666666666666671,32,38,<,-6,41,53,<,-12,106,218,<,-112
104,14,26.0,55.0,<,-29.0,12,16,<,-4,46,76,<,-30,43.333333333333336,37.666666666666664,>,5.666666666666671,38,32,>,6,53,41,>,12,218,106,>,112
0,14,55.0,62.0,<,-7.0,16,46,<,-30,76,79,<,-3,37.666666666666664,44.333333333333336,<,-6.666666666666671,32,37,<,-5,41,50,<,-9,106,220,<,-114
209,14,62.0,55.0,>,7.0,46,16,>,30,79,76,>,3,44.333333333333336,37.666666666666664,>,6.666666666666671,37,32,>,5,50,41,>,9,220,106,>,114
0,14,55.0,78.66666666666667,<,-23.66666666666667,16,60,<,-44,76,88,<,-12,37.666666666666664,51.0,<,-13.333333333333336,32,38,<,-6,41,59,<,-18,106,199,<,-93
224,14,78.66666666666667,55.0,>,23.66666666666667,60,16,>,44,88,76,>,12,51.0,37.666666666666664,>,13.333333333333336,38,32,>,6,59,41,>,18,199,106,>,93
0,14,55.0,23.333333333333332,>,31.666666666666668,16,15,>,1,76,33,>,43,37.666666666666664,40.666666666666664,<,-3.0,32,33,<,-1,41,45,<,-4,106,255,<,-149
115,14,23.333333333333332,55.0,<,-31.666666666666668,15,16,<,-1,33,76,<,-43,40.666666666666664,37.666666666666664,>,3.0,33,32,>,1,45,41,>,4,255,106,>,149
0,14,55.0,62.333333333333336,<,-7.333333333333336,16,48,<,-32,76,72,>,4,37.666666666666664,57.0,<,-19.333333333333336,32,52,<,-20,41,60,<,-19,106,247,<,-141
217,14,62.333333333333336,55.0,>,7.333333333333336,48,16,>,32,72,76,<,-4,57.0,37.666666666666664,>,19.333333333333336,52,32,>,20,60,41,>,19,247,106,>,141
0,14,55.0,45.666666666666664,>,9.333333333333336,16,20,<,-4,76,63,>,13,37.666666666666664,37.333333333333336,>,0.3333333333333286,32,30,>,2,41,44,<,-3,106,201,<,-95
175,14,45.666666666666664,55.0,<,-9.333333333333336,20,16,>,4,63,76,<,-13,37.333333333333336,37.666666666666664,<,-0.3333333333333286,30,32,<,-2,44,41,>,3,201,106,>,95
0,13,35.0,17.666666666666668,>,17.333333333333332,16,13,>,3,69,23,>,46,47.0,38.0,>,9.0,34,33,>,1,58,41,>,17,98,92,>,6
0,13,17.666666666666668,35.0,<,-17.333333333333332,13,16,<,-3,23,69,<,-46,38.0,47.0,<,-9.0,33,34,<,-1,41,58,<,-17,92,98,<,-6
0,13,35.0,33.0,>,2.0,16,17,<,-1,69,55,>,14,47.0,37.0,>,10.0,34,32,>,2,58,41,>,17,98,149,<,-51
41,13,33.0,35.0,<,-2.0,17,16,>,1,55,69,<,-14,37.0,47.0,<,-10.0,32,34,<,-2,41,58,<,-17,149,98,>,51
0,13,35.0,60.333333333333336,<,-25.333333333333336,16,39,<,-23,69,77,<,-8,47.0,34.0,>,13.0,34,30,>,4,58,38,>,20,98,197,<,-99
82,13,60.333333333333336,35.0,>,25.333333333333336,39,16,>,23,77,69,>,8,34.0,47.0,<,-13.0,30,34,<,-4,38,58,<,-20,197,98,>,99
0,13,35.0,29.333333333333332,>,5.666666666666668,16,12,>,4,69,46,>,23,47.0,43.333333333333336,>,3.6666666666666643,34,38,<,-4,58,53,>,5,98,218,<,-120
60,13,29.333333333333332,35.0,<,-5.666666666666668,12,16,<,-4,46,69,<,-23,43.333333333333336,47.0,<,-3.6666666666666643,38,34,>,4,53,58,<,-5,218,98,>,120
0,13,35.0,35.666666666666664,<,-0.6666666666666643,16,15,>,1,69,59,>,10,47.0,40.666666666666664,>,6.333333333333336,34,33,>,1,58,45,>,13,98,255,<,-157
115,13,35.666666666666664,35.0,>,0.6666666666666643,15,16,<,-1,59,69,<,-10,40.666666666666664,47.0,<,-6.333333333333336,33,34,<,-1,45,58,<,-13,255,98,>,157
0,13,35.0,28.666666666666668,>,6.333333333333332,16,12,>,4,69,38,>,31,47.0,36.0,>,11.0,34,31,>,3,58,44,>,14,98,171,<,-73
0,13,28.666666666666668,35.0,<,-6.333333333333332,12,16,<,-4,38,69,<,-31,36.0,47.0,<,-11.0,31,34,<,-3,44,58,<,-14,171,98,>,73
0,13,35.0,51.333333333333336,<,-16.333333333333336,16,27,<,-11,69,88,<,-19,47.0,45.333333333333336,>,1.6666666666666643,34,31,>,3,58,56,>,2,98,189,<,-91
146,13,51.333333333333336,35.0,>,16.333333333333336,27,16,>,11,88,69,>,19,45.333333333333336,47.0,<,-1.6666666666666643,31,34,<,-3,56,58,<,-2,189,98,>,91
0,13,35.0,48.666666666666664,<,-13.666666666666664,16,29,<,-13,69,63,>,6,47.0,37.333333333333336,>,9.666666666666664,34,30,>,4,58,44,>,14,98,201,<,-103
78,13,48.666666666666664,35.0,>,13.666666666666664,29,16,>,13,63,69,<,-6,37.333333333333336,47.0,<,-9.666666666666664,30,34,<,-4,44,58,<,-14,201,98,>,103
0,13,35.0,48.333333333333336,<,-13.333333333333336,16,28,<,-12,69,63,>,6,47.0,49.0,<,-2.0,34,44,<,-10,58,52,>,6,98,197,<,-99
25,13,48.333333333333336,35.0,>,13.333333333333336,28,16,>,12,63,69,<,-6,49.0,47.0,>,2.0,44,34,>,10,52,58,<,-6,197,98,>,99
0,13,35.0,66.66666666666667,<,-31.66666666666667,16,60,<,-44,69,79,<,-10,47.0,44.333333333333336,>,2.6666666666666643,34,37,<,-3,58,50,>,8,98,220,<,-122
104,13,66.66666666666667,35.0,>,31.66666666666667,60,16,>,44,79,69,>,10,44.333333333333336,47.0,<,-2.6666666666666643,37,34,>,3,50,58,<,-8,220,98,>,122
0,13,35.0,60.333333333333336,<,-25.333333333333336,16,48,<,-32,69,72,<,-3,47.0,57.0,<,-10.0,34,52,<,-18,58,60,<,-2,98,247,<,-149
137,13,60.333333333333336,35.0,>,25.333333333333336,48,16,>,32,72,69,>,3,57.0,47.0,>,10.0,52,34,>,18,60,58,>,2,247,98,>,149
0,13,35.0,70.33333333333333,<,-35.33333333333333,16,60,<,-44,69,88,<,-19,47.0,51.0,<,-4.0,34,38,<,-4,58,59,<,-1,98,199,<,-101
71,13,70.33333333333333,35.0,>,35.33333333333333,60,16,>,44,88,69,>,19,51.0,47.0,>,4.0,38,34,>,4,59,58,>,1,199,98,>,101
0,12,38.0,29.666666666666668,>,8.333333333333332,12,13,<,-1,66,59,>,7,36.0,38.0,<,-2.0,31,33,<,-2,44,41,>,3,171,92,>,79
0,12,29.666666666666668,38.0,<,-8.333333333333332,13,12,>,1,59,66,<,-7,38.0,36.0,>,2.0,33,31,>,2,41,44,<,-3,92,171,<,-79
0,12,38.0,42.0,<,-4.0,12,28,<,-16,66,63,>,3,36.0,49.0,<,-13.0,31,44,<,-13,44,52,<,-8,171,197,<,-26
25,12,42.0,38.0,>,4.0,28,12,>,16,63,66,<,-3,49.0,36.0,>,13.0,44,31,>,13,52,44,>,8,197,171,>,26
0,12,38.0,27.333333333333332,>,10.666666666666668,12,10,>,2,66,55,>,11,36.0,37.0,<,-1.0,31,32,<,-1,44,41,>,3,171,149,>,22
0,12,27.333333333333332,38.0,<,-10.666666666666668,10,12,<,-2,55,66,<,-11,37.0,36.0,>,1.0,32,31,>,1,41,44,<,-3,149,171,<,-22
0,12,38.0,49.666666666666664,<,-11.666666666666664,12,30,<,-18,66,73,<,-7,36.0,43.333333333333336,<,-7.333333333333336,31,38,<,-7,44,53,<,-9,171,218,<,-47
60,12,49.666666666666664,38.0,>,11.666666666666664,30,12,>,18,73,66,>,7,43.333333333333336,36.0,>,7.333333333333336,38,31,>,7,53,44,>,9,218,171,>,47
0,12,38.0,66.33333333333333,<,-28.33333333333333,12,60,<,-48,66,76,<,-10,36.0,51.0,<,-15.0,31,38,<,-7,44,59,<,-15,171,199,<,-28
71,12,66.33333333333333,38.0,>,28.33333333333333,60,12,>,48,76,66,>,10,51.0,36.0,>,15.0,38,31,>,7,59,44,>,15,199,171,>,28
0,12,38.0,56.333333333333336,<,-18.333333333333336,12,29,<,-17,66,77,<,-11,36.0,37.333333333333336,<,-1.3333333333333357,31,30,>,1,44,44,=,0,171,201,<,-30
78,12,56.333333333333336,38.0,>,18.333333333333336,29,12,>,17,77,66,>,11,37.333333333333336,36.0,>,1.3333333333333357,30,31,<,-1,44,44,=,0,201,171,>,30
0,12,38.0,44.0,<,-6.0,12,16,<,-4,66,77,<,-11,36.0,34.0,>,2.0,31,30,>,1,44,38,>,6,171,197,<,-26
41,12,44.0,38.0,>,6.0,16,12,>,4,77,66,>,11,34.0,36.0,<,-2.0,30,31,<,-1,38,44,<,-6,197,171,>,26
0,12,38.0,61.0,<,-23.0,12,44,<,-32,66,79,<,-13,36.0,44.333333333333336,<,-8.333333333333336,31,37,<,-6,44,50,<,-6,171,220,<,-49
96,12,61.0,38.0,>,23.0,44,12,>,32,79,66,>,13,44.333333333333336,36.0,>,8.333333333333336,37,31,>,6,50,44,>,6,220,171,>,49
0,12,38.0,46.0,<,-8.0,12,15,<,-3,66,64,>,2,36.0,40.666666666666664,<,-4.666666666666664,31,33,<,-2,44,45,<,-1,171,255,<,-84
115,12,46.0,38.0,>,8.0,15,12,>,3,64,66,<,-2,40.666666666666664,36.0,>,4.666666666666664,33,31,>,2,45,44,>,1,255,171,>,84
0,12,38.0,51.333333333333336,<,-13.333333333333336,12,45,<,-33,66,61,>,5,36.0,57.0,<,-21.0,31,52,<,-21,44,60,<,-16,171,247,<,-76
137,12,51.333333333333336,38.0,>,13.333333333333336,45,12,>,33,61,66,<,-5,57.0,36.0,>,21.0,52,31,>,21,60,44,>,16,247,171,>,76
0,12,38.0,59.0,<,-21.0,12,39,<,-27,66,88,<,-22,36.0,45.333333333333336,<,-9.333333333333336,31,31,=,0,44,56,<,-12,171,189,<,-18
146,12,59.0,38.0,>,21.0,39,12,>,27,88,66,>,22,45.333333333333336,36.0,>,9.333333333333336,31,31,=,0,56,44,>,12,189,171,>,18
0,11,26.666666666666668,33.333333333333336,<,-6.666666666666668,10,17,<,-7,53,59,<,-6,37.0,38.0,<,-1.0,32,33,<,-1,41,41,=,0,149,92,>,57
0,11,33.333333333333336,26.666666666666668,>,6.666666666666668,17,10,>,7,59,53,>,6,38.0,37.0,>,1.0,33,32,>,1,41,41,=,0,92,149,<,-57
0,11,26.666666666666668,42.0,<,-15.333333333333332,10,28,<,-18,53,63,<,-10,37.0,49.0,<,-12.0,32,44,<,-12,41,52,<,-11,149,197,<,-48
43,11,42.0,26.666666666666668,>,15.333333333333332,28,10,>,18,63,53,>,10,49.0,37.0,>,12.0,44,32,>,12,52,41,>,11,197,149,>,48
0,11,26.666666666666668,29.0,<,-2.333333333333332,10,16,<,-6,53,39,>,14,37.0,34.0,>,3.0,32,30,>,2,41,38,>,3,149,197,<,-48
66,11,29.0,26.666666666666668,>,2.333333333333332,16,10,>,6,39,53,<,-14,34.0,37.0,<,-3.0,30,32,<,-2,38,41,<,-3,197,149,>,48
0,11,26.666666666666668,66.33333333333333,<,-39.66666666666666,10,46,<,-36,53,80,<,-27,37.0,43.333333333333336,<,-6.333333333333336,32,38,<,-6,41,53,<,-12,149,218,<,-69
86,11,66.33333333333333,26.666666666666668,>,39.66666666666666,46,10,>,36,80,53,>,27,43.333333333333336,37.0,>,6.333333333333336,38,32,>,6,53,41,>,12,218,149,>,69
0,11,26.666666666666668,59.333333333333336,<,-32.66666666666667,10,42,<,-32,53,76,<,-23,37.0,51.0,<,-14.0,32,38,<,-6,41,59,<,-18,149,199,<,-50
17,11,59.333333333333336,26.666666666666668,>,32.66666666666667,42,10,>,32,76,53,>,23,51.0,37.0,>,14.0,38,32,>,6,59,41,>,18,199,149,>,50
0,11,26.666666666666668,65.0,<,-38.33333333333333,10,55,<,-45,53,77,<,-24,37.0,37.333333333333336,<,-0.3333333333333357,32,30,>,2,41,44,<,-3,149,201,<,-52
108,11,65.0,26.666666666666668,>,38.33333333333333,55,10,>,45,77,53,>,24,37.333333333333336,37.0,>,0.3333333333333357,30,32,<,-2,44,41,>,3,201,149,>,52
0,11,26.666666666666668,45.333333333333336,<,-18.666666666666668,10,13,<,-3,53,79,<,-26,37.0,44.333333333333336,<,-7.333333333333336,32,37,<,-5,41,50,<,-9,149,220,<,-71
0,11,45.333333333333336,26.666666666666668,>,18.666666666666668,13,10,>,3,79,53,>,26,44.333333333333336,37.0,>,7.333333333333336,37,32,>,5,50,41,>,9,220,149,>,71
0,11,26.666666666666668,39.666666666666664,<,-12.999999999999996,10,15,<,-5,53,64,<,-11,37.0,40.666666666666664,<,-3.6666666666666643,32,33,<,-1,41,45,<,-4,149,255,<,-106
81,11,39.666666666666664,26.666666666666668,>,12.999999999999996,15,10,>,5,64,53,>,11,40.666666666666664,37.0,>,3.6666666666666643,33,32,>,1,45,41,>,4,255,149,>,106
0,11,26.666666666666668,47.333333333333336,<,-20.666666666666668,10,45,<,-35,53,49,>,4,37.0,57.0,<,-20.0,32,52,<,-20,41,60,<,-19,149,247,<,-98
57,11,47.333333333333336,26.666666666666668,>,20.666666666666668,45,10,>,35,49,53,<,-4,57.0,37.0,>,20.0,52,32,>,20,60,41,>,19,247,149,>,98
0,11,26.666666666666668,54.0,<,-27.333333333333332,10,39,<,-29,53,73,<,-20,37.0,45.333333333333336,<,-8.333333333333336,32,31,>,1,41,56,<,-15,149,189,<,-40
171,11,54.0,26.666666666666668,>,27.333333333333332,39,10,>,29,73,53,>,20,45.333333333333336,37.0,>,8.333333333333336,31,32,<,-1,56,41,>,15,189,149,>,40
0,10,59.333333333333336,40.666666666666664,>,18.66666666666667,13,17,<,-4,86,81,>,5,44.333333333333336,38.0,>,6.333333333333336,37,33,>,4,50,41,>,9,220,92,>,128
0,10,40.666666666666664,59.333333333333336,<,-18.66666666666667,17,13,>,4,81,86,<,-5,38.0,44.333333333333336,<,-6.333333333333336,33,37,<,-4,41,50,<,-9,92,220,<,-128
0,10,59.333333333333336,61.333333333333336,<,-2.0,13,42,<,-29,86,82,>,4,44.333333333333336,51.0,<,-6.666666666666664,37,38,<,-1,50,59,<,-9,220,199,>,21
17,10,61.333333333333336,59.333333333333336,>,2.0,42,13,>,29,82,86,<,-4,51.0,44.333333333333336,>,6.666666666666664,38,37,>,1,59,50,>,9,199,220,<,-21
0,10,59.333333333333336,53.0,>,6.333333333333336,13,28,<,-15,86,68,>,18,44.333333333333336,49.0,<,-4.666666666666664,37,44,<,-7,50,52,<,-2,220,197,>,23
43,10,53.0,59.333333333333336,<,-6.333333333333336,28,13,>,15,68,86,<,-18,49.0,44.333333333333336,>,4.666666666666664,44,37,>,7,52,50,>,2,197,220,<,-23
0,10,59.333333333333336,60.333333333333336,<,-1.0,13,48,<,-35,86,84,>,2,44.333333333333336,57.0,<,-12.666666666666664,37,52,<,-15,50,60,<,-10,220,247,<,-27
57,10,60.333333333333336,59.333333333333336,>,1.0,48,13,>,35,84,86,<,-2,57.0,44.333333333333336,>,12.666666666666664,52,37,>,15,60,50,>,10,247,220,>,27
0,10,59.333333333333336,35.333333333333336,>,24.0,13,32,<,-19,86,39,>,47,44.333333333333336,34.0,>,10.333333333333336,37,30,>,7,50,38,>,12,220,197,>,23
79,10,35.333333333333336,59.333333333333336,<,-24.0,32,13,>,19,39,86,<,-47,34.0,44.333333333333336,<,-10.333333333333336,30,37,<,-7,38,50,<,-12,197,220,<,-23
0,10,59.333333333333336,31.333333333333332,>,28.000000000000004,13,15,<,-2,86,40,>,46,44.333333333333336,40.666666666666664,>,3.6666666666666714,37,33,>,4,50,45,>,5,220,255,<,-35
76,10,31.333333333333332,59.333333333333336,<,-28.000000000000004,15,13,>,2,40,86,<,-46,40.666666666666664,44.333333333333336,<,-3.6666666666666714,33,37,<,-4,45,50,<,-5,255,220,>,35
0,10,59.333333333333336,65.66666666666667,<,-6.333333333333336,13,46,<,-33,86,80,>,6,44.333333333333336,43.333333333333336,>,1.0,37,38,<,-1,50,53,<,-3,220,218,>,2
86,10,65.66666666666667,59.333333333333336,>,6.333333333333336,46,13,>,33,80,86,<,-6,43.333333333333336,44.333333333333336,<,-1.0,38,37,>,1,53,50,>,3,218,220,<,-2
0,10,59.333333333333336,47.666666666666664,>,11.666666666666671,13,25,<,-12,86,63,>,23,44.333333333333336,37.333333333333336,>,7.0,37,30,>,7,50,44,>,6,220,201,>,19
0,10,47.666666666666664,59.333333333333336,<,-11.666666666666671,25,13,>,12,63,86,<,-23,37.333333333333336,44.333333333333336,<,-7.0,30,37,<,-7,44,50,<,-6,201,220,<,-19
0,10,59.333333333333336,61.333333333333336,<,-2.0,13,39,<,-26,86,73,>,13,44.333333333333336,45.333333333333336,<,-1.0,37,31,>,6,50,56,<,-6,220,189,>,31
179,10,61.333333333333336,59.333333333333336,>,2.0,39,13,>,26,73,86,<,-13,45.333333333333336,44.333333333333336,>,1.0,31,37,<,-6,56,50,>,6,189,220,<,-31
0,9,46.666666666666664,45.666666666666664,>,1.0,25,17,>,8,63,81,<,-18,37.333333333333336,38.0,<,-0.6666666666666643,30,33,<,-3,44,41,>,3,201,92,>,109
0,9,45.666666666666664,46.666666666666664,<,-1.0,17,25,<,-8,81,63,>,18,38.0,37.333333333333336,>,0.6666666666666643,33,30,>,3,41,44,<,-3,92,201,<,-109
0,9,46.666666666666664,60.0,<,-13.333333333333336,25,38,<,-13,63,82,<,-19,37.333333333333336,51.0,<,-13.666666666666664,30,38,<,-8,44,59,<,-15,201,199,>,2
2,9,60.0,46.666666666666664,>,13.333333333333336,38,25,>,13,82,63,>,19,51.0,37.333333333333336,>,13.666666666666664,38,30,>,8,59,44,>,15,199,201,<,-2
0,9,46.666666666666664,64.33333333333333,<,-17.666666666666664,25,62,<,-37,63,68,<,-5,37.333333333333336,49.0,<,-11.666666666666664,30,44,<,-14,44,52,<,-8,201,197,>,4
95,9,64.33333333333333,46.666666666666664,>,17.666666666666664,62,25,>,37,68,63,>,5,49.0,37.333333333333336,>,11.666666666666664,44,30,>,14,52,44,>,8,197,201,<,-4
0,9,46.666666666666664,64.0,<,-17.333333333333336,25,48,<,-23,63,84,<,-21,37.333333333333336,57.0,<,-19.666666666666664,30,52,<,-22,44,60,<,-16,201,247,<,-46
53,9,64.0,46.666666666666664,>,17.333333333333336,48,25,>,23,84,63,>,21,57.0,37.333333333333336,>,19.666666666666664,52,30,>,22,60,44,>,16,247,201,>,46
0,9,46.666666666666664,44.333333333333336,>,2.3333333333333286,25,15,>,10,63,79,<,-16,37.333333333333336,40.666666666666664,<,-3.3333333333333286,30,33,<,-3,44,45,<,-1,201,255,<,-54
75,9,44.333333333333336,46.666666666666664,<,-2.3333333333333286,15,25,<,-10,79,63,>,16,40.666666666666664,37.333333333333336,>,3.3333333333333286,33,30,>,3,45,44,>,1,255,201,>,54
0,9,46.666666666666664,42.666666666666664,>,4.0,25,35,<,-10,63,54,>,9,37.333333333333336,34.0,>,3.3333333333333357,30,30,=,0,44,38,>,6,201,197,>,4
116,9,42.666666666666664,46.666666666666664,<,-4.0,35,25,>,10,54,63,<,-9,34.0,37.333333333333336,<,-3.3333333333333357,30,30,=,0,38,44,<,-6,197,201,<,-4
0,9,46.666666666666664,53.0,<,-6.333333333333336,25,42,<,-17,63,71,<,-8,37.333333333333336,43.333333333333336,<,-6.0,30,38,<,-8,44,53,<,-9,201,218,<,-17
0,9,53.0,46.666666666666664,>,6.333333333333336,42,25,>,17,71,63,>,8,43.333333333333336,37.333333333333336,>,6.0,38,30,>,8,53,44,>,9,218,201,>,17
0,9,46.666666666666664,47.0,<,-0.3333333333333357,25,30,<,-5,63,72,<,-9,37.333333333333336,45.333333333333336,<,-8.0,30,31,<,-1,44,56,<,-12,201,189,>,12
102,9,47.0,46.666666666666664,>,0.3333333333333357,30,25,>,5,72,63,>,9,45.333333333333336,37.333333333333336,>,8.0,31,30,>,1,56,44,>,12,189,201,<,-12
0,8,58.0,25.666666666666668,>,32.33333333333333,42,17,>,25,86,39,>,47,43.333333333333336,38.0,>,5.333333333333336,38,33,>,5,53,41,>,12,218,92,>,126
0,8,25.666666666666668,58.0,<,-32.33333333333333,17,42,<,-25,39,86,<,-47,38.0,43.333333333333336,<,-5.333333333333336,33,38,<,-5,41,53,<,-12,92,218,<,-126
0,8,58.0,37.666666666666664,>,20.333333333333336,42,15,>,27,86,60,>,26,43.333333333333336,51.0,<,-7.666666666666664,38,38,=,0,53,59,<,-6,218,199,>,19
0,8,37.666666666666664,58.0,<,-20.333333333333336,15,42,<,-27,60,86,<,-26,51.0,43.333333333333336,>,7.666666666666664,38,38,=,0,59,53,>,6,199,218,<,-19
0,8,58.0,49.333333333333336,>,8.666666666666664,42,40,>,2,86,60,>,26,43.333333333333336,57.0,<,-13.666666666666664,38,52,<,-14,53,60,<,-7,218,247,<,-29
4,8,49.333333333333336,58.0,<,-8.666666666666664,40,42,<,-2,60,86,<,-26,57.0,43.333333333333336,>,13.666666666666664,52,38,>,14,60,53,>,7,247,218,>,29
0,8,58.0,50.333333333333336,>,7.666666666666664,42,15,>,27,86,79,>,7,43.333333333333336,40.666666666666664,>,2.6666666666666714,38,33,>,5,53,45,>,8,218,255,<,-37
11,8,50.333333333333336,58.0,<,-7.666666666666664,15,42,<,-27,79,86,<,-7,40.666666666666664,43.333333333333336,<,-2.6666666666666714,33,38,<,-5,45,53,<,-8,255,218,>,37
0,8,58.0,46.666666666666664,>,11.333333333333336,42,15,>,27,86,63,>,23,43.333333333333336,49.0,<,-5.666666666666664,38,44,<,-6,53,52,>,1,218,197,>,21
2,8,46.666666666666664,58.0,<,-11.333333333333336,15,42,<,-27,63,86,<,-23,49.0,43.333333333333336,>,5.666666666666664,44,38,>,6,52,53,<,-1,197,218,<,-21
0,8,58.0,27.666666666666668,>,30.333333333333332,42,14,>,28,86,39,>,47,43.333333333333336,45.333333333333336,<,-2.0,38,31,>,7,53,56,<,-3,218,189,>,29
40,8,27.666666666666668,58.0,<,-30.333333333333332,14,42,<,-28,39,86,<,-47,45.333333333333336,43.333333333333336,>,2.0,31,38,<,-7,56,53,>,3,189,218,<,-29
0,8,58.0,51.666666666666664,>,6.333333333333336,42,39,>,3,86,62,>,24,43.333333333333336,34.0,>,9.333333333333336,38,30,>,8,53,38,>,15,218,197,>,21
141,8,51.666666666666664,58.0,<,-6.333333333333336,39,42,<,-3,62,86,<,-24,34.0,43.333333333333336,<,-9.333333333333336,30,38,<,-8,38,53,<,-15,197,218,<,-21
0,7,32.0,18.0,>,14.0,15,16,<,-1,60,21,>,39,51.0,38.0,>,13.0,38,33,>,5,59,41,>,18,199,92,>,107
0,7,18.0,32.0,<,-14.0,16,15,>,1,21,60,<,-39,38.0,51.0,<,-13.0,33,38,<,-5,41,59,<,-18,92,199,<,-107
0,7,32.0,55.666666666666664,<,-23.666666666666664,15,15,=,0,60,89,<,-29,51.0,49.0,>,2.0,38,44,<,-6,59,52,>,7,199,197,>,2
20,7,55.666666666666664,32.0,>,23.666666666666664,15,15,=,0,89,60,>,29,49.0,51.0,<,-2.0,44,38,>,6,52,59,<,-7,197,199,<,-2
0,7,32.0,43.666666666666664,<,-11.666666666666664,15,40,<,-25,60,48,>,12,51.0,57.0,<,-6.0,38,52,<,-14,59,60,<,-1,199,247,<,-48
9,7,43.666666666666664,32.0,>,11.666666666666664,40,15,>,25,48,60,<,-12,57.0,51.0,>,6.0,52,38,>,14,60,59,>,1,247,199,>,48
0,7,32.0,29.666666666666668,>,2.333333333333332,15,15,=,0,60,57,>,3,51.0,40.666666666666664,>,10.333333333333336,38,33,>,5,59,45,>,14,199,255,<,-56
0,7,29.666666666666668,32.0,<,-2.333333333333332,15,15,=,0,57,60,<,-3,40.666666666666664,51.0,<,-10.333333333333336,33,38,<,-5,45,59,<,-14,255,199,>,56
0,7,32.0,29.0,>,3.0,15,14,>,1,60,39,>,21,51.0,45.333333333333336,>,5.666666666666664,38,31,>,7,59,56,>,3,199,189,>,10
45,7,29.0,32.0,<,-3.0,14,15,<,-1,39,60,<,-21,45.333333333333336,51.0,<,-5.666666666666664,31,38,<,-7,56,59,<,-3,189,199,<,-10
0,7,32.0,48.0,<,-16.0,15,39,<,-24,60,62,<,-2,51.0,34.0,>,17.0,38,30,>,8,59,38,>,21,199,197,>,2
137,7,48.0,32.0,>,16.0,39,15,>,24,62,60,>,2,34.0,51.0,<,-17.0,30,38,<,-8,38,59,<,-21,197,199,<,-2
0,6,31.333333333333332,25.666666666666668,>,5.666666666666664,15,16,<,-1,62,44,>,18,40.666666666666664,38.0,>,2.6666666666666643,33,33,=,0,45,41,>,4,255,92,>,163
0,6,25.666666666666668,31.333333333333332,<,-5.666666666666664,16,15,>,1,44,62,<,-18,38.0,40.666666666666664,<,-2.6666666666666643,33,33,=,0,41,45,<,-4,92,255,<,-163
0,6,31.333333333333332,58.333333333333336,<,-27.000000000000004,15,43,<,-28,62,84,<,-22,40.666666666666664,57.0,<,-16.333333333333336,33,52,<,-19,45,60,<,-15,255,247,>,8
23,6,58.333333333333336,31.333333333333332,>,27.000000000000004,43,15,>,28,84,62,>,22,57.0,40.666666666666664,>,16.333333333333336,52,33,>,19,60,45,>,15,247,255,<,-8
0,6,31.333333333333332,69.0,<,-37.66666666666667,15,55,<,-40,62,89,<,-27,40.666666666666664,49.0,<,-8.333333333333336,33,44,<,-11,45,52,<,-7,255,197,>,58
89,6,69.0,31.333333333333332,>,37.66666666666667,55,15,>,40,89,62,>,27,49.0,40.666666666666664,>,8.333333333333336,44,33,>,11,52,45,>,7,197,255,<,-58
0,6,31.333333333333332,37.333333333333336,<,-6.0000000000000036,15,34,<,-19,62,39,>,23,40.666666666666664,45.333333333333336,<,-4.666666666666671,33,31,>,2,45,56,<,-11,255,189,>,66
73,6,37.333333333333336,31.333333333333332,>,6.0000000000000036,34,15,>,19,39,62,<,-23,45.333333333333336,40.666666666666664,>,4.666666666666671,31,33,<,-2,56,45,>,11,189,255,<,-66
0,6,31.333333333333332,37.0,<,-5.666666666666668,15,29,<,-14,62,43,>,19,40.666666666666664,34.0,>,6.666666666666664,33,30,>,3,45,38,>,7,255,197,>,58
120,6,37.0,31.333333333333332,>,5.666666666666668,29,15,>,14,43,62,<,-19,34.0,40.666666666666664,<,-6.666666666666664,30,33,<,-3,38,45,<,-7,197,255,<,-58
0,5,44.666666666666664,58.666666666666664,<,-14.0,17,44,<,-27,73,84,<,-11,38.0,57.0,<,-19.0,33,52,<,-19,41,60,<,-19,92,247,<,-155
102,5,58.666666666666664,44.666666666666664,>,14.0,44,17,>,27,84,73,>,11,57.0,38.0,>,19.0,52,33,>,19,60,41,>,19,247,92,>,155
0,5,44.666666666666664,56.0,<,-11.333333333333336,17,39,<,-22,73,90,<,-17,38.0,45.333333333333336,<,-7.333333333333336,33,31,>,2,41,56,<,-15,92,189,<,-97
103,5,56.0,44.666666666666664,>,11.333333333333336,39,17,>,22,90,73,>,17,45.333333333333336,38.0,>,7.333333333333336,31,33,<,-2,56,41,>,15,189,92,>,97
0,5,44.666666666666664,67.0,<,-22.333333333333336,17,55,<,-38,73,83,<,-10,38.0,49.0,<,-11.0,33,44,<,-11,41,52,<,-11,92,197,<,-105
89,5,67.0,44.666666666666664,>,22.333333333333336,55,17,>,38,83,73,>,10,49.0,38.0,>,11.0,44,33,>,11,52,41,>,11,197,92,>,105
0,5,44.666666666666664,50.666666666666664,<,-6.0,17,29,<,-12,73,84,<,-11,38.0,34.0,>,4.0,33,30,>,3,41,38,>,3,92,197,<,-105
120,5,50.666666666666664,44.666666666666664,>,6.0,29,17,>,12,84,73,>,11,34.0,38.0,<,-4.0,30,33,<,-3,38,41,<,-3,197,92,>,105
0,4,41.333333333333336,60.333333333333336,<,-19.0,11,43,<,-32,84,83,>,1,34.0,49.0,<,-15.0,30,44,<,-14,38,52,<,-14,197,197,=,0
89,4,60.333333333333336,41.333333333333336,>,19.0,43,11,>,32,83,84,<,-1,49.0,34.0,>,15.0,44,30,>,14,52,38,>,14,197,197,=,0
0,4,41.333333333333336,50.666666666666664,<,-9.333333333333329,11,24,<,-13,84,84,=,0,34.0,57.0,<,-23.0,30,52,<,-22,38,60,<,-22,197,247,<,-50
102,4,50.666666666666664,41.333333333333336,>,9.333333333333329,24,11,>,13,84,84,=,0,57.0,34.0,>,23.0,52,30,>,22,60,38,>,22,247,197,>,50
0,4,41.333333333333336,66.66666666666667,<,-25.333333333333336,11,39,<,-28,84,90,<,-6,34.0,45.333333333333336,<,-11.333333333333336,30,31,<,-1,38,56,<,-18,197,189,>,8
103,4,66.66666666666667,41.333333333333336,>,25.333333333333336,39,11,>,28,90,84,>,6,45.333333333333336,34.0,>,11.333333333333336,31,30,>,1,56,38,>,18,189,197,<,-8
0,3,49.666666666666664,69.66666666666667,<,-20.000000000000007,11,44,<,-33,83,84,<,-1,49.0,57.0,<,-8.0,44,52,<,-8,52,60,<,-8,197,247,<,-50
102,3,69.66666666666667,49.666666666666664,>,20.000000000000007,44,11,>,33,84,83,>,1,57.0,49.0,>,8.0,52,44,>,8,60,52,>,8,247,197,>,50
0,3,49.666666666666664,52.0,<,-2.3333333333333357,11,27,<,-16,83,90,<,-7,49.0,45.333333333333336,>,3.6666666666666643,44,31,>,13,52,56,<,-4,197,189,>,8
39,3,52.0,49.666666666666664,>,2.3333333333333357,27,11,>,16,90,83,>,7,45.333333333333336,49.0,<,-3.6666666666666643,31,44,<,-13,56,52,>,4,189,197,<,-8
0,2,49.666666666666664,61.333333333333336,<,-11.666666666666671,20,44,<,-24,90,84,>,6,45.333333333333336,57.0,<,-11.666666666666664,31,52,<,-21,56,60,<,-4,189,247,<,-58
89,2,61.333333333333336,49.666666666666664,>,11.666666666666671,44,20,>,24,84,90,<,-6,57.0,45.333333333333336,>,11.666666666666664,52,31,>,21,60,56,>,4,247,189,>,58
0,16,0.0,0.0,=,0.0,0,0,=,0,0,0,=,0,45.333333333333336,52.333333333333336,<,-7.0,38,40,<,-2,53,60,<,-7,95,175,<,-80
37,16,0.0,0.0,=,0.0,0,0,=,0,0,0,=,0,52.333333333333336,45.333333333333336,>,7.0,40,38,>,2,60,53,>,7,175,95,>,80
0,16,0.0,0.0,=,0.0,0,0,=,0,0,0,=,0,45.333333333333336,40.333333333333336,>,5.0,38,30,>,8,53,47,>,6,95,175,<,-80
41,16,0.0,0.0,=,0.0,0,0,=,0,0,0,=,0,40.333333333333336,45.333333333333336,<,-5.0,30,38,<,-8,47,53,<,-6,175,95,>,80
0,16,0.0,0.0,=,0.0,0,0,=,0,0,0,=,0,45.333333333333336,53.666666666666664,<,-8.333333333333329,38,46,<,-8,53,60,<,-7,95,213,<,-118
48,16,0.0,0.0,=,0.0,0,0,=,0,0,0,=,0,53.666666666666664,45.333333333333336,>,8.333333333333329,46,38,>,8,60,53,>,7,213,95,>,118
0,16,0.0,0.0,=,0.0,0,0,=,0,0,0,=,0,45.333333333333336,46.333333333333336,<,-1.0,38,33,>,5,53,54,<,-1,95,226,<,-131
53,16,0.0,0.0,=,0.0,0,0,=,0,0,0,=,0,46.333333333333336,45.333333333333336,>,1.0,33,38,<,-5,54,53,>,1,226,95,>,131
0,16,0.0,0.0,=,0.0,0,0,=,0,0,0,=,0,45.333333333333336,49.666666666666664,<,-4.333333333333329,38,31,>,7,53,59,<,-6,95,228,<,-133
81,16,0.0,0.0,=,0.0,0,0,=,0,0,0,=,0,49.666666666666664,45.333333333333336,>,4.333333333333329,31,38,<,-7,59,53,>,6,228,95,>,133
0,16,0.0,0.0,=,0.0,0,0,=,0,0,0,=,0,45.333333333333336,46.666666666666664,<,-1.3333333333333286,38,32,>,6,53,59,<,-6,95,182,<,-87
59,16,0.0,0.0,=,0.0,0,0,=,0,0,0,=,0,46.666666666666664,45.333333333333336,>,1.3333333333333286,32,38,<,-6,59,53,>,6,182,95,>,87
0,16,0.0,0.0,=,0.0,0,0,=,0,0,0,=,0,45.333333333333336,47.666666666666664,<,-2.3333333333333286,38,38,=,0,53,58,<,-5,95,113,<,-18
21,16,0.0,0.0,=,0.0,0,0,=,0,0,0,=,0,47.666666666666664,45.333333333333336,>,2.3333333333333286,38,38,=,0,58,53,>,5,113,95,>,18
0,16,0.0,0.0,=,0.0,0,0,=,0,0,0,=,0,45.333333333333336,46.666666666666664,<,-1.3333333333333286,38,39,<,-1,53,51,>,2,95,136,<,-41
0,16,0.0,0.0,=,0.0,0,0,=,0,0,0,=,0,46.666666666666664,45.333333333333336,>,1.3333333333333286,39,38,>,1,51,53,<,-2,136,95,>,41
0,16,0.0,0.0,=,0.0,0,0,=,0,0,0,=,0,45.333333333333336,41.0,>,4.333333333333336,38,33,>,5,53,49,>,4,95,148,<,-53
30,16,0.0,0.0,=,0.0,0,0,=,0,0,0,=,0,41.0,45.333333333333336,<,-4.333333333333336,33,38,<,-5,49,53,<,-4,148,95,>,53
0,16,0.0,0.0,=,0.0,0,0,=,0,0,0,=,0,45.333333333333336,53.333333333333336,<,-8.0,38,46,<,-8,53,57,<,-4,95,220,<,-125
99,16,0.0,0.0,=,0.0,0,0,=,0,0,0,=,0,53.333333333333336,45.333333333333336,>,8.0,46,38,>,8,57,53,>,4,220,95,>,125
0,16,0.0,0.0,=,0.0,0,0,=,0,0,0,=,0,45.333333333333336,37.0,>,8.333333333333336,38,30,>,8,53,43,>,10,95,104,<,-9
49,16,0.0,0.0,=,0.0,0,0,=,0,0,0,=,0,37.0,45.333333333333336,<,-8.333333333333336,30,38,<,-8,43,53,<,-10,104,95,>,9
0,16,0.0,0.0,=,0.0,0,0,=,0,0,0,=,0,45.333333333333336,41.0,>,4.333333333333336,38,38,=,0,53,45,>,8,95,233,<,-138
86,16,0.0,0.0,=,0.0,0,0,=,0,0,0,=,0,41.0,45.333333333333336,<,-4.333333333333336,38,38,=,0,45,53,<,-8,233,95,>,138
0,16,0.0,0.0,=,0.0,0,0,=,0,0,0,=,0,45.333333333333336,37.666666666666664,>,7.666666666666671,38,31,>,7,53,42,>,11,95,144,<,-49
25,16,0.0,0.0,=,0.0,0,0,=,0,0,0,=,0,37.666666666666664,45.333333333333336,<,-7.666666666666671,31,38,<,-7,42,53,<,-11,144,95,>,49
0,16,0.0,0.0,=,0.0,0,0,=,0,0,0,=,0,45.333333333333336,45.666666666666664,<,-0.3333333333333286,38,40,<,-2,53,49,>,4,95,130,<,-35
31,16,0.0,0.0,=,0.0,0,0,=,0,0,0,=,0,45.666666666666664,45.333333333333336,>,0.3333333333333286,40,38,>,2,49,53,<,-4,130,95,>,35
0,16,0.0,0.0,=,0.0,0,0,=,0,0,0,=,0,45.333333333333336,47.666666666666664,<,-2.3333333333333286,38,32,>,6,53,58,<,-5,95,248,<,-153
118,16,0.0,0.0,=,0.0,0,0,=,0,0,0,=,0,47.666666666666664,45.333333333333336,>,2.3333333333333286,32,38,<,-6,58,53,>,5,248,95,>,153
0,15,25.0,12.0,>,13.0,0,0,=,0,75,36,>,39,46.666666666666664,47.666666666666664,<,-1.0,39,38,>,1,51,58,<,-7,136,113,>,23
21,15,12.0,25.0,<,-13.0,0,0,=,0,36,75,<,-39,47.666666666666664,46.666666666666664,>,1.0,38,39,<,-1,58,51,>,7,113,136,<,-23
0,15,25.0,27.666666666666668,<,-2.666666666666668,0,0,=,0,75,83,<,-8,46.666666666666664,37.666666666666664,>,9.0,39,31,>,8,51,42,>,9,136,144,<,-8
38,15,27.666666666666668,25.0,>,2.666666666666668,0,0,=,0,83,75,>,8,37.666666666666664,46.666666666666664,<,-9.0,31,39,<,-8,42,51,<,-9,144,136,>,8
0,15,25.0,22.333333333333332,>,2.666666666666668,0,0,=,0,75,67,>,8,46.666666666666664,41.0,>,5.666666666666664,39,33,>,6,51,49,>,2,136,148,<,-12
30,15,22.333333333333332,25.0,<,-2.666666666666668,0,0,=,0,67,75,<,-8,41.0,46.666666666666664,<,-5.666666666666664,33,39,<,-6,49,51,<,-2,148,136,>,12
0,15,25.0,3.6666666666666665,>,21.333333333333332,0,0,=,0,75,11,>,64,46.666666666666664,45.666666666666664,>,1.0,39,40,<,-1,51,49,>,2,136,130,>,6
0,15,3.6666666666666665,25.0,<,-21.333333333333332,0,0,=,0,11,75,<,-64,45.666666666666664,46.666666666666664,<,-1.0,40,39,>,1,49,51,<,-2,130,136,<,-6
0,15,25.0,22.0,>,3.0,0,0,=,0,75,66,>,9,46.666666666666664,52.333333333333336,<,-5.666666666666671,39,40,<,-1,51,60,<,-9,136,175,<,-39
37,15,22.0,25.0,<,-3.0,0,0,=,0,66,75,<,-9,52.333333333333336,46.666666666666664,>,5.666666666666671,40,39,>,1,60,51,>,9,175,136,>,39
0,15,25.0,11.0,>,14.0,0,0,=,0,75,33,>,42,46.666666666666664,40.333333333333336,>,6.333333333333329,39,30,>,9,51,47,>,4,136,175,<,-39
41,15,11.0,25.0,<,-14.0,0,0,=,0,33,75,<,-42,40.333333333333336,46.666666666666664,<,-6.333333333333329,30,39,<,-9,47,51,<,-4,175,136,>,39
0,15,25.0,12.333333333333334,>,12.666666666666666,0,0,=,0,75,37,>,38,46.666666666666664,53.666666666666664,<,-7.0,39,46,<,-7,51,60,<,-9,136,213,<,-77
79,15,12.333333333333334,25.0,<,-12.666666666666666,0,0,=,0,37,75,<,-38,53.666666666666664,46.666666666666664,>,7.0,46,39,>,7,60,51,>,9,213,136,>,77
0,15,25.0,9.333333333333334,>,15.666666666666666,0,0,=,0,75,28,>,47,46.666666666666664,37.0,>,9.666666666666664,39,30,>,9,51,43,>,8,136,104,>,32
49,15,9.333333333333334,25.0,<,-15.666666666666666,0,0,=,0,28,75,<,-47,37.0,46.666666666666664,<,-9.666666666666664,30,39,<,-9,43,51,<,-8,104,136,<,-32
0,15,25.0,14.0,>,11.0,0,0,=,0,75,42,>,33,46.666666666666664,46.333333333333336,>,0.3333333333333286,39,33,>,6,51,54,<,-3,136,226,<,-90
53,15,14.0,25.0,<,-11.0,0,0,=,0,42,75,<,-33,46.333333333333336,46.666666666666664,<,-0.3333333333333286,33,39,<,-6,54,51,>,3,226,136,>,90
0,15,25.0,8.666666666666666,>,16.333333333333336,0,0,=,0,75,26,>,49,46.666666666666664,46.666666666666664,=,0.0,39,32,>,7,51,59,<,-8,136,182,<,-46
59,15,8.666666666666666,25.0,<,-16.333333333333336,0,0,=,0,26,75,<,-49,46.666666666666664,46.666666666666664,=,0.0,32,39,<,-7,59,51,>,8,182,136,>,46
0,15,25.0,23.0,>,2.0,0,0,=,0,75,69,>,6,46.666666666666664,49.666666666666664,<,-3.0,39,31,>,8,51,59,<,-8,136,228,<,-92
81,15,23.0,25.0,<,-2.0,0,0,=,0,69,75,<,-6,49.666666666666664,46.666666666666664,>,3.0,31,39,<,-8,59,51,>,8,228,136,>,92
0,15,25.0,24.0,>,1.0,0,0,=,0,75,72,>,3,46.666666666666664,41.0,>,5.666666666666664,39,38,>,1,51,45,>,6,136,233,<,-97
97,15,24.0,25.0,<,-1.0,0,0,=,0,72,75,<,-3,41.0,46.666666666666664,<,-5.666666666666664,38,39,<,-1,45,51,<,-6,233,136,>,97
0,15,25.0,28.0,<,-3.0,0,0,=,0,75,84,<,-9,46.666666666666664,53.333333333333336,<,-6.666666666666671,39,46,<,-7,51,57,<,-6,136,220,<,-84
99,15,28.0,25.0,>,3.0,0,0,=,0,84,75,>,9,53.333333333333336,46.666666666666664,>,6.666666666666671,46,39,>,7,57,51,>,6,220,136,>,84
0,15,25.0,28.0,<,-3.0,0,0,=,0,75,84,<,-9,46.666666666666664,47.666666666666664,<,-1.0,39,32,>,7,51,58,<,-7,136,248,<,-112
118,15,28.0,25.0,>,3.0,0,0,=,0,84,75,>,9,47.666666666666664,46.666666666666664,>,1.0,32,39,<,-7,58,51,>,7,248,136,>,112
0,14,30.333333333333332,16.333333333333332,>,14.0,0,0,=,0,80,36,>,44,45.666666666666664,47.666666666666664,<,-2.0,40,38,>,2,49,58,<,-9,130,113,>,17
0,14,16.333333333333332,30.333333333333332,<,-14.0,0,0,=,0,36,80,<,-44,47.666666666666664,45.666666666666664,>,2.0,38,40,<,-2,58,49,>,9,113,130,<,-17
0,14,30.333333333333332,36.666666666666664,<,-6.333333333333332,0,0,=,0,80,67,>,13,45.666666666666664,41.0,>,4.666666666666664,40,33,>,7,49,49,=,0,130,148,<,-18
51,14,36.666666666666664,30.333333333333332,>,6.333333333333332,0,0,=,0,67,80,<,-13,41.0,45.666666666666664,<,-4.666666666666664,33,40,<,-7,49,49,=,0,148,130,>,18
0,14,30.333333333333332,48.666666666666664,<,-18.333333333333332,0,0,=,0,80,80,=,0,45.666666666666664,52.333333333333336,<,-6.666666666666671,40,40,=,0,49,60,<,-11,130,175,<,-45
37,14,48.666666666666664,30.333333333333332,>,18.333333333333332,0,0,=,0,80,80,=,0,52.333333333333336,45.666666666666664,>,6.666666666666671,40,40,=,0,60,49,>,11,175,130,>,45
0,14,30.333333333333332,34.0,<,-3.666666666666668,0,0,=,0,80,83,<,-3,45.666666666666664,37.666666666666664,>,8.0,40,31,>,9,49,42,>,7,130,144,<,-14
28,14,34.0,30.333333333333332,>,3.666666666666668,0,0,=,0,83,80,>,3,37.666666666666664,45.666666666666664,<,-8.0,31,40,<,-9,42,49,<,-7,144,130,>,14
0,14,30.333333333333332,24.666666666666668,>,5.666666666666664,0,0,=,0,80,41,>,39,45.666666666666664,40.333333333333336,>,5.333333333333329,40,30,>,10,49,47,>,2,130,175,<,-45
77,14,24.666666666666668,30.333333333333332,<,-5.666666666666664,0,0,=,0,41,80,<,-39,40.333333333333336,45.666666666666664,<,-5.333333333333329,30,40,<,-10,47,49,<,-2,175,130,>,45
0,14,30.333333333333332,12.666666666666666,>,17.666666666666664,0,0,=,0,80,28,>,52,45.666666666666664,37.0,>,8.666666666666664,40,30,>,10,49,43,>,6,130,104,>,26
0,14,12.666666666666666,30.333333333333332,<,-17.666666666666664,0,0,=,0,28,80,<,-52,37.0,45.666666666666664,<,-8.666666666666664,30,40,<,-10,43,49,<,-6,104,130,<,-26
0,14,30.333333333333332,33.666666666666664,<,-3.333333333333332,0,0,=,0,80,59,>,21,45.666666666666664,46.333333333333336,<,-0.6666666666666714,40,33,>,7,49,54,<,-5,130,226,<,-96
147,14,33.666666666666664,30.333333333333332,>,3.333333333333332,0,0,=,0,59,80,<,-21,46.333333333333336,45.666666666666664,>,0.6666666666666714,33,40,<,-7,54,49,>,5,226,130,>,96
0,14,30.333333333333332,31.666666666666668,<,-1.3333333333333357,0,0,=,0,80,69,>,11,45.666666666666664,46.666666666666664,<,-1.0,40,32,>,8,49,59,<,-10,130,182,<,-52
81,14,31.666666666666668,30.333333333333332,>,1.3333333333333357,0,0,=,0,69,80,<,-11,46.666666666666664,45.666666666666664,>,1.0,32,40,<,-8,59,49,>,10,182,130,>,52
0,14,30.333333333333332,26.666666666666668,>,3.6666666666666643,0,0,=,0,80,43,>,37,45.666666666666664,53.666666666666664,<,-8.0,40,46,<,-6,49,60,<,-11,130,213,<,-83
79,14,26.666666666666668,30.333333333333332,<,-3.6666666666666643,0,0,=,0,43,80,<,-37,53.666666666666664,45.666666666666664,>,8.0,46,40,>,6,60,49,>,11,213,130,>,83
0,14,30.333333333333332,45.0,<,-14.666666666666668,0,0,=,0,80,69,>,11,45.666666666666664,49.666666666666664,<,-4.0,40,31,>,9,49,59,<,-10,130,228,<,-98
149,14,45.0,30.333333333333332,>,14.666666666666668,0,0,=,0,69,80,<,-11,49.666666666666664,45.666666666666664,>,4.0,31,40,<,-9,59,49,>,10,228,130,>,98
0,14,30.333333333333332,49.666666666666664,<,-19.333333333333332,0,0,=,0,80,77,>,3,45.666666666666664,41.0,>,4.666666666666664,40,38,>,2,49,45,>,4,130,233,<,-103
103,14,49.666666666666664,30.333333333333332,>,19.333333333333332,0,0,=,0,77,80,<,-3,41.0,45.666666666666664,<,-4.666666666666664,38,40,<,-2,45,49,<,-4,233,130,>,103
0,14,30.333333333333332,50.333333333333336,<,-20.000000000000004,0,0,=,0,80,84,<,-4,45.666666666666664,53.333333333333336,<,-7.666666666666671,40,46,<,-6,49,57,<,-8,130,220,<,-90
158,14,50.333333333333336,30.333333333333332,>,20.000000000000004,0,0,=,0,84,80,>,4,53.333333333333336,45.666666666666664,>,7.666666666666671,46,40,>,6,57,49,>,8,220,130,>,90
0,14,30.333333333333332,48.666666666666664,<,-18.333333333333332,0,0,=,0,80,84,<,-4,45.666666666666664,47.666666666666664,<,-2.0,40,32,>,8,49,58,<,-9,130,248,<,-118
177,14,48.666666666666664,30.333333333333332,>,18.333333333333332,0,0,=,0,84,80,>,4,47.666666666666664,45.666666666666664,>,2.0,32,40,<,-8,58,49,>,9,248,130,>,118
0,13,23.666666666666668,12.333333333333334,>,11.333333333333334,0,0,=,0,58,27,>,31,47.666666666666664,37.0,>,10.666666666666664,38,30,>,8,58,43,>,15,113,104,>,9
0,13,12.333333333333334,23.666666666666668,<,-11.333333333333334,0,0,=,0,27,58,<,-31,37.0,47.666666666666664,<,-10.666666666666664,30,38,<,-8,43,58,<,-15,104,113,<,-9
0,13,23.666666666666668,29.0,<,-5.333333333333332,0,0,=,0,58,68,<,-10,47.666666666666664,37.666666666666664,>,10.0,38,31,>,7,58,42,>,16,113,144,<,-31
28,13,29.0,23.666666666666668,>,5.333333333333332,0,0,=,0,68,58,>,10,37.666666666666664,47.666666666666664,<,-10.0,31,38,<,-7,42,58,<,-16,144,113,>,31
0,13,23.666666666666668,33.666666666666664,<,-9.999999999999996,0,0,=,0,58,80,<,-22,47.666666666666664,52.333333333333336,<,-4.666666666666671,38,40,<,-2,58,60,<,-2,113,175,<,-62
33,13,33.666666666666664,23.666666666666668,>,9.999999999999996,0,0,=,0,80,58,>,22,52.333333333333336,47.666666666666664,>,4.666666666666671,40,38,>,2,60,58,>,2,175,113,>,62
0,13,23.666666666666668,22.0,>,1.6666666666666679,0,0,=,0,58,43,>,15,47.666666666666664,41.0,>,6.666666666666664,38,33,>,5,58,49,>,9,113,148,<,-35
0,13,22.0,23.666666666666668,<,-1.6666666666666679,0,0,=,0,43,58,<,-15,41.0,47.666666666666664,<,-6.666666666666664,33,38,<,-5,49,58,<,-9,148,113,>,35
0,13,23.666666666666668,43.0,<,-19.333333333333332,0,0,=,0,58,88,<,-30,47.666666666666664,40.333333333333336,>,7.333333333333329,38,30,>,8,58,47,>,11,113,175,<,-62
77,13,43.0,23.666666666666668,>,19.333333333333332,0,0,=,0,88,58,>,30,40.333333333333336,47.666666666666664,<,-7.333333333333329,30,38,<,-8,47,58,<,-11,175,113,>,62
0,13,23.666666666666668,27.666666666666668,<,-4.0,0,0,=,0,58,43,>,15,47.666666666666664,53.666666666666664,<,-6.0,38,46,<,-8,58,60,<,-2,113,213,<,-100
34,13,27.666666666666668,23.666666666666668,>,4.0,0,0,=,0,43,58,<,-15,53.666666666666664,47.666666666666664,>,6.0,46,38,>,8,60,58,>,2,213,113,>,100
0,13,23.666666666666668,33.0,<,-9.333333333333332,0,0,=,0,58,69,<,-11,47.666666666666664,46.666666666666664,>,1.0,38,32,>,6,58,59,<,-1,113,182,<,-69
32,13,33.0,23.666666666666668,>,9.333333333333332,0,0,=,0,69,58,>,11,46.666666666666664,47.666666666666664,<,-1.0,32,38,<,-6,59,58,>,1,182,113,>,69
0,13,23.666666666666668,55.333333333333336,<,-31.666666666666668,0,0,=,0,58,89,<,-31,47.666666666666664,41.0,>,6.666666666666664,38,38,=,0,58,45,>,13,113,233,<,-120
103,13,55.333333333333336,23.666666666666668,>,31.666666666666668,0,0,=,0,89,58,>,31,41.0,47.666666666666664,<,-6.666666666666664,38,38,=,0,45,58,<,-13,233,113,>,120
0,13,23.666666666666668,39.0,<,-15.333333333333332,0,0,=,0,58,59,<,-1,47.666666666666664,46.333333333333336,>,1.3333333333333286,38,33,>,5,58,54,>,4,113,226,<,-113
147,13,39.0,23.666666666666668,>,15.333333333333332,0,0,=,0,59,58,>,1,46.333333333333336,47.666666666666664,<,-1.3333333333333286,33,38,<,-5,54,58,<,-4,226,113,>,113
0,13,23.666666666666668,51.666666666666664,<,-27.999999999999996,0,0,=,0,58,89,<,-31,47.666666666666664,49.666666666666664,<,-2.0,38,31,>,7,58,59,<,-1,113,228,<,-115
149,13,51.666666666666664,23.666666666666668,>,27.999999999999996,0,0,=,0,89,58,>,31,49.666666666666664,47.666666666666664,>,2.0,31,38,<,-7,59,58,>,1,228,113,>,115
0,13,23.666666666666668,47.666666666666664,<,-23.999999999999996,0,0,=,0,58,76,<,-18,47.666666666666664,53.333333333333336,<,-5.666666666666671,38,46,<,-8,58,57,>,1,113,220,<,-107
158,13,47.666666666666664,23.666666666666668,>,23.999999999999996,0,0,=,0,76,58,>,18,53.333333333333336,47.666666666666664,>,5.666666666666671,46,38,>,8,57,58,<,-1,220,113,>,107
0,13,23.666666666666668,25.0,<,-1.3333333333333321,0,0,=,0,58,62,<,-4,47.666666666666664,47.666666666666664,=,0.0,38,32,>,6,58,58,=,0,113,248,<,-135
37,13,25.0,23.666666666666668,>,1.3333333333333321,0,0,=,0,62,58,>,4,47.666666666666664,47.666666666666664,=,0.0,32,38,<,-6,58,58,=,0,248,113,>,135
0,12,27.0,17.333333333333332,>,9.666666666666668,15,10,>,5,43,27,>,16,41.0,37.0,>,4.0,33,30,>,3,49,43,>,6,148,104,>,44
0,12,17.333333333333332,27.0,<,-9.666666666666668,10,15,<,-5,27,43,<,-16,37.0,41.0,<,-4.0,30,33,<,-3,43,49,<,-6,104,148,<,-44
0,12,27.0,46.666666666666664,<,-19.666666666666664,15,19,<,-4,43,68,<,-25,41.0,37.666666666666664,>,3.3333333333333357,33,31,>,2,49,42,>,7,148,144,>,4
28,12,46.666666666666664,27.0,>,19.666666666666664,19,15,>,4,68,43,>,25,37.666666666666664,41.0,<,-3.3333333333333357,31,33,<,-2,42,49,<,-7,144,148,<,-4
0,12,27.0,51.0,<,-24.0,15,30,<,-15,43,69,<,-26,41.0,46.666666666666664,<,-5.666666666666664,33,32,>,1,49,59,<,-10,148,182,<,-34
32,12,51.0,27.0,>,24.0,30,15,>,15,69,43,>,26,46.666666666666664,41.0,>,5.666666666666664,32,33,<,-1,59,49,>,10,182,148,>,34
0,12,27.0,52.333333333333336,<,-25.333333333333336,15,21,<,-6,43,80,<,-37,41.0,52.333333333333336,<,-11.333333333333336,33,40,<,-7,49,60,<,-11,148,175,<,-27
33,12,52.333333333333336,27.0,>,25.333333333333336,21,15,>,6,80,43,>,37,52.333333333333336,41.0,>,11.333333333333336,40,33,>,7,60,49,>,11,175,148,>,27
0,12,27.0,55.666666666666664,<,-28.666666666666664,15,40,<,-25,43,84,<,-41,41.0,53.666666666666664,<,-12.666666666666664,33,46,<,-13,49,60,<,-11,148,213,<,-65
34,12,55.666666666666664,27.0,>,28.666666666666664,40,15,>,25,84,43,>,41,53.666666666666664,41.0,>,12.666666666666664,46,33,>,13,60,49,>,11,213,148,>,65
0,12,27.0,35.666666666666664,<,-8.666666666666664,15,13,>,2,43,62,<,-19,41.0,47.666666666666664,<,-6.666666666666664,33,32,>,1,49,58,<,-9,148,248,<,-100
37,12,35.666666666666664,27.0,>,8.666666666666664,13,15,<,-2,62,43,>,19,47.666666666666664,41.0,>,6.666666666666664,32,33,<,-1,58,49,>,9,248,148,>,100
0,12,27.0,47.666666666666664,<,-20.666666666666664,15,14,>,1,43,88,<,-45,41.0,40.333333333333336,>,0.6666666666666643,33,30,>,3,49,47,>,2,148,175,<,-27
0,12,47.666666666666664,27.0,>,20.666666666666664,14,15,<,-1,88,43,>,45,40.333333333333336,41.0,<,-0.6666666666666643,30,33,<,-3,47,49,<,-2,175,148,>,27
0,12,27.0,80.33333333333333,<,-53.33333333333333,15,75,<,-60,43,89,<,-46,41.0,41.0,=,0.0,33,38,<,-5,49,45,>,4,148,233,<,-85
159,12,80.33333333333333,27.0,>,53.33333333333333,75,15,>,60,89,43,>,46,41.0,41.0,=,0.0,38,33,>,5,45,49,<,-4,233,148,>,85
0,12,27.0,60.0,<,-33.0,15,58,<,-43,43,63,<,-20,41.0,46.333333333333336,<,-5.333333333333336,33,33,=,0,49,54,<,-5,148,226,<,-78
147,12,60.0,27.0,>,33.0,58,15,>,43,63,43,>,20,46.333333333333336,41.0,>,5.333333333333336,33,33,=,0,54,49,>,5,226,148,>,78
0,12,27.0,68.66666666666667,<,-41.66666666666667,15,51,<,-36,43,89,<,-46,41.0,49.666666666666664,<,-8.666666666666664,33,31,>,2,49,59,<,-10,148,228,<,-80
149,12,68.66666666666667,27.0,>,41.66666666666667,51,15,>,36,89,43,>,46,49.666666666666664,41.0,>,8.666666666666664,31,33,<,-2,59,49,>,10,228,148,>,80
0,12,27.0,64.33333333333333,<,-37.33333333333333,15,50,<,-35,43,76,<,-33,41.0,53.333333333333336,<,-12.333333333333336,33,46,<,-13,49,57,<,-8,148,220,<,-72
159,12,64.33333333333333,27.0,>,37.33333333333333,50,15,>,35,76,43,>,33,53.333333333333336,41.0,>,12.333333333333336,46,33,>,13,57,49,>,8,220,148,>,72
0,11,35.0,32.666666666666664,>,2.3333333333333357,14,10,>,4,50,73,<,-23,40.333333333333336,37.0,>,3.3333333333333357,30,30,=,0,47,43,>,4,175,104,>,71
0,11,32.666666666666664,35.0,<,-2.3333333333333357,10,14,<,-4,73,50,>,23,37.0,40.333333333333336,<,-3.3333333333333357,30,30,=,0,43,47,<,-4,104,175,<,-71
0,11,35.0,29.0,>,6.0,14,15,<,-1,50,53,<,-3,40.333333333333336,37.666666666666664,>,2.6666666666666714,30,31,<,-1,47,42,>,5,175,144,>,31
28,11,29.0,35.0,<,-6.0,15,14,>,1,53,50,>,3,37.666666666666664,40.333333333333336,<,-2.6666666666666714,31,30,>,1,42,47,<,-5,144,175,<,-31
0,11,35.0,46.666666666666664,<,-11.666666666666664,14,17,<,-3,50,69,<,-19,40.333333333333336,46.666666666666664,<,-6.333333333333329,30,32,<,-2,47,59,<,-12,175,182,<,-7
55,11,46.666666666666664,35.0,>,11.666666666666664,17,14,>,3,69,50,>,19,46.666666666666664,40.333333333333336,>,6.333333333333329,32,30,>,2,59,47,>,12,182,175,>,7
0,11,35.0,72.33333333333333,<,-37.33333333333333,14,56,<,-42,50,81,<,-31,40.333333333333336,52.333333333333336,<,-12.0,30,40,<,-10,47,60,<,-13,175,175,=,0
161,11,72.33333333333333,35.0,>,37.33333333333333,56,14,>,42,81,50,>,31,52.333333333333336,40.333333333333336,>,12.0,40,30,>,10,60,47,>,13,175,175,=,0
0,11,35.0,47.333333333333336,<,-12.333333333333336,14,15,<,-1,50,84,<,-34,40.333333333333336,53.666666666666664,<,-13.333333333333329,30,46,<,-16,47,60,<,-13,175,213,<,-38
0,11,47.333333333333336,35.0,>,12.333333333333336,15,14,>,1,84,50,>,34,53.666666666666664,40.333333333333336,>,13.333333333333329,46,30,>,16,60,47,>,13,213,175,>,38
0,11,35.0,41.0,<,-6.0,14,29,<,-15,50,62,<,-12,40.333333333333336,47.666666666666664,<,-7.333333333333329,30,32,<,-2,47,58,<,-11,175,248,<,-73
56,11,41.0,35.0,>,6.0,29,14,>,15,62,50,>,12,47.666666666666664,40.333333333333336,>,7.333333333333329,32,30,>,2,58,47,>,11,248,175,>,73
0,11,35.0,66.0,<,-31.0,14,59,<,-45,50,76,<,-26,40.333333333333336,46.333333333333336,<,-6.0,30,33,<,-3,47,54,<,-7,175,226,<,-51
181,11,66.0,35.0,>,31.0,59,14,>,45,76,50,>,26,46.333333333333336,40.333333333333336,>,6.0,33,30,>,3,54,47,>,7,226,175,>,51
0,11,35.0,68.66666666666667,<,-33.66666666666667,14,51,<,-37,50,89,<,-39,40.333333333333336,49.666666666666664,<,-9.333333333333329,30,31,<,-1,47,59,<,-12,175,228,<,-53
149,11,68.66666666666667,35.0,>,33.66666666666667,51,14,>,37,89,50,>,39,49.666666666666664,40.333333333333336,>,9.333333333333329,31,30,>,1,59,47,>,12,228,175,>,53
0,11,35.0,67.66666666666667,<,-32.66666666666667,14,50,<,-36,50,86,<,-36,40.333333333333336,53.333333333333336,<,-13.0,30,46,<,-16,47,57,<,-10,175,220,<,-45
159,11,67.66666666666667,35.0,>,32.66666666666667,50,14,>,36,86,50,>,36,53.333333333333336,40.333333333333336,>,13.0,46,30,>,16,57,47,>,10,220,175,>,45
0,11,35.0,77.66666666666667,<,-42.66666666666667,14,75,<,-61,50,81,<,-31,40.333333333333336,41.0,<,-0.6666666666666643,30,38,<,-8,47,45,>,2,175,233,<,-58
128,11,77.66666666666667,35.0,>,42.66666666666667,75,14,>,61,81,50,>,31,41.0,40.333333333333336,>,0.6666666666666643,38,30,>,8,45,47,<,-2,233,175,>,58
0,10,31.0,51.666666666666664,<,-20.666666666666664,15,10,>,5,43,73,<,-30,53.666666666666664,37.0,>,16.666666666666664,46,30,>,16,60,43,>,17,213,104,>,109
0,10,51.666666666666664,31.0,>,20.666666666666664,10,15,<,-5,73,43,>,30,37.0,53.666666666666664,<,-16.666666666666664,30,46,<,-16,43,60,<,-17,104,213,<,-109
0,10,31.0,15.0,>,16.0,15,11,>,4,43,19,>,24,53.666666666666664,37.666666666666664,>,16.0,46,31,>,15,60,42,>,18,213,144,>,69
0,10,15.0,31.0,<,-16.0,11,15,<,-4,19,43,<,-24,37.666666666666664,53.666666666666664,<,-16.0,31,46,<,-15,42,60,<,-18,144,213,<,-69
0,10,31.0,45.0,<,-14.0,15,17,<,-2,43,69,<,-26,53.666666666666664,46.666666666666664,>,7.0,46,32,>,14,60,59,>,1,213,182,>,31
50,10,45.0,31.0,>,14.0,17,15,>,2,69,43,>,26,46.666666666666664,53.666666666666664,<,-7.0,32,46,<,-14,59,60,<,-1,182,213,<,-31
0,10,31.0,42.333333333333336,<,-11.333333333333336,15,29,<,-14,43,62,<,-19,53.666666666666664,47.666666666666664,>,6.0,46,32,>,14,60,58,>,2,213,248,<,-35
56,10,42.333333333333336,31.0,>,11.333333333333336,29,15,>,14,62,43,>,19,47.666666666666664,53.666666666666664,<,-6.0,32,46,<,-14,58,60,<,-2,248,213,>,35
0,10,31.0,58.666666666666664,<,-27.666666666666664,15,18,<,-3,43,81,<,-38,53.666666666666664,41.0,>,12.666666666666664,46,38,>,8,60,45,>,15,213,233,<,-20
59,10,58.666666666666664,31.0,>,27.666666666666664,18,15,>,3,81,43,>,38,41.0,53.666666666666664,<,-12.666666666666664,38,46,<,-8,45,60,<,-15,233,213,>,20
0,10,31.0,81.66666666666667,<,-50.66666666666667,15,66,<,-51,43,90,<,-47,53.666666666666664,49.666666666666664,>,4.0,46,31,>,15,60,59,>,1,213,228,<,-15
191,10,81.66666666666667,31.0,>,50.66666666666667,66,15,>,51,90,43,>,47,49.666666666666664,53.666666666666664,<,-4.0,31,46,<,-15,59,60,<,-1,228,213,>,15
0,10,31.0,70.0,<,-39.0,15,57,<,-42,43,86,<,-43,53.666666666666664,53.333333333333336,>,0.3333333333333286,46,46,=,0,60,57,>,3,213,220,<,-7
147,10,70.0,31.0,>,39.0,57,15,>,42,86,43,>,43,53.333333333333336,53.666666666666664,<,-0.3333333333333286,46,46,=,0,57,60,<,-3,220,213,>,7
0,10,31.0,82.0,<,-51.0,15,80,<,-65,43,85,<,-42,53.666666666666664,52.333333333333336,>,1.3333333333333286,46,40,>,6,60,60,=,0,213,175,>,38
225,10,82.0,31.0,>,51.0,80,15,>,65,85,43,>,42,52.333333333333336,53.666666666666664,<,-1.3333333333333286,40,46,<,-6,60,60,=,0,175,213,<,-38
0,10,31.0,60.333333333333336,<,-29.333333333333336,15,46,<,-31,43,76,<,-33,53.666666666666664,46.333333333333336,>,7.333333333333329,46,33,>,13,60,54,>,6,213,226,<,-13
141,10,60.333333333333336,31.0,>,29.333333333333336,46,15,>,31,76,43,>,33,46.333333333333336,53.666666666666664,<,-7.333333333333329,33,46,<,-13,54,60,<,-6,226,213,>,13
0,9,30.666666666666668,33.333333333333336,<,-2.666666666666668,10,11,<,-1,72,70,>,2,37.0,37.666666666666664,<,-0.6666666666666643,30,31,<,-1,43,42,>,1,104,144,<,-40
0,9,33.333333333333336,30.666666666666668,>,2.666666666666668,11,10,>,1,70,72,<,-2,37.666666666666664,37.0,>,0.6666666666666643,31,30,>,1,42,43,<,-1,144,104,>,40
0,9,30.666666666666668,45.666666666666664,<,-14.999999999999996,10,19,<,-9,72,69,>,3,37.0,46.666666666666664,<,-9.666666666666664,30,32,<,-2,43,59,<,-16,104,182,<,-78
50,9,45.666666666666664,30.666666666666668,>,14.999999999999996,19,10,>,9,69,72,<,-3,46.666666666666664,37.0,>,9.666666666666664,32,30,>,2,59,43,>,16,182,104,>,78
0,9,30.666666666666668,58.333333333333336,<,-27.666666666666668,10,36,<,-26,72,77,<,-5,37.0,47.666666666666664,<,-10.666666666666664,30,32,<,-2,43,58,<,-15,104,248,<,-144
62,9,58.333333333333336,30.666666666666668,>,27.666666666666668,36,10,>,26,77,72,>,5,47.666666666666664,37.0,>,10.666666666666664,32,30,>,2,58,43,>,15,248,104,>,144
0,9,30.666666666666668,40.0,<,-9.333333333333332,10,18,<,-8,72,77,<,-5,37.0,41.0,<,-4.0,30,38,<,-8,43,45,<,-2,104,233,<,-129
0,9,40.0,30.666666666666668,>,9.333333333333332,18,10,>,8,77,72,>,5,41.0,37.0,>,4.0,38,30,>,8,45,43,>,2,233,104,>,129
0,9,30.666666666666668,52.333333333333336,<,-21.666666666666668,10,46,<,-36,72,59,>,13,37.0,46.333333333333336,<,-9.333333333333336,30,33,<,-3,43,54,<,-11,104,226,<,-122
72,9,52.333333333333336,30.666666666666668,>,21.666666666666668,46,10,>,36,59,72,<,-13,46.333333333333336,37.0,>,9.333333333333336,33,30,>,3,54,43,>,11,226,104,>,122
0,9,30.666666666666668,51.333333333333336,<,-20.666666666666668,10,30,<,-20,72,67,>,5,37.0,53.333333333333336,<,-16.333333333333336,30,46,<,-16,43,57,<,-14,104,220,<,-116
61,9,51.333333333333336,30.666666666666668,>,20.666666666666668,30,10,>,20,67,72,<,-5,53.333333333333336,37.0,>,16.333333333333336,46,30,>,16,57,43,>,14,220,104,>,116
0,9,30.666666666666668,81.66666666666667,<,-51.0,10,66,<,-56,72,90,<,-18,37.0,49.666666666666664,<,-12.666666666666664,30,31,<,-1,43,59,<,-16,104,228,<,-124
108,9,81.66666666666667,30.666666666666668,>,51.0,66,10,>,56,90,72,>,18,49.666666666666664,37.0,>,12.666666666666664,31,30,>,1,59,43,>,16,228,104,>,124
0,9,30.666666666666668,81.0,<,-50.33333333333333,10,78,<,-68,72,85,<,-13,37.0,52.333333333333336,<,-15.333333333333336,30,40,<,-10,43,60,<,-17,104,175,<,-71
138,9,81.0,30.666666666666668,>,50.33333333333333,78,10,>,68,85,72,>,13,52.333333333333336,37.0,>,15.333333333333336,40,30,>,10,60,43,>,17,175,104,>,71
0,8,29.666666666666668,52.666666666666664,<,-22.999999999999996,18,11,>,7,46,77,<,-31,41.0,37.666666666666664,>,3.3333333333333357,38,31,>,7,45,42,>,3,233,144,>,89
0,8,52.666666666666664,29.666666666666668,>,22.999999999999996,11,18,<,-7,77,46,>,31,37.666666666666664,41.0,<,-3.3333333333333357,31,38,<,-7,42,45,<,-3,144,233,<,-89
0,8,29.666666666666668,34.666666666666664,<,-4.9999999999999964,18,19,<,-1,46,49,<,-3,41.0,46.666666666666664,<,-5.666666666666664,38,32,>,6,45,59,<,-14,233,182,>,51
0,8,34.666666666666664,29.666666666666668,>,4.9999999999999964,19,18,>,1,49,46,>,3,46.666666666666664,41.0,>,5.666666666666664,32,38,<,-6,59,45,>,14,182,233,<,-51
0,8,29.666666666666668,49.666666666666664,<,-19.999999999999996,18,30,<,-12,46,62,<,-16,41.0,53.333333333333336,<,-12.333333333333336,38,46,<,-8,45,57,<,-12,233,220,>,13
61,8,49.666666666666664,29.666666666666668,>,19.999999999999996,30,18,>,12,62,46,>,16,53.333333333333336,41.0,>,12.333333333333336,46,38,>,8,57,45,>,12,220,233,<,-13
0,8,29.666666666666668,50.0,<,-20.333333333333332,18,36,<,-18,46,77,<,-31,41.0,47.666666666666664,<,-6.666666666666664,38,32,>,6,45,58,<,-13,233,248,<,-15
62,8,50.0,29.666666666666668,>,20.333333333333332,36,18,>,18,77,46,>,31,47.666666666666664,41.0,>,6.666666666666664,32,38,<,-6,58,45,>,13,248,233,>,15
0,8,29.666666666666668,47.0,<,-17.333333333333332,18,43,<,-25,46,52,<,-6,41.0,46.333333333333336,<,-5.333333333333336,38,33,>,5,45,54,<,-9,233,226,>,7
72,8,47.0,29.666666666666668,>,17.333333333333332,43,18,>,25,52,46,>,6,46.333333333333336,41.0,>,5.333333333333336,33,38,<,-5,54,45,>,9,226,233,<,-7
0,8,29.666666666666668,86.66666666666667,<,-57.0,18,81,<,-63,46,90,<,-44,41.0,49.666666666666664,<,-8.666666666666664,38,31,>,7,45,59,<,-14,233,228,>,5
108,8,86.66666666666667,29.666666666666668,>,57.0,81,18,>,63,90,46,>,44,49.666666666666664,41.0,>,8.666666666666664,31,38,<,-7,59,45,>,14,228,233,<,-5
0,8,29.666666666666668,59.333333333333336,<,-29.666666666666668,18,15,>,3,46,85,<,-39,41.0,52.333333333333336,<,-11.333333333333336,38,40,<,-2,45,60,<,-15,233,175,>,58
21,8,59.333333333333336,29.666666666666668,>,29.666666666666668,15,18,<,-3,85,46,>,39,52.333333333333336,41.0,>,11.333333333333336,40,38,>,2,60,45,>,15,175,233,<,-58
0,7,49.333333333333336,56.0,<,-6.666666666666664,36,11,>,25,63,80,<,-17,46.666666666666664,37.666666666666664,>,9.0,32,31,>,1,59,42,>,17,182,144,>,38
0,7,56.0,49.333333333333336,>,6.666666666666664,11,36,<,-25,80,63,>,17,37.666666666666664,46.666666666666664,<,-9.0,31,32,<,-1,42,59,<,-17,144,182,<,-38
0,7,49.333333333333336,37.0,>,12.333333333333336,36,11,>,25,63,85,<,-22,46.666666666666664,52.333333333333336,<,-5.666666666666671,32,40,<,-8,59,60,<,-1,182,175,>,7
21,7,37.0,49.333333333333336,<,-12.333333333333336,11,36,<,-25,85,63,>,22,52.333333333333336,46.666666666666664,>,5.666666666666671,40,32,>,8,60,59,>,1,175,182,<,-7
0,7,49.333333333333336,55.666666666666664,<,-6.333333333333329,36,48,<,-12,63,62,>,1,46.666666666666664,53.333333333333336,<,-6.666666666666671,32,46,<,-14,59,57,>,2,182,220,<,-38
93,7,55.666666666666664,49.333333333333336,>,6.333333333333329,48,36,>,12,62,63,<,-1,53.333333333333336,46.666666666666664,>,6.666666666666671,46,32,>,14,57,59,<,-2,220,182,>,38
0,7,49.333333333333336,29.333333333333332,>,20.000000000000004,36,15,>,21,63,37,>,26,46.666666666666664,47.666666666666664,<,-1.0,32,32,=,0,59,58,>,1,182,248,<,-66
0,7,29.333333333333332,49.333333333333336,<,-20.000000000000004,15,36,<,-21,37,63,<,-26,47.666666666666664,46.666666666666664,>,1.0,32,32,=,0,58,59,<,-1,248,182,>,66
0,7,49.333333333333336,46.0,>,3.3333333333333357,36,43,<,-7,63,49,>,14,46.666666666666664,46.333333333333336,>,0.3333333333333286,32,33,<,-1,59,54,>,5,182,226,<,-44
114,7,46.0,49.333333333333336,<,-3.3333333333333357,43,36,>,7,49,63,<,-14,46.333333333333336,46.666666666666664,<,-0.3333333333333286,33,32,>,1,54,59,<,-5,226,182,>,44
0,7,49.333333333333336,75.0,<,-25.666666666666664,36,54,<,-18,63,90,<,-27,46.666666666666664,49.666666666666664,<,-3.0,32,31,>,1,59,59,=,0,182,228,<,-46
128,7,75.0,49.333333333333336,>,25.666666666666664,54,36,>,18,90,63,>,27,49.666666666666664,46.666666666666664,>,3.0,31,32,<,-1,59,59,=,0,228,182,>,46
0,6,49.0,28.333333333333332,>,20.666666666666668,11,15,<,-4,80,36,>,44,37.666666666666664,47.666666666666664,<,-10.0,31,32,<,-1,42,58,<,-16,144,248,<,-104
0,6,28.333333333333332,49.0,<,-20.666666666666668,15,11,>,4,36,80,<,-44,47.666666666666664,37.666666666666664,>,10.0,32,31,>,1,58,42,>,16,248,144,>,104
0,6,49.0,39.0,>,10.0,11,11,=,0,80,85,<,-5,37.666666666666664,52.333333333333336,<,-14.666666666666671,31,40,<,-9,42,60,<,-18,144,175,<,-31
84,6,39.0,49.0,<,-10.0,11,11,=,0,85,80,>,5,52.333333333333336,37.666666666666664,>,14.666666666666671,40,31,>,9,60,42,>,18,175,144,>,31
0,6,49.0,46.0,>,3.0,11,33,<,-22,80,57,>,23,37.666666666666664,53.333333333333336,<,-15.666666666666671,31,46,<,-15,42,57,<,-15,144,220,<,-76
74,6,46.0,49.0,<,-3.0,33,11,>,22,57,80,<,-23,53.333333333333336,37.666666666666664,>,15.666666666666671,46,31,>,15,57,42,>,15,220,144,>,76
0,6,49.0,49.666666666666664,<,-0.6666666666666643,11,46,<,-35,80,54,>,26,37.666666666666664,46.333333333333336,<,-8.666666666666671,31,33,<,-2,42,54,<,-12,144,226,<,-82
114,6,49.666666666666664,49.0,>,0.6666666666666643,46,11,>,35,54,80,<,-26,46.333333333333336,37.666666666666664,>,8.666666666666671,33,31,>,2,54,42,>,12,226,144,>,82
0,6,49.0,55.666666666666664,<,-6.666666666666664,11,23,<,-12,80,90,<,-10,37.666666666666664,49.666666666666664,<,-12.0,31,31,=,0,42,59,<,-17,144,228,<,-84
0,6,55.666666666666664,49.0,>,6.666666666666664,23,11,>,12,90,80,>,10,49.666666666666664,37.666666666666664,>,12.0,31,31,=,0,59,42,>,17,228,144,>,84
0,5,39.666666666666664,40.0,<,-0.3333333333333357,23,15,>,8,54,71,<,-17,49.666666666666664,47.666666666666664,>,2.0,31,32,<,-1,59,58,>,1,228,248,<,-20
0,5,40.0,39.666666666666664,>,0.3333333333333357,15,23,<,-8,71,54,>,17,47.666666666666664,49.666666666666664,<,-2.0,32,31,>,1,58,59,<,-1,248,228,>,20
0,5,39.666666666666664,52.0,<,-12.333333333333336,23,33,<,-10,54,75,<,-21,49.666666666666664,53.333333333333336,<,-3.6666666666666714,31,46,<,-15,59,57,>,2,228,220,>,8
74,5,52.0,39.666666666666664,>,12.333333333333336,33,23,>,10,75,54,>,21,53.333333333333336,49.666666666666664,>,3.6666666666666714,46,31,>,15,57,59,<,-2,220,228,<,-8
0,5,39.666666666666664,22.333333333333332,>,17.333333333333332,23,11,>,12,54,35,>,19,49.666666666666664,52.333333333333336,<,-2.6666666666666714,31,40,<,-9,59,60,<,-1,228,175,>,53
36,5,22.333333333333332,39.666666666666664,<,-17.333333333333332,11,23,<,-12,35,54,<,-19,52.333333333333336,49.666666666666664,>,2.6666666666666714,40,31,>,9,60,59,>,1,175,228,<,-53
0,5,39.666666666666664,38.333333333333336,>,1.3333333333333286,23,12,>,11,54,54,=,0,49.666666666666664,46.333333333333336,>,3.3333333333333286,31,33,<,-2,59,54,>,5,228,226,>,2
0,5,38.333333333333336,39.666666666666664,<,-1.3333333333333286,12,23,<,-11,54,54,=,0,46.333333333333336,49.666666666666664,<,-3.3333333333333286,33,31,>,2,54,59,<,-5,226,228,<,-2
0,4,44.333333333333336,44.666666666666664,<,-0.3333333333333286,12,15,<,-3,72,71,>,1,46.333333333333336,47.666666666666664,<,-1.3333333333333286,33,32,>,1,54,58,<,-4,226,248,<,-22
0,4,44.666666666666664,44.333333333333336,>,0.3333333333333286,15,12,>,3,71,72,<,-1,47.666666666666664,46.333333333333336,>,1.3333333333333286,32,33,<,-1,58,54,>,4,248,226,>,22
0,4,44.333333333333336,34.666666666666664,>,9.666666666666671,12,11,>,1,72,58,>,14,46.333333333333336,52.333333333333336,<,-6.0,33,40,<,-7,54,60,<,-6,226,175,>,51
36,4,34.666666666666664,44.333333333333336,<,-9.666666666666671,11,12,<,-1,58,72,<,-14,52.333333333333336,46.333333333333336,>,6.0,40,33,>,7,60,54,>,6,175,226,<,-51
0,4,44.333333333333336,47.666666666666664,<,-3.3333333333333286,12,20,<,-8,72,75,<,-3,46.333333333333336,53.333333333333336,<,-7.0,33,46,<,-13,54,57,<,-3,226,220,>,6
0,4,47.666666666666664,44.333333333333336,>,3.3333333333333286,20,12,>,8,75,72,>,3,53.333333333333336,46.333333333333336,>,7.0,46,33,>,13,57,54,>,3,220,226,<,-6
0,3,46.666666666666664,42.333333333333336,>,4.333333333333329,20,15,>,5,72,64,>,8,53.333333333333336,47.666666666666664,>,5.666666666666671,46,32,>,14,57,58,<,-1,220,248,<,-28
0,3,42.333333333333336,46.666666666666664,<,-4.333333333333329,15,20,<,-5,64,72,<,-8,47.666666666666664,53.333333333333336,<,-5.666666666666671,32,46,<,-14,58,57,>,1,248,220,>,28
0,3,46.666666666666664,30.333333333333332,>,16.333333333333332,20,11,>,9,72,58,>,14,53.333333333333336,52.333333333333336,>,1.0,46,40,>,6,57,60,<,-3,220,175,>,45
0,3,30.333333333333332,46.666666666666664,<,-16.333333333333332,11,20,<,-9,58,72,<,-14,52.333333333333336,53.333333333333336,<,-1.0,40,46,<,-6,60,57,>,3,175,220,<,-45
0,2,33.666666666666664,37.0,<,-3.3333333333333357,11,15,<,-4,68,64,>,4,52.333333333333336,47.666666666666664,>,4.666666666666671,40,32,>,8,60,58,>,2,175,248,<,-73
0,2,37.0,33.666666666666664,>,3.3333333333333357,15,11,>,4,64,68,<,-4,47.666666666666664,52.333333333333336,<,-4.666666666666671,32,40,<,-8,58,60,<,-2,248,175,>,73
0,12,0.0,0.0,=,0.0,0,0,=,0,0,0,=,0,42.333333333333336,50.0,<,-7.666666666666664,32,33,<,-1,48,59,<,-11,89,123,<,-34
25,12,0.0,0.0,=,0.0,0,0,=,0,0,0,=,0,50.0,42.333333333333336,>,7.666666666666664,33,32,>,1,59,48,>,11,123,89,>,34
0,12,0.0,0.0,=,0.0,0,0,=,0,0,0,=,0,42.333333333333336,43.666666666666664,<,-1.3333333333333286,32,35,<,-3,48,52,<,-4,89,74,>,15
14,12,0.0,0.0,=,0.0,0,0,=,0,0,0,=,0,43.666666666666664,42.333333333333336,>,1.3333333333333286,35,32,>,3,52,48,>,4,74,89,<,-15
0,12,0.0,0.0,=,0.0,0,0,=,0,0,0,=,0,42.333333333333336,44.0,<,-1.6666666666666643,32,34,<,-2,48,54,<,-6,89,114,<,-25
0,12,0.0,0.0,=,0.0,0,0,=,0,0,0,=,0,44.0,42.333333333333336,>,1.6666666666666643,34,32,>,2,54,48,>,6,114,89,>,25
0,12,0.0,0.0,=,0.0,0,0,=,0,0,0,=,0,42.333333333333336,51.666666666666664,<,-9.333333333333329,32,44,<,-12,48,59,<,-11,89,73,>,16
29,12,0.0,0.0,=,0.0,0,0,=,0,0,0,=,0,51.666666666666664,42.333333333333336,>,9.333333333333329,44,32,>,12,59,48,>,11,73,89,<,-16
0,12,0.0,0.0,=,0.0,0,0,=,0,0,0,=,0,42.333333333333336,43.666666666666664,<,-1.3333333333333286,32,30,>,2,48,55,<,-7,89,143,<,-54
71,12,0.0,0.0,=,0.0,0,0,=,0,0,0,=,0,43.666666666666664,42.333333333333336,>,1.3333333333333286,30,32,<,-2,55,48,>,7,143,89,>,54
0,12,0.0,0.0,=,0.0,0,0,=,0,0,0,=,0,42.333333333333336,55.333333333333336,<,-13.0,32,48,<,-16,48,60,<,-12,89,174,<,-85
100,12,0.0,0.0,=,0.0,0,0,=,0,0,0,=,0,55.333333333333336,42.333333333333336,>,13.0,48,32,>,16,60,48,>,12,174,89,>,85
0,12,0.0,0.0,=,0.0,0,0,=,0,0,0,=,0,42.333333333333336,43.333333333333336,<,-1.0,32,31,>,1,48,52,<,-4,89,73,>,16
0,12,0.0,0.0,=,0.0,0,0,=,0,0,0,=,0,43.333333333333336,42.333333333333336,>,1.0,31,32,<,-1,52,48,>,4,73,89,<,-16
0,12,0.0,0.0,=,0.0,0,0,=,0,0,0,=,0,42.333333333333336,38.333333333333336,>,4.0,32,30,>,2,48,47,>,1,89,111,<,-22
42,12,0.0,0.0,=,0.0,0,0,=,0,0,0,=,0,38.333333333333336,42.333333333333336,<,-4.0,30,32,<,-2,47,48,<,-1,111,89,>,22
0,12,0.0,0.0,=,0.0,0,0,=,0,0,0,=,0,42.333333333333336,50.666666666666664,<,-8.333333333333329,32,38,<,-6,48,59,<,-11,89,140,<,-51
77,12,0.0,0.0,=,0.0,0,0,=,0,0,0,=,0,50.666666666666664,42.333333333333336,>,8.333333333333329,38,32,>,6,59,48,>,11,140,89,>,51
0,12,0.0,0.0,=,0.0,0,0,=,0,0,0,=,0,42.333333333333336,49.0,<,-6.666666666666664,32,43,<,-11,48,60,<,-12,89,97,<,-8
26,12,0.0,0.0,=,0.0,0,0,=,0,0,0,=,0,49.0,42.333333333333336,>,6.666666666666664,43,32,>,11,60,48,>,12,97,89,>,8
0,12,0.0,0.0,=,0.0,0,0,=,0,0,0,=,0,42.333333333333336,50.666666666666664,<,-8.333333333333329,32,37,<,-5,48,58,<,-10,89,143,<,-54
61,12,0.0,0.0,=,0.0,0,0,=,0,0,0,=,0,50.666666666666664,42.333333333333336,>,8.333333333333329,37,32,>,5,58,48,>,10,143,89,>,54
0,11,6.0,18.0,<,-12.0,0,0,=,0,18,54,<,-36,44.0,43.333333333333336,>,0.6666666666666643,34,31,>,3,54,52,>,2,114,73,>,41
0,11,18.0,6.0,>,12.0,0,0,=,0,54,18,>,36,43.333333333333336,44.0,<,-0.6666666666666643,31,34,<,-3,52,54,<,-2,73,114,<,-41
0,11,6.0,16.333333333333332,<,-10.333333333333332,0,0,=,0,18,49,<,-31,44.0,43.666666666666664,>,0.3333333333333357,34,35,<,-1,54,52,>,2,114,74,>,40
14,11,16.333333333333332,6.0,>,10.333333333333332,0,0,=,0,49,18,>,31,43.666666666666664,44.0,<,-0.3333333333333357,35,34,>,1,52,54,<,-2,74,114,<,-40
0,11,6.0,13.666666666666666,<,-7.666666666666666,0,0,=,0,18,41,<,-23,44.0,50.0,<,-6.0,34,33,>,1,54,59,<,-5,114,123,<,-9
35,11,13.666666666666666,6.0,>,7.666666666666666,0,0,=,0,41,18,>,23,50.0,44.0,>,6.0,33,34,<,-1,59,54,>,5,123,114,>,9
0,11,6.0,13.0,<,-7.0,0,0,=,0,18,39,<,-21,44.0,49.0,<,-5.0,34,43,<,-9,54,60,<,-6,114,97,>,17
26,11,13.0,6.0,>,7.0,0,0,=,0,39,18,>,21,49.0,44.0,>,5.0,43,34,>,9,60,54,>,6,97,114,<,-17
0,11,6.0,15.333333333333334,<,-9.333333333333334,0,0,=,0,18,46,<,-28,44.0,51.666666666666664,<,-7.666666666666664,34,44,<,-10,54,59,<,-5,114,73,>,41
35,11,15.333333333333334,6.0,>,9.333333333333334,0,0,=,0,46,18,>,28,51.666666666666664,44.0,>,7.666666666666664,44,34,>,10,59,54,>,5,73,114,<,-41
0,11,6.0,5.0,>,1.0,0,0,=,0,18,15,>,3,44.0,38.333333333333336,>,5.666666666666664,34,30,>,4,54,47,>,7,114,111,>,3
0,11,5.0,6.0,<,-1.0,0,0,=,0,15,18,<,-3,38.333333333333336,44.0,<,-5.666666666666664,30,34,<,-4,47,54,<,-7,111,114,<,-3
0,11,6.0,29.333333333333332,<,-23.333333333333332,0,0,=,0,18,88,<,-70,44.0,50.666666666666664,<,-6.666666666666664,34,37,<,-3,54,58,<,-4,114,143,<,-29
61,11,29.333333333333332,6.0,>,23.333333333333332,0,0,=,0,88,18,>,70,50.666666666666664,44.0,>,6.666666666666664,37,34,>,3,58,54,>,4,143,114,>,29
0,11,6.0,21.666666666666668,<,-15.666666666666668,0,0,=,0,18,65,<,-47,44.0,43.666666666666664,>,0.3333333333333357,34,30,>,4,54,55,<,-1,114,143,<,-29
122,11,21.666666666666668,6.0,>,15.666666666666668,0,0,=,0,65,18,>,47,43.666666666666664,44.0,<,-0.3333333333333357,30,34,<,-4,55,54,>,1,143,114,>,29
0,11,6.0,29.0,<,-23.0,0,0,=,0,18,87,<,-69,44.0,50.666666666666664,<,-6.666666666666664,34,38,<,-4,54,59,<,-5,114,140,<,-26
95,11,29.0,6.0,>,23.0,0,0,=,0,87,18,>,69,50.666666666666664,44.0,>,6.666666666666664,38,34,>,4,59,54,>,5,140,114,>,26
0,11,6.0,9.666666666666666,<,-3.666666666666666,0,0,=,0,18,29,<,-11,44.0,55.333333333333336,<,-11.333333333333336,34,48,<,-14,54,60,<,-6,114,174,<,-60
100,11,9.666666666666666,6.0,>,3.666666666666666,0,0,=,0,29,18,>,11,55.333333333333336,44.0,>,11.333333333333336,48,34,>,14,60,54,>,6,174,114,>,60
0,10,30.666666666666668,13.333333333333334,>,17.333333333333336,0,0,=,0,54,25,>,29,43.333333333333336,38.333333333333336,>,5.0,31,30,>,1,52,47,>,5,73,111,<,-38
0,10,13.333333333333334,30.666666666666668,<,-17.333333333333336,0,0,=,0,25,54,<,-29,38.333333333333336,43.333333333333336,<,-5.0,30,31,<,-1,47,52,<,-5,111,73,>,38
0,10,30.666666666666668,28.333333333333332,>,2.3333333333333357,0,0,=,0,54,49,>,5,43.333333333333336,43.666666666666664,<,-0.3333333333333286,31,35,<,-4,52,52,=,0,73,74,<,-1
14,10,28.333333333333332,30.666666666666668,<,-2.3333333333333357,0,0,=,0,49,54,<,-5,43.666666666666664,43.333333333333336,>,0.3333333333333286,35,31,>,4,52,52,=,0,74,73,>,1
0,10,30.666666666666668,16.666666666666668,>,14.0,0,0,=,0,54,39,>,15,43.333333333333336,49.0,<,-5.666666666666664,31,43,<,-12,52,60,<,-8,73,97,<,-24
0,10,16.666666666666668,30.666666666666668,<,-14.0,0,0,=,0,39,54,<,-15,49.0,43.333333333333336,>,5.666666666666664,43,31,>,12,60,52,>,8,97,73,>,24
0,10,30.666666666666668,40.666666666666664,<,-9.999999999999996,0,0,=,0,54,81,<,-27,43.333333333333336,50.0,<,-6.666666666666664,31,33,<,-2,52,59,<,-7,73,123,<,-50
35,10,40.666666666666664,30.666666666666668,>,9.999999999999996,0,0,=,0,81,54,>,27,50.0,43.333333333333336,>,6.666666666666664,33,31,>,2,59,52,>,7,123,73,>,50
0,10,30.666666666666668,34.333333333333336,<,-3.666666666666668,0,0,=,0,54,57,<,-3,43.333333333333336,51.666666666666664,<,-8.333333333333329,31,44,<,-13,52,59,<,-7,73,73,=,0
57,10,34.333333333333336,30.666666666666668,>,3.666666666666668,0,0,=,0,57,54,>,3,51.666666666666664,43.333333333333336,>,8.333333333333329,44,31,>,13,59,52,>,7,73,73,=,0
0,10,30.666666666666668,57.333333333333336,<,-26.666666666666668,0,0,=,0,54,88,<,-34,43.333333333333336,50.666666666666664,<,-7.333333333333329,31,37,<,-6,52,58,<,-6,73,143,<,-70
159,10,57.333333333333336,30.666666666666668,>,26.666666666666668,0,0,=,0,88,54,>,34,50.666666666666664,43.333333333333336,>,7.333333333333329,37,31,>,6,58,52,>,6,143,73,>,70
0,10,30.666666666666668,34.333333333333336,<,-3.666666666666668,0,0,=,0,54,87,<,-33,43.333333333333336,50.666666666666664,<,-7.333333333333329,31,38,<,-7,52,59,<,-7,73,140,<,-67
93,10,34.333333333333336,30.666666666666668,>,3.666666666666668,0,0,=,0,87,54,>,33,50.666666666666664,43.333333333333336,>,7.333333333333329,38,31,>,7,59,52,>,7,140,73,>,67
0,10,30.666666666666668,19.666666666666668,>,11.0,0,0,=,0,54,30,>,24,43.333333333333336,55.333333333333336,<,-12.0,31,48,<,-17,52,60,<,-8,73,174,<,-101
100,10,19.666666666666668,30.666666666666668,<,-11.0,0,0,=,0,30,54,<,-24,55.333333333333336,43.333333333333336,>,12.0,48,31,>,17,60,52,>,8,174,73,>,101
0,10,30.666666666666668,44.333333333333336,<,-13.666666666666668,0,0,=,0,54,68,<,-14,43.333333333333336,43.666666666666664,<,-0.3333333333333286,31,30,>,1,52,55,<,-3,73,143,<,-70
122,10,44.333333333333336,30.666666666666668,>,13.666666666666668,0,0,=,0,68,54,>,14,43.666666666666664,43.333333333333336,>,0.3333333333333286,30,31,<,-1,55,52,>,3,143,73,>,70
0,9,22.0,41.666666666666664,<,-19.666666666666664,15,11,>,4,26,75,<,-49,38.333333333333336,49.0,<,-10.666666666666664,30,43,<,-13,47,60,<,-13,111,97,>,14
0,9,41.666666666666664,22.0,>,19.666666666666664,11,15,<,-4,75,26,>,49,49.0,38.333333333333336,>,10.666666666666664,43,30,>,13,60,47,>,13,97,111,<,-14
0,9,22.0,52.333333333333336,<,-30.333333333333336,15,36,<,-21,26,72,<,-46,38.333333333333336,43.666666666666664,<,-5.333333333333329,30,35,<,-5,47,52,<,-5,111,74,>,37
83,9,52.333333333333336,22.0,>,30.333333333333336,36,15,>,21,72,26,>,46,43.666666666666664,38.333333333333336,>,5.333333333333329,35,30,>,5,52,47,>,5,74,111,<,-37
0,9,22.0,66.66666666666667,<,-44.66666666666667,15,41,<,-26,26,81,<,-55,38.333333333333336,50.0,<,-11.666666666666664,30,33,<,-3,47,59,<,-12,111,123,<,-12
35,9,66.66666666666667,22.0,>,44.66666666666667,41,15,>,26,81,26,>,55,50.0,38.333333333333336,>,11.666666666666664,33,30,>,3,59,47,>,12,123,111,>,12
0,9,22.0,44.0,<,-22.0,15,29,<,-14,26,57,<,-31,38.333333333333336,51.666666666666664,<,-13.333333333333329,30,44,<,-14,47,59,<,-12,111,73,>,38
0,9,44.0,22.0,>,22.0,29,15,>,14,57,26,>,31,51.666666666666664,38.333333333333336,>,13.333333333333329,44,30,>,14,59,47,>,12,73,111,<,-38
0,9,22.0,47.0,<,-25.0,15,16,<,-1,26,87,<,-61,38.333333333333336,50.666666666666664,<,-12.333333333333329,30,38,<,-8,47,59,<,-12,111,140,<,-29
31,9,47.0,22.0,>,25.0,16,15,>,1,87,26,>,61,50.666666666666664,38.333333333333336,>,12.333333333333329,38,30,>,8,59,47,>,12,140,111,>,29
0,9,22.0,35.666666666666664,<,-13.666666666666664,15,29,<,-14,26,48,<,-22,38.333333333333336,55.333333333333336,<,-17.0,30,48,<,-18,47,60,<,-13,111,174,<,-63
67,9,35.666666666666664,22.0,>,13.666666666666664,29,15,>,14,48,26,>,22,55.333333333333336,38.333333333333336,>,17.0,48,30,>,18,60,47,>,13,174,111,>,63
0,9,22.0,71.66666666666667,<,-49.66666666666667,15,65,<,-50,26,82,<,-56,38.333333333333336,43.666666666666664,<,-5.333333333333329,30,30,=,0,47,55,<,-8,111,143,<,-32
122,9,71.66666666666667,22.0,>,49.66666666666667,65,15,>,50,82,26,>,56,43.666666666666664,38.333333333333336,>,5.333333333333329,30,30,=,0,55,47,>,8,143,111,>,32
0,9,22.0,83.0,<,-61.0,15,77,<,-62,26,88,<,-62,38.333333333333336,50.666666666666664,<,-12.333333333333329,30,37,<,-7,47,58,<,-11,111,143,<,-32
125,9,83.0,22.0,>,61.0,77,15,>,62,88,26,>,62,50.666666666666664,38.333333333333336,>,12.333333333333329,37,30,>,7,58,47,>,11,143,111,>,32
0,8,52.333333333333336,50.0,>,2.3333333333333357,29,11,>,18,71,75,<,-4,51.666666666666664,49.0,>,2.6666666666666643,44,43,>,1,59,60,<,-1,73,97,<,-24
0,8,50.0,52.333333333333336,<,-2.3333333333333357,11,29,<,-18,75,71,>,4,49.0,51.666666666666664,<,-2.6666666666666643,43,44,<,-1,60,59,>,1,97,73,>,24
0,8,52.333333333333336,38.666666666666664,>,13.666666666666671,29,16,>,13,71,62,>,9,51.666666666666664,50.666666666666664,>,1.0,44,38,>,6,59,59,=,0,73,140,<,-67
31,8,38.666666666666664,52.333333333333336,<,-13.666666666666671,16,29,<,-13,62,71,<,-9,50.666666666666664,51.666666666666664,<,-1.0,38,44,<,-6,59,59,=,0,140,73,>,67
0,8,52.333333333333336,65.0,<,-12.666666666666664,29,36,<,-7,71,81,<,-10,51.666666666666664,50.0,>,1.6666666666666643,44,33,>,11,59,59,=,0,73,123,<,-50
38,8,65.0,52.333333333333336,>,12.666666666666664,36,29,>,7,81,71,>,10,50.0,51.666666666666664,<,-1.6666666666666643,33,44,<,-11,59,59,=,0,123,73,>,50
0,8,52.333333333333336,30.0,>,22.333333333333336,29,12,>,17,71,48,>,23,51.666666666666664,55.333333333333336,<,-3.6666666666666714,44,48,<,-4,59,60,<,-1,73,174,<,-101
64,8,30.0,52.333333333333336,<,-22.333333333333336,12,29,<,-17,48,71,<,-23,55.333333333333336,51.666666666666664,>,3.6666666666666714,48,44,>,4,60,59,>,1,174,73,>,101
0,8,52.333333333333336,50.0,>,2.3333333333333357,29,36,<,-7,71,72,<,-1,51.666666666666664,43.666666666666664,>,8.0,44,35,>,9,59,52,>,7,73,74,<,-1
82,8,50.0,52.333333333333336,<,-2.3333333333333357,36,29,>,7,72,71,>,1,43.666666666666664,51.666666666666664,<,-8.0,35,44,<,-9,52,59,<,-7,74,73,>,1
0,8,52.333333333333336,56.0,<,-3.6666666666666643,29,18,>,11,71,82,<,-11,51.666666666666664,43.666666666666664,>,8.0,44,30,>,14,59,55,>,4,73,143,<,-70
0,8,56.0,52.333333333333336,>,3.6666666666666643,18,29,<,-11,82,71,>,11,43.666666666666664,51.666666666666664,<,-8.0,30,44,<,-14,55,59,<,-4,143,73,>,70
0,8,52.333333333333336,64.66666666666667,<,-12.333333333333336,29,33,<,-4,71,84,<,-13,51.666666666666664,50.666666666666664,>,1.0,44,37,>,7,59,58,>,1,73,143,<,-70
80,8,64.66666666666667,52.333333333333336,>,12.333333333333336,33,29,>,4,84,71,>,13,50.666666666666664,51.666666666666664,<,-1.0,37,44,<,-7,58,59,<,-1,143,73,>,70
0,7,47.0,34.0,>,13.0,18,11,>,7,68,64,>,4,43.666666666666664,49.0,<,-5.333333333333336,30,43,<,-13,55,60,<,-5,143,97,>,46
0,7,34.0,47.0,<,-13.0,11,18,<,-7,64,68,<,-4,49.0,43.666666666666664,>,5.333333333333336,43,30,>,13,60,55,>,5,97,143,<,-46
0,7,47.0,34.0,>,13.0,18,16,>,2,68,62,>,6,43.666666666666664,50.666666666666664,<,-7.0,30,38,<,-8,55,59,<,-4,143,140,>,3
76,7,34.0,47.0,<,-13.0,16,18,<,-2,62,68,<,-6,50.666666666666664,43.666666666666664,>,7.0,38,30,>,8,59,55,>,4,140,143,<,-3
0,7,47.0,48.0,<,-1.0,18,27,<,-9,68,81,<,-13,43.666666666666664,50.0,<,-6.333333333333336,30,33,<,-3,55,59,<,-4,143,123,>,20
35,7,48.0,47.0,>,1.0,27,18,>,9,81,68,>,13,50.0,43.666666666666664,>,6.333333333333336,33,30,>,3,59,55,>,4,123,143,<,-20
0,7,47.0,25.666666666666668,>,21.333333333333332,18,12,>,6,68,35,>,33,43.666666666666664,55.333333333333336,<,-11.666666666666671,30,48,<,-18,55,60,<,-5,143,174,<,-31
0,7,25.666666666666668,47.0,<,-21.333333333333332,12,18,<,-6,35,68,<,-33,55.333333333333336,43.666666666666664,>,11.666666666666671,48,30,>,18,60,55,>,5,174,143,>,31
0,7,47.0,68.66666666666667,<,-21.66666666666667,18,33,<,-15,68,89,<,-21,43.666666666666664,50.666666666666664,<,-7.0,30,37,<,-7,55,58,<,-3,143,143,=,0
86,7,68.66666666666667,47.0,>,21.66666666666667,33,18,>,15,89,68,>,21,50.666666666666664,43.666666666666664,>,7.0,37,30,>,7,58,55,>,3,143,143,=,0
0,7,47.0,55.666666666666664,<,-8.666666666666664,18,36,<,-18,68,89,<,-21,43.666666666666664,43.666666666666664,=,0.0,30,35,<,-5,55,52,>,3,143,74,>,69
87,7,55.666666666666664,47.0,>,8.666666666666664,36,18,>,18,89,68,>,21,43.666666666666664,43.666666666666664,=,0.0,35,30,>,5,52,55,<,-3,74,143,<,-69
0,6,36.333333333333336,30.666666666666668,>,5.666666666666668,30,11,>,19,44,54,<,-10,55.333333333333336,49.0,>,6.333333333333336,48,43,>,5,60,60,=,0,174,97,>,77
0,6,30.666666666666668,36.333333333333336,<,-5.666666666666668,11,30,<,-19,54,44,>,10,49.0,55.333333333333336,<,-6.333333333333336,43,48,<,-5,60,60,=,0,97,174,<,-77
0,6,36.333333333333336,41.333333333333336,<,-5.0,30,16,>,14,44,81,<,-37,55.333333333333336,50.0,>,5.333333333333336,48,33,>,15,60,59,>,1,174,123,>,51
0,6,41.333333333333336,36.333333333333336,>,5.0,16,30,<,-14,81,44,>,37,50.0,55.333333333333336,<,-5.333333333333336,33,48,<,-15,59,60,<,-1,123,174,<,-51
0,6,36.333333333333336,26.0,>,10.333333333333336,30,16,>,14,44,38,>,6,55.333333333333336,50.666666666666664,>,4.666666666666671,48,38,>,10,60,59,>,1,174,140,>,34
93,6,26.0,36.333333333333336,<,-10.333333333333336,16,30,<,-14,38,44,<,-6,50.666666666666664,55.333333333333336,<,-4.666666666666671,38,48,<,-10,59,60,<,-1,140,174,<,-34
0,6,36.333333333333336,81.0,<,-44.666666666666664,30,70,<,-40,44,89,<,-45,55.333333333333336,50.666666666666664,>,4.666666666666671,48,37,>,11,60,58,>,2,174,143,>,31
106,6,81.0,36.333333333333336,>,44.666666666666664,70,30,>,40,89,44,>,45,50.666666666666664,55.333333333333336,<,-4.666666666666671,37,48,<,-11,58,60,<,-2,143,174,<,-31
0,6,36.333333333333336,46.0,<,-9.666666666666664,30,13,>,17,44,89,<,-45,55.333333333333336,43.666666666666664,>,11.666666666666671,48,35,>,13,60,52,>,8,174,74,>,100
31,6,46.0,36.333333333333336,>,9.666666666666664,13,30,<,-17,89,44,>,45,43.666666666666664,55.333333333333336,<,-11.666666666666671,35,48,<,-13,52,60,<,-8,74,174,<,-100
0,5,52.333333333333336,44.666666666666664,>,7.666666666666671,16,11,>,5,81,69,>,12,50.0,49.0,>,1.0,33,43,<,-10,59,60,<,-1,123,97,>,26
0,5,44.666666666666664,52.333333333333336,<,-7.666666666666671,11,16,<,-5,69,81,<,-12,49.0,50.0,<,-1.0,43,33,>,10,60,59,>,1,97,123,<,-26
0,5,52.333333333333336,42.0,>,10.333333333333336,16,13,>,3,81,77,>,4,50.0,43.666666666666664,>,6.333333333333336,33,35,<,-2,59,52,>,7,123,74,>,49
31,5,42.0,52.333333333333336,<,-10.333333333333336,13,16,<,-3,77,81,<,-4,43.666666666666664,50.0,<,-6.333333333333336,35,33,>,2,52,59,<,-7,74,123,<,-49
0,5,52.333333333333336,23.333333333333332,>,29.000000000000004,16,16,=,0,81,38,>,43,50.0,50.666666666666664,<,-0.6666666666666643,33,38,<,-5,59,59,=,0,123,140,<,-17
113,5,23.333333333333332,52.333333333333336,<,-29.000000000000004,16,16,=,0,38,81,<,-43,50.666666666666664,50.0,>,0.6666666666666643,38,33,>,5,59,59,=,0,140,123,>,17
0,5,52.333333333333336,70.66666666666667,<,-18.333333333333336,16,58,<,-42,81,84,<,-3,50.0,50.666666666666664,<,-0.6666666666666643,33,37,<,-4,59,58,>,1,123,143,<,-20
107,5,70.66666666666667,52.333333333333336,>,18.333333333333336,58,16,>,42,84,81,>,3,50.666666666666664,50.0,>,0.6666666666666643,37,33,>,4,58,59,<,-1,143,123,>,20
0,4,56.666666666666664,44.666666666666664,>,12.0,11,21,<,-10,90,77,>,13,49.0,43.666666666666664,>,5.333333333333336,43,35,>,8,60,52,>,8,97,74,>,23
0,4,44.666666666666664,56.666666666666664,<,-12.0,21,11,>,10,77,90,<,-13,43.666666666666664,49.0,<,-5.333333333333336,35,43,<,-8,52,60,<,-8,74,97,<,-23
0,4,56.666666666666664,75.66666666666667,<,-19.000000000000007,11,58,<,-47,90,85,>,5,49.0,50.666666666666664,<,-1.6666666666666643,43,37,>,6,60,58,>,2,97,143,<,-46
120,4,75.66666666666667,56.666666666666664,>,19.000000000000007,58,11,>,47,85,90,<,-5,50.666666666666664,49.0,>,1.6666666666666643,37,43,<,-6,58,60,<,-2,143,97,>,46
0,4,56.666666666666664,29.0,>,27.666666666666664,11,16,<,-5,90,55,>,35,49.0,50.666666666666664,<,-1.6666666666666643,43,38,>,5,60,59,>,1,97,140,<,-43
120,4,29.0,56.666666666666664,<,-27.666666666666664,16,11,>,5,55,90,<,-35,50.666666666666664,49.0,>,1.6666666666666643,38,43,<,-5,59,60,<,-1,140,97,>,43
0,3,59.333333333333336,30.0,>,29.333333333333336,21,16,>,5,80,55,>,25,43.666666666666664,50.666666666666664,<,-7.0,35,38,<,-3,52,59,<,-7,74,140,<,-66
0,3,30.0,59.333333333333336,<,-29.333333333333336,16,21,<,-5,55,80,<,-25,50.666666666666664,43.666666666666664,>,7.0,38,35,>,3,59,52,>,7,140,74,>,66
0,3,59.333333333333336,75.33333333333333,<,-15.999999999999993,21,58,<,-37,80,85,<,-5,43.666666666666664,50.666666666666664,<,-7.0,35,37,<,-2,52,58,<,-6,74,143,<,-69
120,3,75.33333333333333,59.333333333333336,>,15.999999999999993,58,21,>,37,85,80,>,5,50.666666666666664,43.666666666666664,>,7.0,37,35,>,2,58,52,>,6,143,74,>,69
0,2,40.666666666666664,58.333333333333336,<,-17.66666666666667,16,34,<,-18,87,83,>,4,50.666666666666664,50.666666666666664,=,0.0,38,37,>,1,59,58,>,1,140,143,<,-3
120,2,58.333333333333336,40.666666666666664,>,17.66666666666667,34,16,>,18,83,87,<,-4,50.666666666666664,50.666666666666664,=,0.0,37,38,<,-1,58,59,<,-1,143,140,>,3
0,12,0.0,0.0,=,0.0,0,0,=,0,0,0,=,0,33.666666666666664,47.333333333333336,<,-13.666666666666671,31,41,<,-10,38,54,<,-16,74,75,<,-1
0,12,0.0,0.0,=,0.0,0,0,=,0,0,0,=,0,47.333333333333336,33.666666666666664,>,13.666666666666671,41,31,>,10,54,38,>,16,75,74,>,1
0,12,0.0,0.0,=,0.0,0,0,=,0,0,0,=,0,33.666666666666664,41.333333333333336,<,-7.666666666666671,31,32,<,-1,38,49,<,-11,74,110,<,-36
72,12,0.0,0.0,=,0.0,0,0,=,0,0,0,=,0,41.333333333333336,33.666666666666664,>,7.666666666666671,32,31,>,1,49,38,>,11,110,74,>,36
0,12,0.0,0.0,=,0.0,0,0,=,0,0,0,=,0,33.666666666666664,44.0,<,-10.333333333333336,31,38,<,-7,38,55,<,-17,74,91,<,-17
77,12,0.0,0.0,=,0.0,0,0,=,0,0,0,=,0,44.0,33.666666666666664,>,10.333333333333336,38,31,>,7,55,38,>,17,91,74,>,17
0,12,0.0,0.0,=,0.0,0,0,=,0,0,0,=,0,33.666666666666664,47.333333333333336,<,-13.666666666666671,31,36,<,-5,38,60,<,-22,74,156,<,-82
131,12,0.0,0.0,=,0.0,0,0,=,0,0,0,=,0,47.333333333333336,33.666666666666664,>,13.666666666666671,36,31,>,5,60,38,>,22,156,74,>,82
0,12,0.0,0.0,=,0.0,0,0,=,0,0,0,=,0,33.666666666666664,44.333333333333336,<,-10.666666666666671,31,32,<,-1,38,59,<,-21,74,79,<,-5
67,12,0.0,0.0,=,0.0,0,0,=,0,0,0,=,0,44.333333333333336,33.666666666666664,>,10.666666666666671,32,31,>,1,59,38,>,21,79,74,>,5
0,12,0.0,0.0,=,0.0,0,0,=,0,0,0,=,0,33.666666666666664,53.0,<,-19.333333333333336,31,42,<,-11,38,60,<,-22,74,131,<,-57
0,12,0.0,0.0,=,0.0,0,0,=,0,0,0,=,0,53.0,33.666666666666664,>,19.333333333333336,42,31,>,11,60,38,>,22,131,74,>,57
0,12,0.0,0.0,=,0.0,0,0,=,0,0,0,=,0,33.666666666666664,40.333333333333336,<,-6.666666666666671,31,30,>,1,38,53,<,-15,74,86,<,-12
31,12,0.0,0.0,=,0.0,0,0,=,0,0,0,=,0,40.333333333333336,33.666666666666664,>,6.666666666666671,30,31,<,-1,53,38,>,15,86,74,>,12
0,12,0.0,0.0,=,0.0,0,0,=,0,0,0,=,0,33.666666666666664,43.333333333333336,<,-9.666666666666671,31,38,<,-7,38,47,<,-9,74,188,<,-114
105,12,0.0,0.0,=,0.0,0,0,=,0,0,0,=,0,43.333333333333336,33.666666666666664,>,9.666666666666671,38,31,>,7,47,38,>,9,188,74,>,114
0,12,0.0,0.0,=,0.0,0,0,=,0,0,0,=,0,33.666666666666664,42.666666666666664,<,-9.0,31,38,<,-7,38,52,<,-14,74,132,<,-58
101,12,0.0,0.0,=,0.0,0,0,=,0,0,0,=,0,42.666666666666664,33.666666666666664,>,9.0,38,31,>,7,52,38,>,14,132,74,>,58
0,12,0.0,0.0,=,0.0,0,0,=,0,0,0,=,0,33.666666666666664,44.666666666666664,<,-11.0,31,42,<,-11,38,50,<,-12,74,109,<,-35
42,12,0.0,0.0,=,0.0,0,0,=,0,0,0,=,0,44.666666666666664,33.666666666666664,>,11.0,42,31,>,11,50,38,>,12,109,74,>,35
0,12,0.0,0.0,=,0.0,0,0,=,0,0,0,=,0,33.666666666666664,48.666666666666664,<,-15.0,31,43,<,-12,38,57,<,-19,74,190,<,-116
168,12,0.0,0.0,=,0.0,0,0,=,0,0,0,=,0,48.666666666666664,33.666666666666664,>,15.0,43,31,>,12,57,38,>,19,190,74,>,116
0,11,22.333333333333332,19.666666666666668,>,2.6666666666666643,0,0,=,0,67,59,>,8,47.333333333333336,53.0,<,-5.666666666666664,41,42,<,-1,54,60,<,-6,75,131,<,-56
0,11,19.666666666666668,22.333333333333332,<,-2.6666666666666643,0,0,=,0,59,67,<,-8,53.0,47.333333333333336,>,5.666666666666664,42,41,>,1,60,54,>,6,131,75,>,56
0,11,22.333333333333332,18.0,>,4.333333333333332,0,0,=,0,67,54,>,13,47.333333333333336,40.333333333333336,>,7.0,41,30,>,11,54,53,>,1,75,86,<,-11
31,11,18.0,22.333333333333332,<,-4.333333333333332,0,0,=,0,54,67,<,-13,40.333333333333336,47.333333333333336,<,-7.0,30,41,<,-11,53,54,<,-1,86,75,>,11
0,11,22.333333333333332,26.0,<,-3.666666666666668,0,0,=,0,67,78,<,-11,47.333333333333336,44.666666666666664,>,2.6666666666666714,41,42,<,-1,54,50,>,4,75,109,<,-34
49,11,26.0,22.333333333333332,>,3.666666666666668,0,0,=,0,78,67,>,11,44.666666666666664,47.333333333333336,<,-2.6666666666666714,42,41,>,1,50,54,<,-4,109,75,>,34
0,11,22.333333333333332,7.666666666666667,>,14.666666666666664,0,0,=,0,67,23,>,44,47.333333333333336,44.333333333333336,>,3.0,41,32,>,9,54,59,<,-5,75,79,<,-4
0,11,7.666666666666667,22.333333333333332,<,-14.666666666666664,0,0,=,0,23,67,<,-44,44.333333333333336,47.333333333333336,<,-3.0,32,41,<,-9,59,54,>,5,79,75,>,4
0,11,22.333333333333332,12.0,>,10.333333333333332,0,0,=,0,67,36,>,31,47.333333333333336,41.333333333333336,>,6.0,41,32,>,9,54,49,>,5,75,110,<,-35
68,11,12.0,22.333333333333332,<,-10.333333333333332,0,0,=,0,36,67,<,-31,41.333333333333336,47.333333333333336,<,-6.0,32,41,<,-9,49,54,<,-5,110,75,>,35
0,11,22.333333333333332,29.0,<,-6.666666666666668,0,0,=,0,67,87,<,-20,47.333333333333336,44.0,>,3.3333333333333357,41,38,>,3,54,55,<,-1,75,91,<,-16
77,11,29.0,22.333333333333332,>,6.666666666666668,0,0,=,0,87,67,>,20,44.0,47.333333333333336,<,-3.3333333333333357,38,41,<,-3,55,54,>,1,91,75,>,16
0,11,22.333333333333332,10.0,>,12.333333333333332,0,0,=,0,67,30,>,37,47.333333333333336,42.666666666666664,>,4.666666666666671,41,38,>,3,54,52,>,2,75,132,<,-57
49,11,10.0,22.333333333333332,<,-12.333333333333332,0,0,=,0,30,67,<,-37,42.666666666666664,47.333333333333336,<,-4.666666666666671,38,41,<,-3,52,54,<,-2,132,75,>,57
0,11,22.333333333333332,12.333333333333334,>,9.999999999999998,0,0,=,0,67,37,>,30,47.333333333333336,43.333333333333336,>,4.0,41,38,>,3,54,47,>,7,75,188,<,-113
125,11,12.333333333333334,22.333333333333332,<,-9.999999999999998,0,0,=,0,37,67,<,-30,43.333333333333336,47.333333333333336,<,-4.0,38,41,<,-3,47,54,<,-7,188,75,>,113
0,11,22.333333333333332,27.666666666666668,<,-5.333333333333336,0,0,=,0,67,83,<,-16,47.333333333333336,47.333333333333336,=,0.0,41,36,>,5,54,60,<,-6,75,156,<,-81
131,11,27.666666666666668,22.333333333333332,>,5.333333333333336,0,0,=,0,83,67,>,16,47.333333333333336,47.333333333333336,=,0.0,36,41,<,-5,60,54,>,6,156,75,>,81
0,11,22.333333333333332,15.666666666666666,>,6.666666666666666,0,0,=,0,67,47,>,20,47.333333333333336,48.666666666666664,<,-1.3333333333333286,41,43,<,-2,54,57,<,-3,75,190,<,-115
148,11,15.666666666666666,22.333333333333332,<,-6.666666666666666,0,0,=,0,47,67,<,-20,48.666666666666664,47.333333333333336,>,1.3333333333333286,43,41,>,2,57,54,>,3,190,75,>,115
0,10,12.333333333333334,37.0,<,-24.666666666666664,0,0,=,0,23,59,<,-36,44.333333333333336,53.0,<,-8.666666666666664,32,42,<,-10,59,60,<,-1,79,131,<,-52
0,10,37.0,12.333333333333334,>,24.666666666666664,0,0,=,0,59,23,>,36,53.0,44.333333333333336,>,8.666666666666664,42,32,>,10,60,59,>,1,131,79,>,52
0,10,12.333333333333334,44.666666666666664,<,-32.33333333333333,0,0,=,0,23,80,<,-57,44.333333333333336,40.333333333333336,>,4.0,32,30,>,2,59,53,>,6,79,86,<,-7
31,10,44.666666666666664,12.333333333333334,>,32.33333333333333,0,0,=,0,80,23,>,57,40.333333333333336,44.333333333333336,<,-4.0,30,32,<,-2,53,59,<,-6,86,79,>,7
0,10,12.333333333333334,23.666666666666668,<,-11.333333333333334,0,0,=,0,23,41,<,-18,44.333333333333336,42.666666666666664,>,1.6666666666666714,32,38,<,-6,59,52,>,7,79,132,<,-53
49,10,23.666666666666668,12.333333333333334,>,11.333333333333334,0,0,=,0,41,23,>,18,42.666666666666664,44.333333333333336,<,-1.6666666666666714,38,32,>,6,52,59,<,-7,132,79,>,53
0,10,12.333333333333334,51.666666666666664,<,-39.33333333333333,0,0,=,0,23,78,<,-55,44.333333333333336,44.666666666666664,<,-0.3333333333333286,32,42,<,-10,59,50,>,9,79,109,<,-30
49,10,51.666666666666664,12.333333333333334,>,39.33333333333333,0,0,=,0,78,23,>,55,44.666666666666664,44.333333333333336,>,0.3333333333333286,42,32,>,10,50,59,<,-9,109,79,>,30
0,10,12.333333333333334,17.333333333333332,<,-4.999999999999998,0,0,=,0,23,36,<,-13,44.333333333333336,41.333333333333336,>,3.0,32,32,=,0,59,49,>,10,79,110,<,-31
0,10,17.333333333333332,12.333333333333334,>,4.999999999999998,0,0,=,0,36,23,>,13,41.333333333333336,44.333333333333336,<,-3.0,32,32,=,0,49,59,<,-10,110,79,>,31
0,10,12.333333333333334,49.0,<,-36.666666666666664,0,0,=,0,23,87,<,-64,44.333333333333336,44.0,>,0.3333333333333357,32,38,<,-6,59,55,>,4,79,91,<,-12
77,10,49.0,12.333333333333334,>,36.666666666666664,0,0,=,0,87,23,>,64,44.0,44.333333333333336,<,-0.3333333333333357,38,32,>,6,55,59,<,-4,91,79,>,12
0,10,12.333333333333334,30.333333333333332,<,-18.0,0,0,=,0,23,54,<,-31,44.333333333333336,43.333333333333336,>,1.0,32,38,<,-6,59,47,>,12,79,188,<,-109
125,10,30.333333333333332,12.333333333333334,>,18.0,0,0,=,0,54,23,>,31,43.333333333333336,44.333333333333336,<,-1.0,38,32,>,6,47,59,<,-12,188,79,>,109
0,10,12.333333333333334,36.666666666666664,<,-24.33333333333333,0,0,=,0,23,83,<,-60,44.333333333333336,47.333333333333336,<,-3.0,32,36,<,-4,59,60,<,-1,79,156,<,-77
110,10,36.666666666666664,12.333333333333334,>,24.33333333333333,0,0,=,0,83,23,>,60,47.333333333333336,44.333333333333336,>,3.0,36,32,>,4,60,59,>,1,156,79,>,77
0,10,12.333333333333334,39.0,<,-26.666666666666664,0,0,=,0,23,70,<,-47,44.333333333333336,48.666666666666664,<,-4.333333333333329,32,43,<,-11,59,57,>,2,79,190,<,-111
148,10,39.0,12.333333333333334,>,26.666666666666664,0,0,=,0,70,23,>,47,48.666666666666664,44.333333333333336,>,4.333333333333329,43,32,>,11,57,59,<,-2,190,79,>,111
0,9,18.333333333333332,26.666666666666668,<,-8.333333333333336,0,0,=,0,39,52,<,-13,41.333333333333336,53.0,<,-11.666666666666664,32,42,<,-10,49,60,<,-11,110,131,<,-21
0,9,26.666666666666668,18.333333333333332,>,8.333333333333336,0,0,=,0,52,39,>,13,53.0,41.333333333333336,>,11.666666666666664,42,32,>,10,60,49,>,11,131,110,>,21
0,9,18.333333333333332,41.666666666666664,<,-23.333333333333332,0,0,=,0,39,80,<,-41,41.333333333333336,40.333333333333336,>,1.0,32,30,>,2,49,53,<,-4,110,86,>,24
31,9,41.666666666666664,18.333333333333332,>,23.333333333333332,0,0,=,0,80,39,>,41,40.333333333333336,41.333333333333336,<,-1.0,30,32,<,-2,53,49,>,4,86,110,<,-24
0,9,18.333333333333332,17.666666666666668,>,0.6666666666666643,0,0,=,0,39,41,<,-2,41.333333333333336,42.666666666666664,<,-1.3333333333333286,32,38,<,-6,49,52,<,-3,110,132,<,-22
0,9,17.666666666666668,18.333333333333332,<,-0.6666666666666643,0,0,=,0,41,39,>,2,42.666666666666664,41.333333333333336,>,1.3333333333333286,38,32,>,6,52,49,>,3,132,110,>,22
0,9,18.333333333333332,33.666666666666664,<,-15.333333333333332,0,0,=,0,39,77,<,-38,41.333333333333336,44.666666666666664,<,-3.3333333333333286,32,42,<,-10,49,50,<,-1,110,109,>,1
49,9,33.666666666666664,18.333333333333332,>,15.333333333333332,0,0,=,0,77,39,>,38,44.666666666666664,41.333333333333336,>,3.3333333333333286,42,32,>,10,50,49,>,1,109,110,<,-1
0,9,18.333333333333332,36.0,<,-17.666666666666668,0,0,=,0,39,60,<,-21,41.333333333333336,44.0,<,-2.6666666666666643,32,38,<,-6,49,55,<,-6,110,91,>,19
77,9,36.0,18.333333333333332,>,17.666666666666668,0,0,=,0,60,39,>,21,44.0,41.333333333333336,>,2.6666666666666643,38,32,>,6,55,49,>,6,91,110,<,-19
0,9,18.333333333333332,20.666666666666668,<,-2.3333333333333357,0,0,=,0,39,35,>,4,41.333333333333336,47.333333333333336,<,-6.0,32,36,<,-4,49,60,<,-11,110,156,<,-46
110,9,20.666666666666668,18.333333333333332,>,2.3333333333333357,0,0,=,0,35,39,<,-4,47.333333333333336,41.333333333333336,>,6.0,36,32,>,4,60,49,>,11,156,110,>,46
0,9,18.333333333333332,25.333333333333332,<,-7.0,0,0,=,0,39,54,<,-15,41.333333333333336,43.333333333333336,<,-2.0,32,38,<,-6,49,47,>,2,110,188,<,-78
125,9,25.333333333333332,18.333333333333332,>,7.0,0,0,=,0,54,39,>,15,43.333333333333336,41.333333333333336,>,2.0,38,32,>,6,47,49,<,-2,188,110,>,78
0,9,18.333333333333332,45.333333333333336,<,-27.000000000000004,0,0,=,0,39,70,<,-31,41.333333333333336,48.666666666666664,<,-7.333333333333329,32,43,<,-11,49,57,<,-8,110,190,<,-80
134,9,45.333333333333336,18.333333333333332,>,27.000000000000004,0,0,=,0,70,39,>,31,48.666666666666664,41.333333333333336,>,7.333333333333329,43,32,>,11,57,49,>,8,190,110,>,80
0,8,30.666666666666668,28.666666666666668,>,2.0,0,0,=,0,64,74,<,-10,53.0,42.666666666666664,>,10.333333333333336,42,38,>,4,60,52,>,8,131,132,<,-1
0,8,28.666666666666668,30.666666666666668,<,-2.0,0,0,=,0,74,64,>,10,42.666666666666664,53.0,<,-10.333333333333336,38,42,<,-4,52,60,<,-8,132,131,>,1
0,8,30.666666666666668,40.666666666666664,<,-9.999999999999996,0,0,=,0,64,77,<,-13,53.0,40.333333333333336,>,12.666666666666664,42,30,>,12,60,53,>,7,131,86,>,45
31,8,40.666666666666664,30.666666666666668,>,9.999999999999996,0,0,=,0,77,64,>,13,40.333333333333336,53.0,<,-12.666666666666664,30,42,<,-12,53,60,<,-7,86,131,<,-45
0,8,30.666666666666668,21.0,>,9.666666666666668,0,0,=,0,64,39,>,25,53.0,44.666666666666664,>,8.333333333333336,42,42,=,0,60,50,>,10,131,109,>,22
36,8,21.0,30.666666666666668,<,-9.666666666666668,0,0,=,0,39,64,<,-25,44.666666666666664,53.0,<,-8.333333333333336,42,42,=,0,50,60,<,-10,109,131,<,-22
0,8,30.666666666666668,44.333333333333336,<,-13.666666666666668,0,0,=,0,64,85,<,-21,53.0,44.0,>,9.0,42,38,>,4,60,55,>,5,131,91,>,40
77,8,44.333333333333336,30.666666666666668,>,13.666666666666668,0,0,=,0,85,64,>,21,44.0,53.0,<,-9.0,38,42,<,-4,55,60,<,-5,91,131,<,-40
0,8,30.666666666666668,29.0,>,1.6666666666666679,0,0,=,0,64,52,>,12,53.0,47.333333333333336,>,5.666666666666664,42,36,>,6,60,60,=,0,131,156,<,-25
124,8,29.0,30.666666666666668,<,-1.6666666666666679,0,0,=,0,52,64,<,-12,47.333333333333336,53.0,<,-5.666666666666664,36,42,<,-6,60,60,=,0,156,131,>,25
0,8,30.666666666666668,17.0,>,13.666666666666668,0,0,=,0,64,29,>,35,53.0,43.333333333333336,>,9.666666666666664,42,38,>,4,60,47,>,13,131,188,<,-57
0,8,17.0,30.666666666666668,<,-13.666666666666668,0,0,=,0,29,64,<,-35,43.333333333333336,53.0,<,-9.666666666666664,38,42,<,-4,47,60,<,-13,188,131,>,57
0,8,30.666666666666668,51.333333333333336,<,-20.666666666666668,0,0,=,0,64,88,<,-24,53.0,48.666666666666664,>,4.333333333333336,42,43,<,-1,60,57,>,3,131,190,<,-59
134,8,51.333333333333336,30.666666666666668,>,20.666666666666668,0,0,=,0,88,64,>,24,48.666666666666664,53.0,<,-4.333333333333336,43,42,>,1,57,60,<,-3,190,131,>,59
0,7,41.0,48.666666666666664,<,-7.666666666666664,22,12,>,10,72,74,<,-2,43.333333333333336,42.666666666666664,>,0.6666666666666714,38,38,=,0,47,52,<,-5,188,132,>,56
0,7,48.666666666666664,41.0,>,7.666666666666664,12,22,<,-10,74,72,>,2,42.666666666666664,43.333333333333336,<,-0.6666666666666714,38,38,=,0,52,47,>,5,132,188,<,-56
0,7,41.0,48.333333333333336,<,-7.333333333333336,22,23,<,-1,72,77,<,-5,43.333333333333336,40.333333333333336,>,3.0,38,30,>,8,47,53,<,-6,188,86,>,102
36,7,48.333333333333336,41.0,>,7.333333333333336,23,22,>,1,77,72,>,5,40.333333333333336,43.333333333333336,<,-3.0,30,38,<,-8,53,47,>,6,86,188,<,-102
0,7,41.0,24.333333333333332,>,16.666666666666668,22,10,>,12,72,39,>,33,43.333333333333336,44.666666666666664,<,-1.3333333333333286,38,42,<,-4,47,50,<,-3,188,109,>,79
0,7,24.333333333333332,41.0,<,-16.666666666666668,10,22,<,-12,39,72,<,-33,44.666666666666664,43.333333333333336,>,1.3333333333333286,42,38,>,4,50,47,>,3,109,188,<,-79
0,7,41.0,68.33333333333333,<,-27.33333333333333,22,48,<,-26,72,85,<,-13,43.333333333333336,44.0,<,-0.6666666666666643,38,38,=,0,47,55,<,-8,188,91,>,97
162,7,68.33333333333333,41.0,>,27.33333333333333,48,22,>,26,85,72,>,13,44.0,43.333333333333336,>,0.6666666666666643,38,38,=,0,55,47,>,8,91,188,<,-97
0,7,41.0,32.333333333333336,>,8.666666666666664,22,10,>,12,72,52,>,20,43.333333333333336,47.333333333333336,<,-4.0,38,36,>,2,47,60,<,-13,188,156,>,32
92,7,32.333333333333336,41.0,<,-8.666666666666664,10,22,<,-12,52,72,<,-20,47.333333333333336,43.333333333333336,>,4.0,36,38,<,-2,60,47,>,13,156,188,<,-32
0,7,41.0,80.0,<,-39.0,22,66,<,-44,72,88,<,-16,43.333333333333336,48.666666666666664,<,-5.333333333333329,38,43,<,-5,47,57,<,-10,188,190,<,-2
134,7,80.0,41.0,>,39.0,66,22,>,44,88,72,>,16,48.666666666666664,43.333333333333336,>,5.333333333333329,43,38,>,5,57,47,>,10,190,188,>,2
0,6,50.333333333333336,35.333333333333336,>,15.0,12,10,>,2,79,72,>,7,42.666666666666664,44.666666666666664,<,-2.0,38,42,<,-4,52,50,>,2,132,109,>,23
0,6,35.333333333333336,50.333333333333336,<,-15.0,10,12,<,-2,72,79,<,-7,44.666666666666664,42.666666666666664,>,2.0,42,38,>,4,50,52,<,-2,109,132,<,-23
0,6,50.333333333333336,28.333333333333332,>,22.000000000000004,12,17,<,-5,79,45,>,34,42.666666666666664,40.333333333333336,>,2.3333333333333286,38,30,>,8,52,53,<,-1,132,86,>,46
0,6,28.333333333333332,50.333333333333336,<,-22.000000000000004,17,12,>,5,45,79,<,-34,40.333333333333336,42.666666666666664,<,-2.3333333333333286,30,38,<,-8,53,52,>,1,86,132,<,-46
0,6,50.333333333333336,39.333333333333336,>,11.0,12,10,>,2,79,73,>,6,42.666666666666664,47.333333333333336,<,-4.666666666666671,38,36,>,2,52,60,<,-8,132,156,<,-24
92,6,39.333333333333336,50.333333333333336,<,-11.0,10,12,<,-2,73,79,<,-6,47.333333333333336,42.666666666666664,>,4.666666666666671,36,38,<,-2,60,52,>,8,156,132,>,24
0,6,50.333333333333336,69.33333333333333,<,-18.999999999999993,12,56,<,-44,79,86,<,-7,42.666666666666664,48.666666666666664,<,-6.0,38,43,<,-5,52,57,<,-5,132,190,<,-58
78,6,69.33333333333333,50.333333333333336,>,18.999999999999993,56,12,>,44,86,79,>,7,48.666666666666664,42.666666666666664,>,6.0,43,38,>,5,57,52,>,5,190,132,>,58
0,6,50.333333333333336,69.66666666666667,<,-19.333333333333336,12,48,<,-36,79,89,<,-10,42.666666666666664,44.0,<,-1.3333333333333357,38,38,=,0,52,55,<,-3,132,91,>,41
148,6,69.66666666666667,50.333333333333336,>,19.333333333333336,48,12,>,36,89,79,>,10,44.0,42.666666666666664,>,1.3333333333333357,38,38,=,0,55,52,>,3,91,132,<,-41
0,5,21.333333333333332,53.666666666666664,<,-32.33333333333333,17,10,>,7,24,79,<,-55,40.333333333333336,44.666666666666664,<,-4.333333333333329,30,42,<,-12,53,50,>,3,86,109,<,-23
0,5,53.666666666666664,21.333333333333332,>,32.33333333333333,10,17,<,-7,79,24,>,55,44.666666666666664,40.333333333333336,>,4.333333333333329,42,30,>,12,50,53,<,-3,109,86,>,23
0,5,21.333333333333332,51.0,<,-29.666666666666668,17,11,>,6,24,86,<,-62,40.333333333333336,48.666666666666664,<,-8.333333333333329,30,43,<,-13,53,57,<,-4,86,190,<,-104
0,5,51.0,21.333333333333332,>,29.666666666666668,11,17,<,-6,86,24,>,62,48.666666666666664,40.333333333333336,>,8.333333333333329,43,30,>,13,57,53,>,4,190,86,>,104
0,5,21.333333333333332,41.0,<,-19.666666666666668,17,10,>,7,24,73,<,-49,40.333333333333336,47.333333333333336,<,-7.0,30,36,<,-6,53,60,<,-7,86,156,<,-70
92,5,41.0,21.333333333333332,>,19.666666666666668,10,17,<,-7,73,24,>,49,47.333333333333336,40.333333333333336,>,7.0,36,30,>,6,60,53,>,7,156,86,>,70
0,5,21.333333333333332,74.0,<,-52.66666666666667,17,61,<,-44,24,89,<,-65,40.333333333333336,44.0,<,-3.6666666666666643,30,38,<,-8,53,55,<,-2,86,91,<,-5
148,5,74.0,21.333333333333332,>,52.66666666666667,61,17,>,44,89,24,>,65,44.0,40.333333333333336,>,3.6666666666666643,38,30,>,8,55,53,>,2,91,86,>,5
0,4,33.333333333333336,49.666666666666664,<,-16.33333333333333,10,11,<,-1,79,86,<,-7,44.666666666666664,48.666666666666664,<,-4.0,42,43,<,-1,50,57,<,-7,109,190,<,-81
0,4,49.666666666666664,33.333333333333336,>,16.33333333333333,11,10,>,1,86,79,>,7,48.666666666666664,44.666666666666664,>,4.0,43,42,>,1,57,50,>,7,190,109,>,81
0,4,33.333333333333336,46.666666666666664,<,-13.333333333333329,10,10,=,0,79,90,<,-11,44.666666666666664,47.333333333333336,<,-2.6666666666666714,42,36,>,6,50,60,<,-10,109,156,<,-47
92,4,46.666666666666664,33.333333333333336,>,13.333333333333329,10,10,=,0,90,79,>,11,47.333333333333336,44.666666666666664,>,2.6666666666666714,36,42,<,-6,60,50,>,10,156,109,>,47
0,4,33.333333333333336,71.33333333333333,<,-37.99999999999999,10,61,<,-51,79,81,<,-2,44.666666666666664,44.0,>,0.6666666666666643,42,38,>,4,50,55,<,-5,109,91,>,18
187,4,71.33333333333333,33.333333333333336,>,37.99999999999999,61,10,>,51,81,79,>,2,44.0,44.666666666666664,<,-0.6666666666666643,38,42,<,-4,55,50,>,5,91,109,<,-18
0,3,46.0,68.0,<,-22.0,11,40,<,-29,75,90,<,-15,48.666666666666664,47.333333333333336,>,1.3333333333333286,43,36,>,7,57,60,<,-3,190,156,>,34
107,3,68.0,46.0,>,22.0,40,11,>,29,90,75,>,15,47.333333333333336,48.666666666666664,<,-1.3333333333333286,36,43,<,-7,60,57,>,3,156,190,<,-34
0,3,46.0,51.666666666666664,<,-5.666666666666664,11,13,<,-2,75,81,<,-6,48.666666666666664,44.0,>,4.666666666666664,43,38,>,5,57,55,>,2,190,91,>,99
0,3,51.666666666666664,46.0,>,5.666666666666664,13,11,>,2,81,75,>,6,44.0,48.666666666666664,<,-4.666666666666664,38,43,<,-5,55,57,<,-2,91,190,<,-99
0,2,61.0,64.66666666666667,<,-3.6666666666666714,13,30,<,-17,89,90,<,-1,44.0,47.333333333333336,<,-3.3333333333333357,38,36,>,2,55,60,<,-5,91,156,<,-65
84,2,64.66666666666667,61.0,>,3.6666666666666714,30,13,>,17,90,89,>,1,47.333333333333336,44.0,>,3.3333333333333357,36,38,<,-2,60,55,>,5,156,91,>,65
0,13,0.0,0.0,=,0.0,0,0,=,0,0,0,=,0,45.0,51.0,<,-6.0,41,38,>,3,51,60,<,-9,86,107,<,-21
87,13,0.0,0.0,=,0.0,0,0,=,0,0,0,=,0,51.0,45.0,>,6.0,38,41,<,-3,60,51,>,9,107,86,>,21
0,13,0.0,0.0,=,0.0,0,0,=,0,0,0,=,0,45.0,39.666666666666664,>,5.333333333333336,41,38,>,3,51,42,>,9,86,202,<,-116
70,13,0.0,0.0,=,0.0,0,0,=,0,0,0,=,0,39.666666666666664,45.0,<,-5.333333333333336,38,41,<,-3,42,51,<,-9,202,86,>,116
0,13,0.0,0.0,=,0.0,0,0,=,0,0,0,=,0,45.0,45.666666666666664,<,-0.6666666666666643,41,33,>,8,51,52,<,-1,86,168,<,-82
66,13,0.0,0.0,=,0.0,0,0,=,0,0,0,=,0,45.666666666666664,45.0,>,0.6666666666666643,33,41,<,-8,52,51,>,1,168,86,>,82
0,13,0.0,0.0,=,0.0,0,0,=,0,0,0,=,0,45.0,44.333333333333336,>,0.6666666666666643,41,39,>,2,51,51,=,0,86,182,<,-96
62,13,0.0,0.0,=,0.0,0,0,=,0,0,0,=,0,44.333333333333336,45.0,<,-0.6666666666666643,39,41,<,-2,51,51,=,0,182,86,>,96
0,13,0.0,0.0,=,0.0,0,0,=,0,0,0,=,0,45.0,50.333333333333336,<,-5.333333333333336,41,45,<,-4,51,57,<,-6,86,146,<,-60
56,13,0.0,0.0,=,0.0,0,0,=,0,0,0,=,0,50.333333333333336,45.0,>,5.333333333333336,45,41,>,4,57,51,>,6,146,86,>,60
0,13,0.0,0.0,=,0.0,0,0,=,0,0,0,=,0,45.0,53.333333333333336,<,-8.333333333333336,41,52,<,-11,51,56,<,-5,86,188,<,-102
137,13,0.0,0.0,=,0.0,0,0,=,0,0,0,=,0,53.333333333333336,45.0,>,8.333333333333336,52,41,>,11,56,51,>,5,188,86,>,102
0,13,0.0,0.0,=,0.0,0,0,=,0,0,0,=,0,45.0,39.0,>,6.0,41,37,>,4,51,40,>,11,86,140,<,-54
0,13,0.0,0.0,=,0.0,0,0,=,0,0,0,=,0,39.0,45.0,<,-6.0,37,41,<,-4,40,51,<,-11,140,86,>,54
0,13,0.0,0.0,=,0.0,0,0,=,0,0,0,=,0,45.0,47.333333333333336,<,-2.3333333333333357,41,40,>,1,51,58,<,-7,86,201,<,-115
126,13,0.0,0.0,=,0.0,0,0,=,0,0,0,=,0,47.333333333333336,45.0,>,2.3333333333333357,40,41,<,-1,58,51,>,7,201,86,>,115
0,13,0.0,0.0,=,0.0,0,0,=,0,0,0,=,0,45.0,40.666666666666664,>,4.333333333333336,41,33,>,8,51,46,>,5,86,136,<,-50
0,13,0.0,0.0,=,0.0,0,0,=,0,0,0,=,0,40.666666666666664,45.0,<,-4.333333333333336,33,41,<,-8,46,51,<,-5,136,86,>,50
0,13,0.0,0.0,=,0.0,0,0,=,0,0,0,=,0,45.0,45.666666666666664,<,-0.6666666666666643,41,36,>,5,51,55,<,-4,86,208,<,-122
108,13,0.0,0.0,=,0.0,0,0,=,0,0,0,=,0,45.666666666666664,45.0,>,0.6666666666666643,36,41,<,-5,55,51,>,4,208,86,>,122
0,13,0.0,0.0,=,0.0,0,0,=,0,0,0,=,0,45.0,46.666666666666664,<,-1.6666666666666643,41,40,>,1,51,60,<,-9,86,98,<,-12
76,13,0.0,0.0,=,0.0,0,0,=,0,0,0,=,0,46.666666666666664,45.0,>,1.6666666666666643,40,41,<,-1,60,51,>,9,98,86,>,12
0,13,0.0,0.0,=,0.0,0,0,=,0,0,0,=,0,45.0,42.333333333333336,>,2.6666666666666643,41,33,>,8,51,54,<,-3,86,92,<,-6
72,13,0.0,0.0,=,0.0,0,0,=,0,0,0,=,0,42.333333333333336,45.0,<,-2.6666666666666643,33,41,<,-8,54,51,>,3,92,86,>,6
0,12,13.0,17.0,<,-4.0,0,0,=,0,39,51,<,-12,39.0,40.666666666666664,<,-1.6666666666666643,37,33,>,4,40,46,<,-6,140,136,>,4
0,12,17.0,13.0,>,4.0,0,0,=,0,51,39,>,12,40.666666666666664,39.0,>,1.6666666666666643,33,37,<,-4,46,40,>,6,136,140,<,-4
0,12,13.0,5.333333333333333,>,7.666666666666667,0,0,=,0,39,16,>,23,39.0,50.333333333333336,<,-11.333333333333336,37,45,<,-8,40,57,<,-17,140,146,<,-6
56,12,5.333333333333333,13.0,<,-7.666666666666667,0,0,=,0,16,39,<,-23,50.333333333333336,39.0,>,11.333333333333336,45,37,>,8,57,40,>,17,146,140,>,6
0,12,13.0,13.0,=,0.0,0,0,=,0,39,39,=,0,39.0,44.333333333333336,<,-5.333333333333336,37,39,<,-2,40,51,<,-11,140,182,<,-42
62,12,13.0,13.0,=,0.0,0,0,=,0,39,39,=,0,44.333333333333336,39.0,>,5.333333333333336,39,37,>,2,51,40,>,11,182,140,>,42
0,12,13.0,6.666666666666667,>,6.333333333333333,0,0,=,0,39,20,>,19,39.0,45.666666666666664,<,-6.666666666666664,37,33,>,4,40,52,<,-12,140,168,<,-28
66,12,6.666666666666667,13.0,<,-6.333333333333333,0,0,=,0,20,39,<,-19,45.666666666666664,39.0,>,6.666666666666664,33,37,<,-4,52,40,>,12,168,140,>,28
0,12,13.0,8.333333333333334,>,4.666666666666666,0,0,=,0,39,25,>,14,39.0,39.666666666666664,<,-0.6666666666666643,37,38,<,-1,40,42,<,-2,140,202,<,-62
70,12,8.333333333333334,13.0,<,-4.666666666666666,0,0,=,0,25,39,<,-14,39.666666666666664,39.0,>,0.6666666666666643,38,37,>,1,42,40,>,2,202,140,>,62
0,12,13.0,7.333333333333333,>,5.666666666666667,0,0,=,0,39,22,>,17,39.0,42.333333333333336,<,-3.3333333333333357,37,33,>,4,40,54,<,-14,140,92,>,48
72,12,7.333333333333333,13.0,<,-5.666666666666667,0,0,=,0,22,39,<,-17,42.333333333333336,39.0,>,3.3333333333333357,33,37,<,-4,54,40,>,14,92,140,<,-48
0,12,13.0,5.0,>,8.0,0,0,=,0,39,15,>,24,39.0,46.666666666666664,<,-7.666666666666664,37,40,<,-3,40,60,<,-20,140,98,>,42
0,12,5.0,13.0,<,-8.0,0,0,=,0,15,39,<,-24,46.666666666666664,39.0,>,7.666666666666664,40,37,>,3,60,40,>,20,98,140,<,-42
0,12,13.0,9.0,>,4.0,0,0,=,0,39,27,>,12,39.0,51.0,<,-12.0,37,38,<,-1,40,60,<,-20,140,107,>,33
62,12,9.0,13.0,<,-4.0,0,0,=,0,27,39,<,-12,51.0,39.0,>,12.0,38,37,>,1,60,40,>,20,107,140,<,-33
0,12,13.0,4.0,>,9.0,0,0,=,0,39,12,>,27,39.0,45.666666666666664,<,-6.666666666666664,37,36,>,1,40,55,<,-15,140,208,<,-68
108,12,4.0,13.0,<,-9.0,0,0,=,0,12,39,<,-27,45.666666666666664,39.0,>,6.666666666666664,36,37,<,-1,55,40,>,15,208,140,>,68
0,12,13.0,22.0,<,-9.0,0,0,=,0,39,66,<,-27,39.0,47.333333333333336,<,-8.333333333333336,37,40,<,-3,40,58,<,-18,140,201,<,-61
126,12,22.0,13.0,>,9.0,0,0,=,0,66,39,>,27,47.333333333333336,39.0,>,8.333333333333336,40,37,>,3,58,40,>,18,201,140,>,61
0,12,13.0,21.666666666666668,<,-8.666666666666668,0,0,=,0,39,65,<,-26,39.0,53.333333333333336,<,-14.333333333333336,37,52,<,-15,40,56,<,-16,140,188,<,-48
173,12,21.666666666666668,13.0,>,8.666666666666668,0,0,=,0,65,39,>,26,53.333333333333336,39.0,>,14.333333333333336,52,37,>,15,56,40,>,16,188,140,>,48
0,11,30.333333333333332,21.0,>,9.333333333333332,0,0,=,0,51,48,>,3,40.666666666666664,46.666666666666664,<,-6.0,33,40,<,-7,46,60,<,-14,136,98,>,38
0,11,21.0,30.333333333333332,<,-9.333333333333332,0,0,=,0,48,51,<,-3,46.666666666666664,40.666666666666664,>,6.0,40,33,>,7,60,46,>,14,98,136,<,-38
0,11,30.333333333333332,23.333333333333332,>,7.0,0,0,=,0,51,54,<,-3,40.666666666666664,50.333333333333336,<,-9.666666666666671,33,45,<,-12,46,57,<,-11,136,146,<,-10
65,11,23.333333333333332,30.333333333333332,<,-7.0,0,0,=,0,54,51,>,3,50.333333333333336,40.666666666666664,>,9.666666666666671,45,33,>,12,57,46,>,11,146,136,>,10
0,11,30.333333333333332,13.333333333333334,>,17.0,0,0,=,0,51,27,>,24,40.666666666666664,51.0,<,-10.333333333333336,33,38,<,-5,46,60,<,-14,136,107,>,29
62,11,13.333333333333334,30.333333333333332,<,-17.0,0,0,=,0,27,51,<,-24,51.0,40.666666666666664,>,10.333333333333336,38,33,>,5,60,46,>,14,107,136,<,-29
0,11,30.333333333333332,29.333333333333332,>,1.0,0,0,=,0,51,49,>,2,40.666666666666664,44.333333333333336,<,-3.6666666666666714,33,39,<,-6,46,51,<,-5,136,182,<,-46
77,11,29.333333333333332,30.333333333333332,<,-1.0,0,0,=,0,49,51,<,-2,44.333333333333336,40.666666666666664,>,3.6666666666666714,39,33,>,6,51,46,>,5,182,136,>,46
0,11,30.333333333333332,15.666666666666666,>,14.666666666666666,0,0,=,0,51,27,>,24,40.666666666666664,45.666666666666664,<,-5.0,33,33,=,0,46,52,<,-6,136,168,<,-32
81,11,15.666666666666666,30.333333333333332,<,-14.666666666666666,0,0,=,0,27,51,<,-24,45.666666666666664,40.666666666666664,>,5.0,33,33,=,0,52,46,>,6,168,136,>,32
0,11,30.333333333333332,33.666666666666664,<,-3.333333333333332,0,0,=,0,51,76,<,-25,40.666666666666664,39.666666666666664,>,1.0,33,38,<,-5,46,42,>,4,136,202,<,-66
85,11,33.666666666666664,30.333333333333332,>,3.333333333333332,0,0,=,0,76,51,>,25,39.666666666666664,40.666666666666664,<,-1.0,38,33,>,5,42,46,<,-4,202,136,>,66
0,11,30.333333333333332,13.333333333333334,>,17.0,0,0,=,0,51,22,>,29,40.666666666666664,42.333333333333336,<,-1.6666666666666714,33,33,=,0,46,54,<,-8,136,92,>,44
0,11,13.333333333333334,30.333333333333332,<,-17.0,0,0,=,0,22,51,<,-29,42.333333333333336,40.666666666666664,>,1.6666666666666714,33,33,=,0,54,46,>,8,92,136,<,-44
0,11,30.333333333333332,22.666666666666668,>,7.666666666666664,0,0,=,0,51,56,<,-5,40.666666666666664,45.666666666666664,<,-5.0,33,36,<,-3,46,55,<,-9,136,208,<,-72
108,11,22.666666666666668,30.333333333333332,<,-7.666666666666664,0,0,=,0,56,51,>,5,45.666666666666664,40.666666666666664,>,5.0,36,33,>,3,55,46,>,9,208,136,>,72
0,11,30.333333333333332,37.0,<,-6.666666666666668,0,0,=,0,51,66,<,-15,40.666666666666664,47.333333333333336,<,-6.666666666666671,33,40,<,-7,46,58,<,-12,136,201,<,-65
126,11,37.0,30.333333333333332,>,6.666666666666668,0,0,=,0,66,51,>,15,47.333333333333336,40.666666666666664,>,6.666666666666671,40,33,>,7,58,46,>,12,201,136,>,65
0,11,30.333333333333332,43.666666666666664,<,-13.333333333333332,0,0,=,0,51,66,<,-15,40.666666666666664,53.333333333333336,<,-12.666666666666671,33,52,<,-19,46,56,<,-10,136,188,<,-52
169,11,43.666666666666664,30.333333333333332,>,13.333333333333332,0,0,=,0,66,51,>,15,53.333333333333336,40.666666666666664,>,12.666666666666671,52,33,>,19,56,46,>,10,188,136,>,52
0,10,40.666666666666664,19.666666666666668,>,20.999999999999996,15,18,<,-3,59,22,>,37,46.666666666666664,42.333333333333336,>,4.333333333333329,40,33,>,7,60,54,>,6,98,92,>,6
0,10,19.666666666666668,40.666666666666664,<,-20.999999999999996,18,15,>,3,22,59,<,-37,42.333333333333336,46.666666666666664,<,-4.333333333333329,33,40,<,-7,54,60,<,-6,92,98,<,-6
0,10,40.666666666666664,25.333333333333332,>,15.333333333333332,15,13,>,2,59,36,>,23,46.666666666666664,51.0,<,-4.333333333333336,40,38,>,2,60,60,=,0,98,107,<,-9
62,10,25.333333333333332,40.666666666666664,<,-15.333333333333332,13,15,<,-2,36,59,<,-23,51.0,46.666666666666664,>,4.333333333333336,38,40,<,-2,60,60,=,0,107,98,>,9
0,10,40.666666666666664,28.0,>,12.666666666666664,15,14,>,1,59,54,>,5,46.666666666666664,50.333333333333336,<,-3.6666666666666714,40,45,<,-5,60,57,>,3,98,146,<,-48
0,10,28.0,40.666666666666664,<,-12.666666666666664,14,15,<,-1,54,59,<,-5,50.333333333333336,46.666666666666664,>,3.6666666666666714,45,40,>,5,57,60,<,-3,146,98,>,48
0,10,40.666666666666664,37.666666666666664,>,3.0,15,25,<,-10,59,49,>,10,46.666666666666664,44.333333333333336,>,2.3333333333333286,40,39,>,1,60,51,>,9,98,182,<,-84
45,10,37.666666666666664,40.666666666666664,<,-3.0,25,15,>,10,49,59,<,-10,44.333333333333336,46.666666666666664,<,-2.3333333333333286,39,40,<,-1,51,60,<,-9,182,98,>,84
0,10,40.666666666666664,31.666666666666668,>,8.999999999999996,15,20,<,-5,59,48,>,11,46.666666666666664,45.666666666666664,>,1.0,40,33,>,7,60,52,>,8,98,168,<,-70
71,10,31.666666666666668,40.666666666666664,<,-8.999999999999996,20,15,>,5,48,59,<,-11,45.666666666666664,46.666666666666664,<,-1.0,33,40,<,-7,52,60,<,-8,168,98,>,70
0,10,40.666666666666664,52.333333333333336,<,-11.666666666666671,15,25,<,-10,59,76,<,-17,46.666666666666664,39.666666666666664,>,7.0,40,38,>,2,60,42,>,18,98,202,<,-104
179,10,52.333333333333336,40.666666666666664,>,11.666666666666671,25,15,>,10,76,59,>,17,39.666666666666664,46.666666666666664,<,-7.0,38,40,<,-2,42,60,<,-18,202,98,>,104
0,10,40.666666666666664,49.0,<,-8.333333333333336,15,12,>,3,59,79,<,-20,46.666666666666664,45.666666666666664,>,1.0,40,36,>,4,60,55,>,5,98,208,<,-110
170,10,49.0,40.666666666666664,>,8.333333333333336,12,15,<,-3,79,59,>,20,45.666666666666664,46.666666666666664,<,-1.0,36,40,<,-4,55,60,<,-5,208,98,>,110
0,10,40.666666666666664,52.666666666666664,<,-12.0,15,45,<,-30,59,66,<,-7,46.666666666666664,47.333333333333336,<,-0.6666666666666714,40,40,=,0,60,58,>,2,98,201,<,-103
211,10,52.666666666666664,40.666666666666664,>,12.0,45,15,>,30,66,59,>,7,47.333333333333336,46.666666666666664,>,0.6666666666666714,40,40,=,0,58,60,<,-2,201,98,>,103
0,10,40.666666666666664,53.0,<,-12.333333333333336,15,28,<,-13,59,66,<,-7,46.666666666666664,53.333333333333336,<,-6.666666666666671,40,52,<,-12,60,56,>,4,98,188,<,-90
192,10,53.0,40.666666666666664,>,12.333333333333336,28,15,>,13,66,59,>,7,53.333333333333336,46.666666666666664,>,6.666666666666671,52,40,>,12,56,60,<,-4,188,98,>,90
0,9,28.333333333333332,33.666666666666664,<,-5.333333333333332,14,18,<,-4,54,64,<,-10,50.333333333333336,42.333333333333336,>,8.0,45,33,>,12,57,54,>,3,146,92,>,54
0,9,33.666666666666664,28.333333333333332,>,5.333333333333332,18,14,>,4,64,54,>,10,42.333333333333336,50.333333333333336,<,-8.0,33,45,<,-12,54,57,<,-3,92,146,<,-54
0,9,28.333333333333332,54.333333333333336,<,-26.000000000000004,14,25,<,-11,54,89,<,-35,50.333333333333336,44.333333333333336,>,6.0,45,39,>,6,57,51,>,6,146,182,<,-36
45,9,54.333333333333336,28.333333333333332,>,26.000000000000004,25,14,>,11,89,54,>,35,44.333333333333336,50.333333333333336,<,-6.0,39,45,<,-6,51,57,<,-6,182,146,>,36
0,9,28.333333333333332,19.666666666666668,>,8.666666666666664,14,10,>,4,54,36,>,18,50.333333333333336,51.0,<,-0.6666666666666643,45,38,>,7,57,60,<,-3,146,107,>,39
0,9,19.666666666666668,28.333333333333332,<,-8.666666666666664,10,14,<,-4,36,54,<,-18,51.0,50.333333333333336,>,0.6666666666666643,38,45,<,-7,60,57,>,3,107,146,<,-39
0,9,28.333333333333332,53.666666666666664,<,-25.333333333333332,14,27,<,-13,54,86,<,-32,50.333333333333336,45.666666666666664,>,4.666666666666671,45,33,>,12,57,52,>,5,146,168,<,-22
71,9,53.666666666666664,28.333333333333332,>,25.333333333333332,27,14,>,13,86,54,>,32,45.666666666666664,50.333333333333336,<,-4.666666666666671,33,45,<,-12,52,57,<,-5,168,146,>,22
0,9,28.333333333333332,67.33333333333333,<,-39.0,14,56,<,-42,54,79,<,-25,50.333333333333336,45.666666666666664,>,4.666666666666671,45,36,>,9,57,55,>,2,146,208,<,-62
190,9,67.33333333333333,28.333333333333332,>,39.0,56,14,>,42,79,54,>,25,45.666666666666664,50.333333333333336,<,-4.666666666666671,36,45,<,-9,55,57,<,-2,208,146,>,62
0,9,28.333333333333332,50.0,<,-21.666666666666668,14,18,<,-4,54,76,<,-22,50.333333333333336,39.666666666666664,>,10.666666666666671,45,38,>,7,57,42,>,15,146,202,<,-56
129,9,50.0,28.333333333333332,>,21.666666666666668,18,14,>,4,76,54,>,22,39.666666666666664,50.333333333333336,<,-10.666666666666671,38,45,<,-7,42,57,<,-15,202,146,>,56
0,9,28.333333333333332,43.0,<,-14.666666666666668,14,28,<,-14,54,66,<,-12,50.333333333333336,53.333333333333336,<,-3.0,45,52,<,-7,57,56,>,1,146,188,<,-42
159,9,43.0,28.333333333333332,>,14.666666666666668,28,14,>,14,66,54,>,12,53.333333333333336,50.333333333333336,>,3.0,52,45,>,7,56,57,<,-1,188,146,>,42
0,9,28.333333333333332,42.333333333333336,<,-14.000000000000004,14,35,<,-21,54,47,>,7,50.333333333333336,47.333333333333336,>,3.0,45,40,>,5,57,58,<,-1,146,201,<,-55
133,9,42.333333333333336,28.333333333333332,>,14.000000000000004,35,14,>,21,47,54,<,-7,47.333333333333336,50.333333333333336,<,-3.0,40,45,<,-5,58,57,>,1,201,146,>,55
0,8,31.666666666666668,44.0,<,-12.333333333333332,10,18,<,-8,72,64,>,8,51.0,42.333333333333336,>,8.666666666666664,38,33,>,5,60,54,>,6,107,92,>,15
0,8,44.0,31.666666666666668,>,12.333333333333332,18,10,>,8,64,72,<,-8,42.333333333333336,51.0,<,-8.666666666666664,33,38,<,-5,54,60,<,-6,92,107,<,-15
0,8,31.666666666666668,65.66666666666667,<,-34.0,10,49,<,-39,72,89,<,-17,51.0,44.333333333333336,>,6.666666666666664,38,39,<,-1,60,51,>,9,107,182,<,-75
76,8,65.66666666666667,31.666666666666668,>,34.0,49,10,>,39,89,72,>,17,44.333333333333336,51.0,<,-6.666666666666664,39,38,>,1,51,60,<,-9,182,107,>,75
0,8,31.666666666666668,42.666666666666664,<,-10.999999999999996,10,15,<,-5,72,86,<,-14,51.0,45.666666666666664,>,5.333333333333336,38,33,>,5,60,52,>,8,107,168,<,-61
0,8,42.666666666666664,31.666666666666668,>,10.999999999999996,15,10,>,5,86,72,>,14,45.666666666666664,51.0,<,-5.333333333333336,33,38,<,-5,52,60,<,-8,168,107,>,61
0,8,31.666666666666668,40.333333333333336,<,-8.666666666666668,10,18,<,-8,72,76,<,-4,51.0,39.666666666666664,>,11.333333333333336,38,38,=,0,60,42,>,18,107,202,<,-95
84,8,40.333333333333336,31.666666666666668,>,8.666666666666668,18,10,>,8,76,72,>,4,39.666666666666664,51.0,<,-11.333333333333336,38,38,=,0,42,60,<,-18,202,107,>,95
0,8,31.666666666666668,33.0,<,-1.3333333333333321,10,19,<,-9,72,45,>,27,51.0,47.333333333333336,>,3.6666666666666643,38,40,<,-2,60,58,>,2,107,201,<,-94
106,8,33.0,31.666666666666668,>,1.3333333333333321,19,10,>,9,45,72,<,-27,47.333333333333336,51.0,<,-3.6666666666666643,40,38,>,2,58,60,<,-2,201,107,>,94
0,8,31.666666666666668,47.0,<,-15.333333333333332,10,35,<,-25,72,66,>,6,51.0,53.333333333333336,<,-2.3333333333333357,38,52,<,-14,60,56,>,4,107,188,<,-81
131,8,47.0,31.666666666666668,>,15.333333333333332,35,10,>,25,66,72,<,-6,53.333333333333336,51.0,>,2.3333333333333357,52,38,>,14,56,60,<,-4,188,107,>,81
0,8,31.666666666666668,54.0,<,-22.333333333333332,10,39,<,-29,72,67,>,5,51.0,45.666666666666664,>,5.333333333333336,38,36,>,2,60,55,>,5,107,208,<,-101
140,8,54.0,31.666666666666668,>,22.333333333333332,39,10,>,29,67,72,<,-5,45.666666666666664,51.0,<,-5.333333333333336,36,38,<,-2,55,60,<,-5,208,107,>,101
0,7,17.666666666666668,50.666666666666664,<,-33.0,11,18,<,-7,27,84,<,-57,45.666666666666664,42.333333333333336,>,3.3333333333333286,33,33,=,0,52,54,<,-2,168,92,>,76
0,7,50.666666666666664,17.666666666666668,>,33.0,18,11,>,7,84,27,>,57,42.333333333333336,45.666666666666664,<,-3.3333333333333286,33,33,=,0,54,52,>,2,92,168,<,-76
0,7,17.666666666666668,60.0,<,-42.33333333333333,11,49,<,-38,27,72,<,-45,45.666666666666664,44.333333333333336,>,1.3333333333333286,33,39,<,-6,52,51,>,1,168,182,<,-14
76,7,60.0,17.666666666666668,>,42.33333333333333,49,11,>,38,72,27,>,45,44.333333333333336,45.666666666666664,<,-1.3333333333333286,39,33,>,6,51,52,<,-1,182,168,>,14
0,7,17.666666666666668,48.333333333333336,<,-30.666666666666668,11,27,<,-16,27,76,<,-49,45.666666666666664,39.666666666666664,>,6.0,33,38,<,-5,52,42,>,10,168,202,<,-34
51,7,48.333333333333336,17.666666666666668,>,30.666666666666668,27,11,>,16,76,27,>,49,39.666666666666664,45.666666666666664,<,-6.0,38,33,>,5,42,52,<,-10,202,168,>,34
0,7,17.666666666666668,26.0,<,-8.333333333333332,11,14,<,-3,27,45,<,-18,45.666666666666664,47.333333333333336,<,-1.6666666666666714,33,40,<,-7,52,58,<,-6,168,201,<,-33
0,7,26.0,17.666666666666668,>,8.333333333333332,14,11,>,3,45,27,>,18,47.333333333333336,45.666666666666664,>,1.6666666666666714,40,33,>,7,58,52,>,6,201,168,>,33
0,7,17.666666666666668,48.666666666666664,<,-30.999999999999996,11,40,<,-29,27,66,<,-39,45.666666666666664,53.333333333333336,<,-7.666666666666671,33,52,<,-19,52,56,<,-4,168,188,<,-20
98,7,48.666666666666664,17.666666666666668,>,30.999999999999996,40,11,>,29,66,27,>,39,53.333333333333336,45.666666666666664,>,7.666666666666671,52,33,>,19,56,52,>,4,188,168,>,20
0,7,17.666666666666668,39.333333333333336,<,-21.666666666666668,11,23,<,-12,27,56,<,-29,45.666666666666664,45.666666666666664,=,0.0,33,36,<,-3,52,55,<,-3,168,208,<,-40
44,7,39.333333333333336,17.666666666666668,>,21.666666666666668,23,11,>,12,56,27,>,29,45.666666666666664,45.666666666666664,=,0.0,36,33,>,3,55,52,>,3,208,168,>,40
0,6,38.333333333333336,53.666666666666664,<,-15.333333333333329,14,18,<,-4,56,84,<,-28,47.333333333333336,42.333333333333336,>,5.0,40,33,>,7,58,54,>,4,201,92,>,109
0,6,53.666666666666664,38.333333333333336,>,15.333333333333329,18,14,>,4,84,56,>,28,42.333333333333336,47.333333333333336,<,-5.0,33,40,<,-7,54,58,<,-4,92,201,<,-109
0,6,38.333333333333336,42.333333333333336,<,-4.0,14,23,<,-9,56,56,=,0,47.333333333333336,45.666666666666664,>,1.6666666666666714,40,36,>,4,58,55,>,3,201,208,<,-7
44,6,42.333333333333336,38.333333333333336,>,4.0,23,14,>,9,56,56,=,0,45.666666666666664,47.333333333333336,<,-1.6666666666666714,36,40,<,-4,55,58,<,-3,208,201,>,7
0,6,38.333333333333336,50.666666666666664,<,-12.333333333333329,14,34,<,-20,56,76,<,-20,47.333333333333336,39.666666666666664,>,7.666666666666671,40,38,>,2,58,42,>,16,201,202,<,-1
51,6,50.666666666666664,38.333333333333336,>,12.333333333333329,34,14,>,20,76,56,>,20,39.666666666666664,47.333333333333336,<,-7.666666666666671,38,40,<,-2,42,58,<,-16,202,201,>,1
0,6,38.333333333333336,46.0,<,-7.666666666666664,14,17,<,-3,56,72,<,-16,47.333333333333336,44.333333333333336,>,3.0,40,39,>,1,58,51,>,7,201,182,>,19
0,6,46.0,38.333333333333336,>,7.666666666666664,17,14,>,3,72,56,>,16,44.333333333333336,47.333333333333336,<,-3.0,39,40,<,-1,51,58,<,-7,182,201,<,-19
0,6,38.333333333333336,64.0,<,-25.666666666666664,14,40,<,-26,56,86,<,-30,47.333333333333336,53.333333333333336,<,-6.0,40,52,<,-12,58,56,>,2,201,188,>,13
98,6,64.0,38.333333333333336,>,25.666666666666664,40,14,>,26,86,56,>,30,53.333333333333336,47.333333333333336,>,6.0,52,40,>,12,56,58,<,-2,188,201,<,-13
0,5,45.333333333333336,51.666666666666664,<,-6.333333333333329,17,18,<,-1,70,78,<,-8,44.333333333333336,42.333333333333336,>,2.0,39,33,>,6,51,54,<,-3,182,92,>,90
0,5,51.666666666666664,45.333333333333336,>,6.333333333333329,18,17,>,1,78,70,>,8,42.333333333333336,44.333333333333336,<,-2.0,33,39,<,-6,54,51,>,3,92,182,<,-90
0,5,45.333333333333336,42.0,>,3.3333333333333357,17,22,<,-5,70,56,>,14,44.333333333333336,45.666666666666664,<,-1.3333333333333286,39,36,>,3,51,55,<,-4,182,208,<,-26
43,5,42.0,45.333333333333336,<,-3.3333333333333357,22,17,>,5,56,70,<,-14,45.666666666666664,44.333333333333336,>,1.3333333333333286,36,39,<,-3,55,51,>,4,208,182,>,26
0,5,45.333333333333336,43.0,>,2.3333333333333357,17,19,<,-2,70,76,<,-6,44.333333333333336,39.666666666666664,>,4.666666666666671,39,38,>,1,51,42,>,9,182,202,<,-20
0,5,43.0,45.333333333333336,<,-2.3333333333333357,19,17,>,2,76,70,>,6,39.666666666666664,44.333333333333336,<,-4.666666666666671,38,39,<,-1,42,51,<,-9,202,182,>,20
0,5,45.333333333333336,75.0,<,-29.666666666666664,17,66,<,-49,70,86,<,-16,44.333333333333336,53.333333333333336,<,-9.0,39,52,<,-13,51,56,<,-5,182,188,<,-6
140,5,75.0,45.333333333333336,>,29.666666666666664,66,17,>,49,86,70,>,16,53.333333333333336,44.333333333333336,>,9.0,52,39,>,13,56,51,>,5,188,182,>,6
0,4,38.333333333333336,39.333333333333336,<,-1.0,19,18,>,1,76,78,<,-2,39.666666666666664,42.333333333333336,<,-2.6666666666666714,38,33,>,5,42,54,<,-12,202,92,>,110
0,4,39.333333333333336,38.333333333333336,>,1.0,18,19,<,-1,78,76,>,2,42.333333333333336,39.666666666666664,>,2.6666666666666714,33,38,<,-5,54,42,>,12,92,202,<,-110
0,4,38.333333333333336,43.666666666666664,<,-5.333333333333329,19,22,<,-3,76,56,>,20,39.666666666666664,45.666666666666664,<,-6.0,38,36,>,2,42,55,<,-13,202,208,<,-6
43,4,43.666666666666664,38.333333333333336,>,5.333333333333329,22,19,>,3,56,76,<,-20,45.666666666666664,39.666666666666664,>,6.0,36,38,<,-2,55,42,>,13,208,202,>,6
0,4,38.333333333333336,50.666666666666664,<,-12.333333333333329,19,13,>,6,76,73,>,3,39.666666666666664,53.333333333333336,<,-13.666666666666671,38,52,<,-14,42,56,<,-14,202,188,>,14
86,4,50.666666666666664,38.333333333333336,>,12.333333333333329,13,19,<,-6,73,76,<,-3,53.333333333333336,39.666666666666664,>,13.666666666666671,52,38,>,14,56,42,>,14,188,202,<,-14
0,3,25.333333333333332,63.333333333333336,<,-38.0,18,53,<,-35,36,81,<,-45,42.333333333333336,45.666666666666664,<,-3.3333333333333286,33,36,<,-3,54,55,<,-1,92,208,<,-116
105,3,63.333333333333336,25.333333333333332,>,38.0,53,18,>,35,81,36,>,45,45.666666666666664,42.333333333333336,>,3.3333333333333286,36,33,>,3,55,54,>,1,208,92,>,116
0,3,25.333333333333332,49.333333333333336,<,-24.000000000000004,18,13,>,5,36,69,<,-33,42.333333333333336,53.333333333333336,<,-11.0,33,52,<,-19,54,56,<,-2,92,188,<,-96
86,3,49.333333333333336,25.333333333333332,>,24.000000000000004,13,18,<,-5,69,36,>,33,53.333333333333336,42.333333333333336,>,11.0,52,33,>,19,56,54,>,2,188,92,>,96
0,2,31.333333333333332,66.33333333333333,<,-35.0,12,53,<,-41,69,81,<,-12,53.333333333333336,45.666666666666664,>,7.666666666666671,52,36,>,16,56,55,>,1,188,208,<,-20
84,2,66.33333333333333,31.333333333333332,>,35.0,53,12,>,41,81,69,>,12,45.666666666666664,53.333333333333336,<,-7.666666666666671,36,52,<,-16,55,56,<,-1,208,188,>,20
0,20,0.0,0.0,=,0.0,0,0,=,0,0,0,=,0,53.666666666666664,45.333333333333336,>,8.333333333333329,49,33,>,16,59,54,>,5,166,216,<,-50
70,20,0.0,0.0,=,0.0,0,0,=,0,0,0,=,0,45.333333333333336,53.666666666666664,<,-8.333333333333329,33,49,<,-16,54,59,<,-5,216,166,>,50
0,20,0.0,0.0,=,0.0,0,0,=,0,0,0,=,0,53.666666666666664,44.0,>,9.666666666666664,49,30,>,19,59,56,>,3,166,308,<,-142
70,20,0.0,0.0,=,0.0,0,0,=,0,0,0,=,0,44.0,53.666666666666664,<,-9.666666666666664,30,49,<,-19,56,59,<,-3,308,166,>,142
0,20,0.0,0.0,=,0.0,0,0,=,0,0,0,=,0,53.666666666666664,42.0,>,11.666666666666664,49,33,>,16,59,56,>,3,166,180,<,-14
69,20,0.0,0.0,=,0.0,0,0,=,0,0,0,=,0,42.0,53.666666666666664,<,-11.666666666666664,33,49,<,-16,56,59,<,-3,180,166,>,14
0,20,0.0,0.0,=,0.0,0,0,=,0,0,0,=,0,53.666666666666664,46.0,>,7.666666666666664,49,30,>,19,59,55,>,4,166,319,<,-153
127,20,0.0,0.0,=,0.0,0,0,=,0,0,0,=,0,46.0,53.666666666666664,<,-7.666666666666664,30,49,<,-19,55,59,<,-4,319,166,>,153
0,20,0.0,0.0,=,0.0,0,0,=,0,0,0,=,0,53.666666666666664,46.666666666666664,>,7.0,49,36,>,13,59,55,>,4,166,213,<,-47
69,20,0.0,0.0,=,0.0,0,0,=,0,0,0,=,0,46.666666666666664,53.666666666666664,<,-7.0,36,49,<,-13,55,59,<,-4,213,166,>,47
0,20,0.0,0.0,=,0.0,0,0,=,0,0,0,=,0,53.666666666666664,37.666666666666664,>,16.0,49,32,>,17,59,42,>,17,166,305,<,-139
105,20,0.0,0.0,=,0.0,0,0,=,0,0,0,=,0,37.666666666666664,53.666666666666664,<,-16.0,32,49,<,-17,42,59,<,-17,305,166,>,139
0,20,0.0,0.0,=,0.0,0,0,=,0,0,0,=,0,53.666666666666664,35.333333333333336,>,18.33333333333333,49,30,>,19,59,40,>,19,166,253,<,-87
34,20,0.0,0.0,=,0.0,0,0,=,0,0,0,=,0,35.333333333333336,53.666666666666664,<,-18.33333333333333,30,49,<,-19,40,59,<,-19,253,166,>,87
0,20,0.0,0.0,=,0.0,0,0,=,0,0,0,=,0,53.666666666666664,46.0,>,7.666666666666664,49,39,>,10,59,56,>,3,166,299,<,-133
120,20,0.0,0.0,=,0.0,0,0,=,0,0,0,=,0,46.0,53.666666666666664,<,-7.666666666666664,39,49,<,-10,56,59,<,-3,299,166,>,133
0,20,0.0,0.0,=,0.0,0,0,=,0,0,0,=,0,53.666666666666664,47.333333333333336,>,6.333333333333329,49,30,>,19,59,56,>,3,166,218,<,-52
14,20,0.0,0.0,=,0.0,0,0,=,0,0,0,=,0,47.333333333333336,53.666666666666664,<,-6.333333333333329,30,49,<,-19,56,59,<,-3,218,166,>,52
0,20,0.0,0.0,=,0.0,0,0,=,0,0,0,=,0,53.666666666666664,43.333333333333336,>,10.333333333333329,49,33,>,16,59,58,>,1,166,130,>,36
63,20,0.0,0.0,=,0.0,0,0,=,0,0,0,=,0,43.333333333333336,53.666666666666664,<,-10.333333333333329,33,49,<,-16,58,59,<,-1,130,166,<,-36
0,20,0.0,0.0,=,0.0,0,0,=,0,0,0,=,0,53.666666666666664,43.333333333333336,>,10.333333333333329,49,30,>,19,59,51,>,8,166,131,>,35
24,20,0.0,0.0,=,0.0,0,0,=,0,0,0,=,0,43.333333333333336,53.666666666666664,<,-10.333333333333329,30,49,<,-19,51,59,<,-8,131,166,<,-35
0,20,0.0,0.0,=,0.0,0,0,=,0,0,0,=,0,53.666666666666664,41.666666666666664,>,12.0,49,34,>,15,59,52,>,7,166,114,>,52
29,20,0.0,0.0,=,0.0,0,0,=,0,0,0,=,0,41.666666666666664,53.666666666666664,<,-12.0,34,49,<,-15,52,59,<,-7,114,166,<,-52
0,20,0.0,0.0,=,0.0,0,0,=,0,0,0,=,0,53.666666666666664,48.0,>,5.666666666666664,49,43,>,6,59,53,>,6,166,277,<,-111
92,20,0.0,0.0,=,0.0,0,0,=,0,0,0,=,0,48.0,53.666666666666664,<,-5.666666666666664,43,49,<,-6,53,59,<,-6,277,166,>,111
0,20,0.0,0.0,=,0.0,0,0,=,0,0,0,=,0,53.666666666666664,42.0,>,11.666666666666664,49,38,>,11,59,49,>,10,166,118,>,48
0,20,0.0,0.0,=,0.0,0,0,=,0,0,0,=,0,42.0,53.666666666666664,<,-11.666666666666664,38,49,<,-11,49,59,<,-10,118,166,<,-48
0,20,0.0,0.0,=,0.0,0,0,=,0,0,0,=,0,53.666666666666664,43.333333333333336,>,10.333333333333329,49,36,>,13,59,53,>,6,166,108,>,58
0,20,0.0,0.0,=,0.0,0,0,=,0,0,0,=,0,43.333333333333336,53.666666666666664,<,-10.333333333333329,36,49,<,-13,53,59,<,-6,108,166,<,-58
0,20,0.0,0.0,=,0.0,0,0,=,0,0,0,=,0,53.666666666666664,41.666666666666664,>,12.0,49,33,>,16,59,55,>,4,166,206,<,-40
44,20,0.0,0.0,=,0.0,0,0,=,0,0,0,=,0,41.666666666666664,53.666666666666664,<,-12.0,33,49,<,-16,55,59,<,-4,206,166,>,40
0,20,0.0,0.0,=,0.0,0,0,=,0,0,0,=,0,53.666666666666664,45.666666666666664,>,8.0,49,34,>,15,59,59,=,0,166,205,<,-39
55,20,0.0,0.0,=,0.0,0,0,=,0,0,0,=,0,45.666666666666664,53.666666666666664,<,-8.0,34,49,<,-15,59,59,=,0,205,166,>,39
0,20,0.0,0.0,=,0.0,0,0,=,0,0,0,=,0,53.666666666666664,51.666666666666664,>,2.0,49,44,>,5,59,56,>,3,166,216,<,-50
89,20,0.0,0.0,=,0.0,0,0,=,0,0,0,=,0,51.666666666666664,53.666666666666664,<,-2.0,44,49,<,-5,56,59,<,-3,216,166,>,50
0,20,0.0,0.0,=,0.0,0,0,=,0,0,0,=,0,53.666666666666664,38.0,>,15.666666666666664,49,30,>,19,59,46,>,13,166,274,<,-108
128,20,0.0,0.0,=,0.0,0,0,=,0,0,0,=,0,38.0,53.666666666666664,<,-15.666666666666664,30,49,<,-19,46,59,<,-13,274,166,>,108
0,19,3.6666666666666665,9.0,<,-5.333333333333334,0,0,=,0,11,27,<,-16,41.666666666666664,42.0,<,-0.3333333333333357,34,38,<,-4,52,49,>,3,114,118,<,-4
17,19,9.0,3.6666666666666665,>,5.333333333333334,0,0,=,0,27,11,>,16,42.0,41.666666666666664,>,0.3333333333333357,38,34,>,4,49,52,<,-3,118,114,>,4
0,19,3.6666666666666665,6.0,<,-2.3333333333333335,0,0,=,0,11,18,<,-7,41.666666666666664,43.333333333333336,<,-1.6666666666666714,34,36,<,-2,52,53,<,-1,114,108,>,6
28,19,6.0,3.6666666666666665,>,2.3333333333333335,0,0,=,0,18,11,>,7,43.333333333333336,41.666666666666664,>,1.6666666666666714,36,34,>,2,53,52,>,1,108,114,<,-6
0,19,3.6666666666666665,4.666666666666667,<,-1.0000000000000004,0,0,=,0,11,14,<,-3,41.666666666666664,47.333333333333336,<,-5.666666666666671,34,30,>,4,52,56,<,-4,114,218,<,-104
58,19,4.666666666666667,3.6666666666666665,>,1.0000000000000004,0,0,=,0,14,11,>,3,47.333333333333336,41.666666666666664,>,5.666666666666671,30,34,<,-4,56,52,>,4,218,114,>,104
0,19,3.6666666666666665,28.333333333333332,<,-24.666666666666664,0,0,=,0,11,85,<,-74,41.666666666666664,43.333333333333336,<,-1.6666666666666714,34,30,>,4,52,51,>,1,114,131,<,-17
52,19,28.333333333333332,3.6666666666666665,>,24.666666666666664,0,0,=,0,85,11,>,74,43.333333333333336,41.666666666666664,>,1.6666666666666714,30,34,<,-4,51,52,<,-1,131,114,>,17
0,19,3.6666666666666665,19.666666666666668,<,-16.0,0,0,=,0,11,59,<,-48,41.666666666666664,35.333333333333336,>,6.333333333333329,34,30,>,4,52,40,>,12,114,253,<,-139
68,19,19.666666666666668,3.6666666666666665,>,16.0,0,0,=,0,59,11,>,48,35.333333333333336,41.666666666666664,<,-6.333333333333329,30,34,<,-4,40,52,<,-12,253,114,>,139
0,19,3.6666666666666665,6.0,<,-2.3333333333333335,0,0,=,0,11,18,<,-7,41.666666666666664,41.666666666666664,=,0.0,34,33,>,1,52,55,<,-3,114,206,<,-92
73,19,6.0,3.6666666666666665,>,2.3333333333333335,0,0,=,0,18,11,>,7,41.666666666666664,41.666666666666664,=,0.0,33,34,<,-1,55,52,>,3,206,114,>,92
0,19,3.6666666666666665,24.333333333333332,<,-20.666666666666664,0,0,=,0,11,73,<,-62,41.666666666666664,45.666666666666664,<,-4.0,34,34,=,0,52,59,<,-7,114,205,<,-91
39,19,24.333333333333332,3.6666666666666665,>,20.666666666666664,0,0,=,0,73,11,>,62,45.666666666666664,41.666666666666664,>,4.0,34,34,=,0,59,52,>,7,205,114,>,91
0,19,3.6666666666666665,6.666666666666667,<,-3.0000000000000004,0,0,=,0,11,20,<,-9,41.666666666666664,43.333333333333336,<,-1.6666666666666714,34,33,>,1,52,58,<,-6,114,130,<,-16
86,19,6.666666666666667,3.6666666666666665,>,3.0000000000000004,0,0,=,0,20,11,>,9,43.333333333333336,41.666666666666664,>,1.6666666666666714,33,34,<,-1,58,52,>,6,130,114,>,16
0,19,3.6666666666666665,24.333333333333332,<,-20.666666666666664,0,0,=,0,11,73,<,-62,41.666666666666664,42.0,<,-0.3333333333333357,34,33,>,1,52,56,<,-4,114,180,<,-66
71,19,24.333333333333332,3.6666666666666665,>,20.666666666666664,0,0,=,0,73,11,>,62,42.0,41.666666666666664,>,0.3333333333333357,33,34,<,-1,56,52,>,4,180,114,>,66
0,19,3.6666666666666665,11.333333333333334,<,-7.666666666666668,0,0,=,0,11,34,<,-23,41.666666666666664,46.666666666666664,<,-5.0,34,36,<,-2,52,55,<,-3,114,213,<,-99
40,19,11.333333333333334,3.6666666666666665,>,7.666666666666668,0,0,=,0,34,11,>,23,46.666666666666664,41.666666666666664,>,5.0,36,34,>,2,55,52,>,3,213,114,>,99
0,19,3.6666666666666665,26.333333333333332,<,-22.666666666666664,0,0,=,0,11,79,<,-68,41.666666666666664,45.333333333333336,<,-3.6666666666666714,34,33,>,1,52,54,<,-2,114,216,<,-102
0,19,26.333333333333332,3.6666666666666665,>,22.666666666666664,0,0,=,0,79,11,>,68,45.333333333333336,41.666666666666664,>,3.6666666666666714,33,34,<,-1,54,52,>,2,216,114,>,102
0,19,3.6666666666666665,15.666666666666666,<,-12.0,0,0,=,0,11,47,<,-36,41.666666666666664,44.0,<,-2.3333333333333357,34,30,>,4,52,56,<,-4,114,308,<,-194
146,19,15.666666666666666,3.6666666666666665,>,12.0,0,0,=,0,47,11,>,36,44.0,41.666666666666664,>,2.3333333333333357,30,34,<,-4,56,52,>,4,308,114,>,194
0,19,3.6666666666666665,22.666666666666668,<,-19.0,0,0,=,0,11,68,<,-57,41.666666666666664,51.666666666666664,<,-10.0,34,44,<,-10,52,56,<,-4,114,216,<,-102
107,19,22.666666666666668,3.6666666666666665,>,19.0,0,0,=,0,68,11,>,57,51.666666666666664,41.666666666666664,>,10.0,44,34,>,10,56,52,>,4,216,114,>,102
0,19,3.6666666666666665,11.666666666666666,<,-8.0,0,0,=,0,11,35,<,-24,41.666666666666664,48.0,<,-6.333333333333336,34,43,<,-9,52,53,<,-1,114,277,<,-163
105,19,11.666666666666666,3.6666666666666665,>,8.0,0,0,=,0,35,11,>,24,48.0,41.666666666666664,>,6.333333333333336,43,34,>,9,53,52,>,1,277,114,>,163
0,19,3.6666666666666665,28.666666666666668,<,-25.0,0,0,=,0,11,86,<,-75,41.666666666666664,37.666666666666664,>,4.0,34,32,>,2,52,42,>,10,114,305,<,-191
150,19,28.666666666666668,3.6666666666666665,>,25.0,0,0,=,0,86,11,>,75,37.666666666666664,41.666666666666664,<,-4.0,32,34,<,-2,42,52,<,-10,305,114,>,191
0,19,3.6666666666666665,10.666666666666666,<,-7.0,0,0,=,0,11,32,<,-21,41.666666666666664,46.0,<,-4.333333333333336,34,39,<,-5,52,56,<,-4,114,299,<,-185
161,19,10.666666666666666,3.6666666666666665,>,7.0,0,0,=,0,32,11,>,21,46.0,41.666666666666664,>,4.333333333333336,39,34,>,5,56,52,>,4,299,114,>,185
0,19,3.6666666666666665,3.6666666666666665,=,0.0,0,0,=,0,11,11,=,0,41.666666666666664,46.0,<,-4.333333333333336,34,30,>,4,52,55,<,-3,114,319,<,-205
133,19,3.6666666666666665,3.6666666666666665,=,0.0,0,0,=,0,11,11,=,0,46.0,41.666666666666664,>,4.333333333333336,30,34,<,-4,55,52,>,3,319,114,>,205
0,19,3.6666666666666665,11.666666666666666,<,-8.0,0,0,=,0,11,35,<,-24,41.666666666666664,38.0,>,3.6666666666666643,34,30,>,4,52,46,>,6,114,274,<,-160
159,19,11.666666666666666,3.6666666666666665,>,8.0,0,0,=,0,35,11,>,24,38.0,41.666666666666664,<,-3.6666666666666643,30,34,<,-4,46,52,<,-6,274,114,>,160
0,18,20.0,24.0,<,-4.0,0,0,=,0,60,72,<,-12,45.333333333333336,42.0,>,3.3333333333333357,33,38,<,-5,54,49,>,5,216,118,>,98
28,18,24.0,20.0,>,4.0,0,0,=,0,72,60,>,12,42.0,45.333333333333336,<,-3.3333333333333357,38,33,>,5,49,54,<,-5,118,216,<,-98
0,18,20.0,6.333333333333333,>,13.666666666666668,0,0,=,0,60,19,>,41,45.333333333333336,43.333333333333336,>,2.0,33,36,<,-3,54,53,>,1,216,108,>,108
0,18,6.333333333333333,20.0,<,-13.666666666666668,0,0,=,0,19,60,<,-41,43.333333333333336,45.333333333333336,<,-2.0,36,33,>,3,53,54,<,-1,108,216,<,-108
0,18,20.0,28.333333333333332,<,-8.333333333333332,0,0,=,0,60,85,<,-25,45.333333333333336,45.666666666666664,<,-0.3333333333333286,33,34,<,-1,54,59,<,-5,216,205,>,11
73,18,28.333333333333332,20.0,>,8.333333333333332,0,0,=,0,85,60,>,25,45.666666666666664,45.333333333333336,>,0.3333333333333286,34,33,>,1,59,54,>,5,205,216,<,-11
0,18,20.0,28.333333333333332,<,-8.333333333333332,0,0,=,0,60,85,<,-25,45.333333333333336,46.666666666666664,<,-1.3333333333333286,33,36,<,-3,54,55,<,-1,216,213,>,3
90,18,28.333333333333332,20.0,>,8.333333333333332,0,0,=,0,85,60,>,25,46.666666666666664,45.333333333333336,>,1.3333333333333286,36,33,>,3,55,54,>,1,213,216,<,-3
0,18,20.0,13.666666666666666,>,6.333333333333334,0,0,=,0,60,41,>,19,45.333333333333336,43.333333333333336,>,2.0,33,30,>,3,54,51,>,3,216,131,>,85
90,18,13.666666666666666,20.0,<,-6.333333333333334,0,0,=,0,41,60,<,-19,43.333333333333336,45.333333333333336,<,-2.0,30,33,<,-3,51,54,<,-3,131,216,<,-85
0,18,20.0,12.0,>,8.0,0,0,=,0,60,36,>,24,45.333333333333336,47.333333333333336,<,-2.0,33,30,>,3,54,56,<,-2,216,218,<,-2
58,18,12.0,20.0,<,-8.0,0,0,=,0,36,60,<,-24,47.333333333333336,45.333333333333336,>,2.0,30,33,<,-3,56,54,>,2,218,216,>,2
0,18,20.0,4.666666666666667,>,15.333333333333332,0,0,=,0,60,14,>,46,45.333333333333336,35.333333333333336,>,10.0,33,30,>,3,54,40,>,14,216,253,<,-37
28,18,4.666666666666667,20.0,<,-15.333333333333332,0,0,=,0,14,60,<,-46,35.333333333333336,45.333333333333336,<,-10.0,30,33,<,-3,40,54,<,-14,253,216,>,37
0,18,20.0,9.666666666666666,>,10.333333333333334,0,0,=,0,60,29,>,31,45.333333333333336,42.0,>,3.3333333333333357,33,33,=,0,54,56,<,-2,216,180,>,36
0,18,9.666666666666666,20.0,<,-10.333333333333334,0,0,=,0,29,60,<,-31,42.0,45.333333333333336,<,-3.3333333333333357,33,33,=,0,56,54,>,2,180,216,<,-36
0,18,20.0,8.0,>,12.0,0,0,=,0,60,24,>,36,45.333333333333336,41.666666666666664,>,3.6666666666666714,33,33,=,0,54,55,<,-1,216,206,>,10
73,18,8.0,20.0,<,-12.0,0,0,=,0,24,60,<,-36,41.666666666666664,45.333333333333336,<,-3.6666666666666714,33,33,=,0,55,54,>,1,206,216,<,-10
0,18,20.0,27.0,<,-7.0,0,0,=,0,60,81,<,-21,45.333333333333336,43.333333333333336,>,2.0,33,33,=,0,54,58,<,-4,216,130,>,86
139,18,27.0,20.0,>,7.0,0,0,=,0,81,60,>,21,43.333333333333336,45.333333333333336,<,-2.0,33,33,=,0,58,54,>,4,130,216,<,-86
0,18,20.0,23.333333333333332,<,-3.333333333333332,0,0,=,0,60,70,<,-10,45.333333333333336,48.0,<,-2.6666666666666643,33,43,<,-10,54,53,>,1,216,277,<,-61
156,18,23.333333333333332,20.0,>,3.333333333333332,0,0,=,0,70,60,>,10,48.0,45.333333333333336,>,2.6666666666666643,43,33,>,10,53,54,<,-1,277,216,>,61
0,18,20.0,29.333333333333332,<,-9.333333333333332,0,0,=,0,60,88,<,-28,45.333333333333336,51.666666666666664,<,-6.333333333333329,33,44,<,-11,54,56,<,-2,216,216,=,0
137,18,29.333333333333332,20.0,>,9.333333333333332,0,0,=,0,88,60,>,28,51.666666666666664,45.333333333333336,>,6.333333333333329,44,33,>,11,56,54,>,2,216,216,=,0
0,18,20.0,17.333333333333332,>,2.666666666666668,0,0,=,0,60,52,>,8,45.333333333333336,46.0,<,-0.6666666666666643,33,30,>,3,54,55,<,-1,216,319,<,-103
133,18,17.333333333333332,20.0,<,-2.666666666666668,0,0,=,0,52,60,<,-8,46.0,45.333333333333336,>,0.6666666666666643,30,33,<,-3,55,54,>,1,319,216,>,103
0,18,20.0,13.333333333333334,>,6.666666666666666,0,0,=,0,60,40,>,20,45.333333333333336,44.0,>,1.3333333333333357,33,30,>,3,54,56,<,-2,216,308,<,-92
132,18,13.333333333333334,20.0,<,-6.666666666666666,0,0,=,0,40,60,<,-20,44.0,45.333333333333336,<,-1.3333333333333357,30,33,<,-3,56,54,>,2,308,216,>,92
0,18,20.0,23.333333333333332,<,-3.333333333333332,0,0,=,0,60,70,<,-10,45.333333333333336,37.666666666666664,>,7.666666666666671,33,32,>,1,54,42,>,12,216,305,<,-89
195,18,23.333333333333332,20.0,>,3.333333333333332,0,0,=,0,70,60,>,10,37.666666666666664,45.333333333333336,<,-7.666666666666671,32,33,<,-1,42,54,<,-12,305,216,>,89
0,18,20.0,29.333333333333332,<,-9.333333333333332,0,0,=,0,60,88,<,-28,45.333333333333336,38.0,>,7.333333333333336,33,30,>,3,54,46,>,8,216,274,<,-58
252,18,29.333333333333332,20.0,>,9.333333333333332,0,0,=,0,88,60,>,28,38.0,45.333333333333336,<,-7.333333333333336,30,33,<,-3,46,54,<,-8,274,216,>,58
0,18,20.0,22.333333333333332,<,-2.333333333333332,0,0,=,0,60,67,<,-7,45.333333333333336,46.0,<,-0.6666666666666643,33,39,<,-6,54,56,<,-2,216,299,<,-83
157,18,22.333333333333332,20.0,>,2.333333333333332,0,0,=,0,67,60,>,7,46.0,45.333333333333336,>,0.6666666666666643,39,33,>,6,56,54,>,2,299,216,>,83
0,17,16.0,30.0,<,-14.0,0,0,=,0,29,71,<,-42,42.0,43.333333333333336,<,-1.3333333333333357,33,36,<,-3,56,53,>,3,180,108,>,72
0,17,30.0,16.0,>,14.0,0,0,=,0,71,29,>,42,43.333333333333336,42.0,>,1.3333333333333357,36,33,>,3,53,56,<,-3,108,180,<,-72
0,17,16.0,29.333333333333332,<,-13.333333333333332,0,0,=,0,29,74,<,-45,42.0,35.333333333333336,>,6.666666666666664,33,30,>,3,56,40,>,16,180,253,<,-73
75,17,29.333333333333332,16.0,>,13.333333333333332,0,0,=,0,74,29,>,45,35.333333333333336,42.0,<,-6.666666666666664,30,33,<,-3,40,56,<,-16,253,180,>,73
0,17,16.0,33.0,<,-17.0,0,0,=,0,29,72,<,-43,42.0,42.0,=,0.0,33,38,<,-5,56,49,>,7,180,118,>,62
0,17,33.0,16.0,>,17.0,0,0,=,0,72,29,>,43,42.0,42.0,=,0.0,38,33,>,5,49,56,<,-7,118,180,<,-62
0,17,16.0,27.666666666666668,<,-11.666666666666668,0,0,=,0,29,47,<,-18,42.0,47.333333333333336,<,-5.333333333333336,33,30,>,3,56,56,=,0,180,218,<,-38
126,17,27.666666666666668,16.0,>,11.666666666666668,0,0,=,0,47,29,>,18,47.333333333333336,42.0,>,5.333333333333336,30,33,<,-3,56,56,=,0,218,180,>,38
0,17,16.0,20.666666666666668,<,-4.666666666666668,0,0,=,0,29,38,<,-9,42.0,41.666666666666664,>,0.3333333333333357,33,33,=,0,56,55,>,1,180,206,<,-26
126,17,20.666666666666668,16.0,>,4.666666666666668,0,0,=,0,38,29,>,9,41.666666666666664,42.0,<,-0.3333333333333357,33,33,=,0,55,56,<,-1,206,180,>,26
0,17,16.0,47.333333333333336,<,-31.333333333333336,0,0,=,0,29,85,<,-56,42.0,45.666666666666664,<,-3.6666666666666643,33,34,<,-1,56,59,<,-3,180,205,<,-25
159,17,47.333333333333336,16.0,>,31.333333333333336,0,0,=,0,85,29,>,56,45.666666666666664,42.0,>,3.6666666666666643,34,33,>,1,59,56,>,3,205,180,>,25
0,17,16.0,51.0,<,-35.0,0,0,=,0,29,85,<,-56,42.0,46.666666666666664,<,-4.666666666666664,33,36,<,-3,56,55,>,1,180,213,<,-33
91,17,51.0,16.0,>,35.0,0,0,=,0,85,29,>,56,46.666666666666664,42.0,>,4.666666666666664,36,33,>,3,55,56,<,-1,213,180,>,33
0,17,16.0,17.333333333333332,<,-1.3333333333333321,0,0,=,0,29,41,<,-12,42.0,43.333333333333336,<,-1.3333333333333357,33,30,>,3,56,51,>,5,180,131,>,49
103,17,17.333333333333332,16.0,>,1.3333333333333321,0,0,=,0,41,29,>,12,43.333333333333336,42.0,>,1.3333333333333357,30,33,<,-3,51,56,<,-5,131,180,<,-49
0,17,16.0,34.666666666666664,<,-18.666666666666664,0,0,=,0,29,64,<,-35,42.0,44.0,<,-2.0,33,30,>,3,56,56,=,0,180,308,<,-128
187,17,34.666666666666664,16.0,>,18.666666666666664,0,0,=,0,64,29,>,35,44.0,42.0,>,2.0,30,33,<,-3,56,56,=,0,308,180,>,128
0,17,16.0,37.666666666666664,<,-21.666666666666664,0,0,=,0,29,61,<,-32,42.0,46.0,<,-4.0,33,30,>,3,56,55,>,1,180,319,<,-139
236,17,37.666666666666664,16.0,>,21.666666666666664,0,0,=,0,61,29,>,32,46.0,42.0,>,4.0,30,33,<,-3,55,56,<,-1,319,180,>,139
0,17,16.0,47.0,<,-31.0,0,0,=,0,29,88,<,-59,42.0,51.666666666666664,<,-9.666666666666664,33,44,<,-11,56,56,=,0,180,216,<,-36
158,17,47.0,16.0,>,31.0,0,0,=,0,88,29,>,59,51.666666666666664,42.0,>,9.666666666666664,44,33,>,11,56,56,=,0,216,180,>,36
0,17,16.0,34.0,<,-18.0,0,0,=,0,29,81,<,-52,42.0,43.333333333333336,<,-1.3333333333333357,33,33,=,0,56,58,<,-2,180,130,>,50
130,17,34.0,16.0,>,18.0,0,0,=,0,81,29,>,52,43.333333333333336,42.0,>,1.3333333333333357,33,33,=,0,58,56,>,2,130,180,<,-50
0,17,16.0,51.333333333333336,<,-35.333333333333336,0,0,=,0,29,84,<,-55,42.0,48.0,<,-6.0,33,43,<,-10,56,53,>,3,180,277,<,-97
245,17,51.333333333333336,16.0,>,35.333333333333336,0,0,=,0,84,29,>,55,48.0,42.0,>,6.0,43,33,>,10,53,56,<,-3,277,180,>,97
0,17,16.0,50.0,<,-34.0,0,0,=,0,29,83,<,-54,42.0,46.0,<,-4.0,33,39,<,-6,56,56,=,0,180,299,<,-119
265,17,50.0,16.0,>,34.0,0,0,=,0,83,29,>,54,46.0,42.0,>,4.0,39,33,>,6,56,56,=,0,299,180,>,119
0,17,16.0,44.666666666666664,<,-28.666666666666664,0,0,=,0,29,70,<,-41,42.0,37.666666666666664,>,4.333333333333336,33,32,>,1,56,42,>,14,180,305,<,-125
213,17,44.666666666666664,16.0,>,28.666666666666664,0,0,=,0,70,29,>,41,37.666666666666664,42.0,<,-4.333333333333336,32,33,<,-1,42,56,<,-14,305,180,>,125
0,17,16.0,55.666666666666664,<,-39.666666666666664,0,0,=,0,29,88,<,-59,42.0,38.0,>,4.0,33,30,>,3,56,46,>,10,180,274,<,-94
253,17,55.666666666666664,16.0,>,39.666666666666664,0,0,=,0,88,29,>,59,38.0,42.0,<,-4.0,30,33,<,-3,46,56,<,-10,274,180,>,94
0,16,18.333333333333332,36.333333333333336,<,-18.000000000000004,0,0,=,0,28,71,<,-43,42.0,43.333333333333336,<,-1.3333333333333357,38,36,>,2,49,53,<,-4,118,108,>,10
0,16,36.333333333333336,18.333333333333332,>,18.000000000000004,0,0,=,0,71,28,>,43,43.333333333333336,42.0,>,1.3333333333333357,36,38,<,-2,53,49,>,4,108,118,<,-10
0,16,18.333333333333332,37.666666666666664,<,-19.333333333333332,0,0,=,0,28,74,<,-46,42.0,35.333333333333336,>,6.666666666666664,38,30,>,8,49,40,>,9,118,253,<,-135
116,16,37.666666666666664,18.333333333333332,>,19.333333333333332,0,0,=,0,74,28,>,46,35.333333333333336,42.0,<,-6.666666666666664,30,38,<,-8,40,49,<,-9,253,118,>,135
0,16,18.333333333333332,46.666666666666664,<,-28.333333333333332,0,0,=,0,28,72,<,-44,42.0,46.666666666666664,<,-4.666666666666664,38,36,>,2,49,55,<,-6,118,213,<,-95
147,16,46.666666666666664,18.333333333333332,>,28.333333333333332,0,0,=,0,72,28,>,44,46.666666666666664,42.0,>,4.666666666666664,36,38,<,-2,55,49,>,6,213,118,>,95
0,16,18.333333333333332,15.333333333333334,>,2.9999999999999982,0,0,=,0,28,35,<,-7,42.0,43.333333333333336,<,-1.3333333333333357,38,30,>,8,49,51,<,-2,118,131,<,-13
107,16,15.333333333333334,18.333333333333332,<,-2.9999999999999982,0,0,=,0,35,28,>,7,43.333333333333336,42.0,>,1.3333333333333357,30,38,<,-8,51,49,>,2,131,118,>,13
0,16,18.333333333333332,45.0,<,-26.666666666666668,0,0,=,0,28,88,<,-60,42.0,47.333333333333336,<,-5.333333333333336,38,30,>,8,49,56,<,-7,118,218,<,-100
126,16,45.0,18.333333333333332,>,26.666666666666668,0,0,=,0,88,28,>,60,47.333333333333336,42.0,>,5.333333333333336,30,38,<,-8,56,49,>,7,218,118,>,100
0,16,18.333333333333332,32.333333333333336,<,-14.000000000000004,0,0,=,0,28,59,<,-31,42.0,41.666666666666664,>,0.3333333333333357,38,33,>,5,49,55,<,-6,118,206,<,-88
126,16,32.333333333333336,18.333333333333332,>,14.000000000000004,0,0,=,0,59,28,>,31,41.666666666666664,42.0,<,-0.3333333333333357,33,38,<,-5,55,49,>,6,206,118,>,88
0,16,18.333333333333332,26.333333333333332,<,-8.0,0,0,=,0,28,58,<,-30,42.0,43.333333333333336,<,-1.3333333333333357,38,33,>,5,49,58,<,-9,118,130,<,-12
130,16,26.333333333333332,18.333333333333332,>,8.0,0,0,=,0,58,28,>,30,43.333333333333336,42.0,>,1.3333333333333357,33,38,<,-5,58,49,>,9,130,118,>,12
0,16,18.333333333333332,28.333333333333332,<,-10.0,0,0,=,0,28,53,<,-25,42.0,51.666666666666664,<,-9.666666666666664,38,44,<,-6,49,56,<,-7,118,216,<,-98
175,16,28.333333333333332,18.333333333333332,>,10.0,0,0,=,0,53,28,>,25,51.666666666666664,42.0,>,9.666666666666664,44,38,>,6,56,49,>,7,216,118,>,98
0,16,18.333333333333332,27.0,<,-8.666666666666668,0,0,=,0,28,57,<,-29,42.0,45.666666666666664,<,-3.6666666666666643,38,34,>,4,49,59,<,-10,118,205,<,-87
0,16,27.0,18.333333333333332,>,8.666666666666668,0,0,=,0,57,28,>,29,45.666666666666664,42.0,>,3.6666666666666643,34,38,<,-4,59,49,>,10,205,118,>,87
0,16,18.333333333333332,38.666666666666664,<,-20.333333333333332,0,0,=,0,28,64,<,-36,42.0,44.0,<,-2.0,38,30,>,8,49,56,<,-7,118,308,<,-190
195,16,38.666666666666664,18.333333333333332,>,20.333333333333332,0,0,=,0,64,28,>,36,44.0,42.0,>,2.0,30,38,<,-8,56,49,>,7,308,118,>,190
0,16,18.333333333333332,39.666666666666664,<,-21.333333333333332,0,0,=,0,28,64,<,-36,42.0,37.666666666666664,>,4.333333333333336,38,32,>,6,49,42,>,7,118,305,<,-187
203,16,39.666666666666664,18.333333333333332,>,21.333333333333332,0,0,=,0,64,28,>,36,37.666666666666664,42.0,<,-4.333333333333336,32,38,<,-6,42,49,<,-7,305,118,>,187
0,16,18.333333333333332,31.333333333333332,<,-13.0,0,0,=,0,28,61,<,-33,42.0,46.0,<,-4.0,38,30,>,8,49,55,<,-6,118,319,<,-201
162,16,31.333333333333332,18.333333333333332,>,13.0,0,0,=,0,61,28,>,33,46.0,42.0,>,4.0,30,38,<,-8,55,49,>,6,319,118,>,201
0,16,18.333333333333332,44.666666666666664,<,-26.333333333333332,0,0,=,0,28,84,<,-56,42.0,48.0,<,-6.0,38,43,<,-5,49,53,<,-4,118,277,<,-159
212,16,44.666666666666664,18.333333333333332,>,26.333333333333332,0,0,=,0,84,28,>,56,48.0,42.0,>,6.0,43,38,>,5,53,49,>,4,277,118,>,159
0,16,18.333333333333332,33.333333333333336,<,-15.000000000000004,0,0,=,0,28,79,<,-51,42.0,38.0,>,4.0,38,30,>,8,49,46,>,3,118,274,<,-156
151,16,33.333333333333336,18.333333333333332,>,15.000000000000004,0,0,=,0,79,28,>,51,38.0,42.0,<,-4.0,30,38,<,-8,46,49,<,-3,274,118,>,156
0,16,18.333333333333332,31.666666666666668,<,-13.333333333333336,0,0,=,0,28,83,<,-55,42.0,46.0,<,-4.0,38,39,<,-1,49,56,<,-7,118,299,<,-181
116,16,31.666666666666668,18.333333333333332,>,13.333333333333336,0,0,=,0,83,28,>,55,46.0,42.0,>,4.0,39,38,>,1,56,49,>,7,299,118,>,181
0,15,29.0,32.333333333333336,<,-3.3333333333333357,0,0,=,0,49,73,<,-24,43.333333333333336,45.666666666666664,<,-2.3333333333333286,36,34,>,2,53,59,<,-6,108,205,<,-97
0,15,32.333333333333336,29.0,>,3.3333333333333357,0,0,=,0,73,49,>,24,45.666666666666664,43.333333333333336,>,2.3333333333333286,34,36,<,-2,59,53,>,6,205,108,>,97
0,15,29.0,23.0,>,6.0,0,0,=,0,49,35,>,14,43.333333333333336,43.333333333333336,=,0.0,36,30,>,6,53,51,>,2,108,131,<,-23
138,15,23.0,29.0,<,-6.0,0,0,=,0,35,49,<,-14,43.333333333333336,43.333333333333336,=,0.0,30,36,<,-6,51,53,<,-2,131,108,>,23
0,15,29.0,19.333333333333332,>,9.666666666666668,0,0,=,0,49,39,>,10,43.333333333333336,35.333333333333336,>,8.0,36,30,>,6,53,40,>,13,108,253,<,-145
72,15,19.333333333333332,29.0,<,-9.666666666666668,0,0,=,0,39,49,<,-10,35.333333333333336,43.333333333333336,<,-8.0,30,36,<,-6,40,53,<,-13,253,108,>,145
0,15,29.0,32.0,<,-3.0,0,0,=,0,49,84,<,-35,43.333333333333336,46.0,<,-2.6666666666666643,36,39,<,-3,53,56,<,-3,108,299,<,-191
116,15,32.0,29.0,>,3.0,0,0,=,0,84,49,>,35,46.0,43.333333333333336,>,2.6666666666666643,39,36,>,3,56,53,>,3,299,108,>,191
0,15,29.0,36.0,<,-7.0,0,0,=,0,49,88,<,-39,43.333333333333336,47.333333333333336,<,-4.0,36,30,>,6,53,56,<,-3,108,218,<,-110
0,15,36.0,29.0,>,7.0,0,0,=,0,88,49,>,39,47.333333333333336,43.333333333333336,>,4.0,30,36,<,-6,56,53,>,3,218,108,>,110
0,15,29.0,40.0,<,-11.0,0,0,=,0,49,61,<,-12,43.333333333333336,41.666666666666664,>,1.6666666666666714,36,33,>,3,53,55,<,-2,108,206,<,-98
187,15,40.0,29.0,>,11.0,0,0,=,0,61,49,>,12,41.666666666666664,43.333333333333336,<,-1.6666666666666714,33,36,<,-3,55,53,>,2,206,108,>,98
0,15,29.0,44.666666666666664,<,-15.666666666666664,0,0,=,0,49,76,<,-27,43.333333333333336,43.333333333333336,=,0.0,36,33,>,3,53,58,<,-5,108,130,<,-22
183,15,44.666666666666664,29.0,>,15.666666666666664,0,0,=,0,76,49,>,27,43.333333333333336,43.333333333333336,=,0.0,33,36,<,-3,58,53,>,5,130,108,>,22
0,15,29.0,28.666666666666668,>,0.33333333333333215,0,0,=,0,49,72,<,-23,43.333333333333336,46.666666666666664,<,-3.3333333333333286,36,36,=,0,53,55,<,-2,108,213,<,-105
58,15,28.666666666666668,29.0,<,-0.33333333333333215,0,0,=,0,72,49,>,23,46.666666666666664,43.333333333333336,>,3.3333333333333286,36,36,=,0,55,53,>,2,213,108,>,105
0,15,29.0,22.333333333333332,>,6.666666666666668,0,0,=,0,49,46,>,3,43.333333333333336,38.0,>,5.333333333333336,36,30,>,6,53,46,>,7,108,274,<,-166
151,15,22.333333333333332,29.0,<,-6.666666666666668,0,0,=,0,46,49,<,-3,38.0,43.333333333333336,<,-5.333333333333336,30,36,<,-6,46,53,<,-7,274,108,>,166
0,15,29.0,24.0,>,5.0,0,0,=,0,49,39,>,10,43.333333333333336,46.0,<,-2.6666666666666643,36,30,>,6,53,55,<,-2,108,319,<,-211
162,15,24.0,29.0,<,-5.0,0,0,=,0,39,49,<,-10,46.0,43.333333333333336,>,2.6666666666666643,30,36,<,-6,55,53,>,2,319,108,>,211
0,15,29.0,40.333333333333336,<,-11.333333333333336,0,0,=,0,49,89,<,-40,43.333333333333336,51.666666666666664,<,-8.333333333333329,36,44,<,-8,53,56,<,-3,108,216,<,-108
175,15,40.333333333333336,29.0,>,11.333333333333336,0,0,=,0,89,49,>,40,51.666666666666664,43.333333333333336,>,8.333333333333329,44,36,>,8,56,53,>,3,216,108,>,108
0,15,29.0,38.0,<,-9.0,0,0,=,0,49,62,<,-13,43.333333333333336,44.0,<,-0.6666666666666643,36,30,>,6,53,56,<,-3,108,308,<,-200
195,15,38.0,29.0,>,9.0,0,0,=,0,62,49,>,13,44.0,43.333333333333336,>,0.6666666666666643,30,36,<,-6,56,53,>,3,308,108,>,200
0,15,29.0,32.666666666666664,<,-3.6666666666666643,0,0,=,0,49,55,<,-6,43.333333333333336,37.666666666666664,>,5.666666666666671,36,32,>,4,53,42,>,11,108,305,<,-197
203,15,32.666666666666664,29.0,>,3.6666666666666643,0,0,=,0,55,49,>,6,37.666666666666664,43.333333333333336,<,-5.666666666666671,32,36,<,-4,42,53,<,-11,305,108,>,197
0,15,29.0,43.0,<,-14.0,0,0,=,0,49,79,<,-30,43.333333333333336,48.0,<,-4.666666666666664,36,43,<,-7,53,53,=,0,108,277,<,-169
212,15,43.0,29.0,>,14.0,0,0,=,0,79,49,>,30,48.0,43.333333333333336,>,4.666666666666664,43,36,>,7,53,53,=,0,277,108,>,169
0,14,59.666666666666664,62.333333333333336,<,-2.6666666666666714,20,24,<,-4,88,90,<,-2,47.333333333333336,45.666666666666664,>,1.6666666666666714,30,34,<,-4,56,59,<,-3,218,205,>,13
0,14,62.333333333333336,59.666666666666664,>,2.6666666666666714,24,20,>,4,90,88,>,2,45.666666666666664,47.333333333333336,<,-1.6666666666666714,34,30,>,4,59,56,>,3,205,218,<,-13
0,14,59.666666666666664,40.666666666666664,>,19.0,20,14,>,6,88,72,>,16,47.333333333333336,46.666666666666664,>,0.6666666666666714,30,36,<,-6,56,55,>,1,218,213,>,5
58,14,40.666666666666664,59.666666666666664,<,-19.0,14,20,<,-6,72,88,<,-16,46.666666666666664,47.333333333333336,<,-0.6666666666666714,36,30,>,6,55,56,<,-1,213,218,<,-5
0,14,59.666666666666664,27.333333333333332,>,32.33333333333333,20,19,>,1,88,39,>,49,47.333333333333336,35.333333333333336,>,12.0,30,30,=,0,56,40,>,16,218,253,<,-35
72,14,27.333333333333332,59.666666666666664,<,-32.33333333333333,19,20,<,-1,39,88,<,-49,35.333333333333336,47.333333333333336,<,-12.0,30,30,=,0,40,56,<,-16,253,218,>,35
0,14,59.666666666666664,60.0,<,-0.3333333333333357,20,12,>,8,88,84,>,4,47.333333333333336,46.0,>,1.3333333333333357,30,39,<,-9,56,56,=,0,218,299,<,-81
116,14,60.0,59.666666666666664,>,0.3333333333333357,12,20,<,-8,84,88,<,-4,46.0,47.333333333333336,<,-1.3333333333333357,39,30,>,9,56,56,=,0,299,218,>,81
0,14,59.666666666666664,26.666666666666668,>,33.0,20,11,>,9,88,35,>,53,47.333333333333336,43.333333333333336,>,4.0,30,30,=,0,56,51,>,5,218,131,>,87
0,14,26.666666666666668,59.666666666666664,<,-33.0,11,20,<,-9,35,88,<,-53,43.333333333333336,47.333333333333336,<,-4.0,30,30,=,0,51,56,<,-5,131,218,<,-87
0,14,59.666666666666664,39.0,>,20.666666666666664,20,21,<,-1,88,50,>,38,47.333333333333336,38.0,>,9.333333333333336,30,30,=,0,56,46,>,10,218,274,<,-56
151,14,39.0,59.666666666666664,<,-20.666666666666664,21,20,>,1,50,88,<,-38,38.0,47.333333333333336,<,-9.333333333333336,30,30,=,0,46,56,<,-10,274,218,>,56
0,14,59.666666666666664,47.666666666666664,>,12.0,20,33,<,-13,88,71,>,17,47.333333333333336,46.0,>,1.3333333333333357,30,30,=,0,56,55,>,1,218,319,<,-101
162,14,47.666666666666664,59.666666666666664,<,-12.0,33,20,>,13,71,88,<,-17,46.0,47.333333333333336,<,-1.3333333333333357,30,30,=,0,55,56,<,-1,319,218,>,101
0,14,59.666666666666664,55.0,>,4.666666666666664,20,32,<,-12,88,89,<,-1,47.333333333333336,51.666666666666664,<,-4.333333333333329,30,44,<,-14,56,56,=,0,218,216,>,2
181,14,55.0,59.666666666666664,<,-4.666666666666664,32,20,>,12,89,88,>,1,51.666666666666664,47.333333333333336,>,4.333333333333329,44,30,>,14,56,56,=,0,216,218,<,-2
0,14,59.666666666666664,67.33333333333333,<,-7.666666666666664,20,58,<,-38,88,76,>,12,47.333333333333336,43.333333333333336,>,4.0,30,33,<,-3,56,58,<,-2,218,130,>,88
341,14,67.33333333333333,59.666666666666664,>,7.666666666666664,58,20,>,38,76,88,<,-12,43.333333333333336,47.333333333333336,<,-4.0,33,30,>,3,58,56,>,2,130,218,<,-88
0,14,59.666666666666664,56.0,>,3.6666666666666643,20,48,<,-28,88,61,>,27,47.333333333333336,41.666666666666664,>,5.666666666666671,30,33,<,-3,56,55,>,1,218,206,>,12
187,14,56.0,59.666666666666664,<,-3.6666666666666643,48,20,>,28,61,88,<,-27,41.666666666666664,47.333333333333336,<,-5.666666666666671,33,30,>,3,55,56,<,-1,206,218,<,-12
0,14,59.666666666666664,46.666666666666664,>,13.0,20,26,<,-6,88,62,>,26,47.333333333333336,44.0,>,3.3333333333333357,30,30,=,0,56,56,=,0,218,308,<,-90
195,14,46.666666666666664,59.666666666666664,<,-13.0,26,20,>,6,62,88,<,-26,44.0,47.333333333333336,<,-3.3333333333333357,30,30,=,0,56,56,=,0,308,218,>,90
0,14,59.666666666666664,62.333333333333336,<,-2.6666666666666714,20,43,<,-23,88,89,<,-1,47.333333333333336,37.666666666666664,>,9.666666666666671,30,32,<,-2,56,42,>,14,218,305,<,-87
203,14,62.333333333333336,59.666666666666664,>,2.6666666666666714,43,20,>,23,89,88,>,1,37.666666666666664,47.333333333333336,<,-9.666666666666671,32,30,>,2,42,56,<,-14,305,218,>,87
0,14,59.666666666666664,47.333333333333336,>,12.333333333333329,20,13,>,7,88,79,>,9,47.333333333333336,48.0,<,-0.6666666666666643,30,43,<,-13,56,53,>,3,218,277,<,-59
182,14,47.333333333333336,59.666666666666664,<,-12.333333333333329,13,20,<,-7,79,88,<,-9,48.0,47.333333333333336,>,0.6666666666666643,43,30,>,13,53,56,<,-3,277,218,>,59
0,13,27.0,60.333333333333336,<,-33.333333333333336,11,24,<,-13,35,90,<,-55,43.333333333333336,45.666666666666664,<,-2.3333333333333286,30,34,<,-4,51,59,<,-8,131,205,<,-74
0,13,60.333333333333336,27.0,>,33.333333333333336,24,11,>,13,90,35,>,55,45.666666666666664,43.333333333333336,>,2.3333333333333286,34,30,>,4,59,51,>,8,205,131,>,74
0,13,27.0,49.333333333333336,<,-22.333333333333336,11,36,<,-25,35,72,<,-37,43.333333333333336,46.666666666666664,<,-3.3333333333333286,30,36,<,-6,51,55,<,-4,131,213,<,-82
158,13,49.333333333333336,27.0,>,22.333333333333336,36,11,>,25,72,35,>,37,46.666666666666664,43.333333333333336,>,3.3333333333333286,36,30,>,6,55,51,>,4,213,131,>,82
0,13,27.0,48.0,<,-21.0,11,24,<,-13,35,81,<,-46,43.333333333333336,35.333333333333336,>,8.0,30,30,=,0,51,40,>,11,131,253,<,-122
159,13,48.0,27.0,>,21.0,24,11,>,13,81,35,>,46,35.333333333333336,43.333333333333336,<,-8.0,30,30,=,0,40,51,<,-11,253,131,>,122
0,13,27.0,52.0,<,-25.0,11,12,<,-1,35,84,<,-49,43.333333333333336,46.0,<,-2.6666666666666643,30,39,<,-9,51,56,<,-5,131,299,<,-168
116,13,52.0,27.0,>,25.0,12,11,>,1,84,35,>,49,46.0,43.333333333333336,>,2.6666666666666643,39,30,>,9,56,51,>,5,299,131,>,168
0,13,27.0,40.0,<,-13.0,11,21,<,-10,35,50,<,-15,43.333333333333336,38.0,>,5.333333333333336,30,30,=,0,51,46,>,5,131,274,<,-143
151,13,40.0,27.0,>,13.0,21,11,>,10,50,35,>,15,38.0,43.333333333333336,<,-5.333333333333336,30,30,=,0,46,51,<,-5,274,131,>,143
0,13,27.0,62.333333333333336,<,-35.333333333333336,11,33,<,-22,35,83,<,-48,43.333333333333336,46.0,<,-2.6666666666666643,30,30,=,0,51,55,<,-4,131,319,<,-188
162,13,62.333333333333336,27.0,>,35.333333333333336,33,11,>,22,83,35,>,48,46.0,43.333333333333336,>,2.6666666666666643,30,30,=,0,55,51,>,4,319,131,>,188
0,13,27.0,42.666666666666664,<,-15.666666666666664,11,32,<,-21,35,52,<,-17,43.333333333333336,51.666666666666664,<,-8.333333333333329,30,44,<,-14,51,56,<,-5,131,216,<,-85
181,13,42.666666666666664,27.0,>,15.666666666666664,32,11,>,21,52,35,>,17,51.666666666666664,43.333333333333336,>,8.333333333333329,44,30,>,14,56,51,>,5,216,131,>,85
0,13,27.0,31.0,<,-4.0,11,13,<,-2,35,50,<,-15,43.333333333333336,48.0,<,-4.666666666666664,30,43,<,-13,51,53,<,-2,131,277,<,-146
182,13,31.0,27.0,>,4.0,13,11,>,2,50,35,>,15,48.0,43.333333333333336,>,4.666666666666664,43,30,>,13,53,51,>,2,277,131,>,146
0,13,27.0,40.0,<,-13.0,11,13,<,-2,35,59,<,-24,43.333333333333336,41.666666666666664,>,1.6666666666666714,30,33,<,-3,51,55,<,-4,131,206,<,-75
0,13,40.0,27.0,>,13.0,13,11,>,2,59,35,>,24,41.666666666666664,43.333333333333336,<,-1.6666666666666714,33,30,>,3,55,51,>,4,206,131,>,75
0,13,27.0,31.333333333333332,<,-4.333333333333332,11,16,<,-5,35,52,<,-17,43.333333333333336,44.0,<,-0.6666666666666643,30,30,=,0,51,56,<,-5,131,308,<,-177
64,13,31.333333333333332,27.0,>,4.333333333333332,16,11,>,5,52,35,>,17,44.0,43.333333333333336,>,0.6666666666666643,30,30,=,0,56,51,>,5,308,131,>,177
0,13,27.0,77.66666666666667,<,-50.66666666666667,11,55,<,-44,35,89,<,-54,43.333333333333336,37.666666666666664,>,5.666666666666671,30,32,<,-2,51,42,>,9,131,305,<,-174
203,13,77.66666666666667,27.0,>,50.66666666666667,55,11,>,44,89,35,>,54,37.666666666666664,43.333333333333336,<,-5.666666666666671,32,30,>,2,42,51,<,-9,305,131,>,174
0,13,27.0,58.666666666666664,<,-31.666666666666664,11,50,<,-39,35,68,<,-33,43.333333333333336,43.333333333333336,=,0.0,30,33,<,-3,51,58,<,-7,131,130,>,1
341,13,58.666666666666664,27.0,>,31.666666666666664,50,11,>,39,68,35,>,33,43.333333333333336,43.333333333333336,=,0.0,33,30,>,3,58,51,>,7,130,131,<,-1
0,12,42.0,46.333333333333336,<,-4.333333333333336,13,24,<,-11,59,67,<,-8,41.666666666666664,45.666666666666664,<,-4.0,33,34,<,-1,55,59,<,-4,206,205,>,1
0,12,46.333333333333336,42.0,>,4.333333333333336,24,13,>,11,67,59,>,8,45.666666666666664,41.666666666666664,>,4.0,34,33,>,1,59,55,>,4,205,206,<,-1
0,12,42.0,32.666666666666664,>,9.333333333333336,13,16,<,-3,59,52,>,7,41.666666666666664,44.0,<,-2.3333333333333357,33,30,>,3,55,56,<,-1,206,308,<,-102
64,12,32.666666666666664,42.0,<,-9.333333333333336,16,13,>,3,52,59,<,-7,44.0,41.666666666666664,>,2.3333333333333357,30,33,<,-3,56,55,>,1,308,206,>,102
0,12,42.0,42.333333333333336,<,-0.3333333333333357,13,12,>,1,59,60,<,-1,41.666666666666664,46.0,<,-4.333333333333336,33,39,<,-6,55,56,<,-1,206,299,<,-93
116,12,42.333333333333336,42.0,>,0.3333333333333357,12,13,<,-1,60,59,>,1,46.0,41.666666666666664,>,4.333333333333336,39,33,>,6,56,55,>,1,299,206,>,93
0,12,42.0,37.666666666666664,>,4.333333333333336,13,21,<,-8,59,49,>,10,41.666666666666664,38.0,>,3.6666666666666643,33,30,>,3,55,46,>,9,206,274,<,-68
151,12,37.666666666666664,42.0,<,-4.333333333333336,21,13,>,8,49,59,<,-10,38.0,41.666666666666664,<,-3.6666666666666643,30,33,<,-3,46,55,<,-9,274,206,>,68
0,12,42.0,46.0,<,-4.0,13,26,<,-13,59,72,<,-13,41.666666666666664,46.666666666666664,<,-5.0,33,36,<,-3,55,55,=,0,206,213,<,-7
158,12,46.0,42.0,>,4.0,26,13,>,13,72,59,>,13,46.666666666666664,41.666666666666664,>,5.0,36,33,>,3,55,55,=,0,213,206,>,7
0,12,42.0,63.333333333333336,<,-21.333333333333336,13,39,<,-26,59,81,<,-22,41.666666666666664,35.333333333333336,>,6.333333333333329,33,30,>,3,55,40,>,15,206,253,<,-47
159,12,63.333333333333336,42.0,>,21.333333333333336,39,13,>,26,81,59,>,22,35.333333333333336,41.666666666666664,<,-6.333333333333329,30,33,<,-3,40,55,<,-15,253,206,>,47
0,12,42.0,47.666666666666664,<,-5.666666666666664,13,27,<,-14,59,83,<,-24,41.666666666666664,46.0,<,-4.333333333333336,33,30,>,3,55,55,=,0,206,319,<,-113
162,12,47.666666666666664,42.0,>,5.666666666666664,27,13,>,14,83,59,>,24,46.0,41.666666666666664,>,4.333333333333336,30,33,<,-3,55,55,=,0,319,206,>,113
0,12,42.0,40.666666666666664,>,1.3333333333333357,13,32,<,-19,59,52,>,7,41.666666666666664,51.666666666666664,<,-10.0,33,44,<,-11,55,56,<,-1,206,216,<,-10
181,12,40.666666666666664,42.0,<,-1.3333333333333357,32,13,>,19,52,59,<,-7,51.666666666666664,41.666666666666664,>,10.0,44,33,>,11,56,55,>,1,216,206,>,10
0,12,42.0,31.666666666666668,>,10.333333333333332,13,15,<,-2,59,50,>,9,41.666666666666664,48.0,<,-6.333333333333336,33,43,<,-10,55,53,>,2,206,277,<,-71
192,12,31.666666666666668,42.0,<,-10.333333333333332,15,13,>,2,50,59,<,-9,48.0,41.666666666666664,>,6.333333333333336,43,33,>,10,53,55,<,-2,277,206,>,71
0,12,42.0,57.333333333333336,<,-15.333333333333336,13,28,<,-15,59,89,<,-30,41.666666666666664,37.666666666666664,>,4.0,33,32,>,1,55,42,>,13,206,305,<,-99
203,12,57.333333333333336,42.0,>,15.333333333333336,28,13,>,15,89,59,>,30,37.666666666666664,41.666666666666664,<,-4.0,32,33,<,-1,42,55,<,-13,305,206,>,99
0,12,42.0,40.0,>,2.0,13,12,>,1,59,58,>,1,41.666666666666664,43.333333333333336,<,-1.6666666666666714,33,33,=,0,55,58,<,-3,206,130,>,76
0,12,40.0,42.0,<,-2.0,12,13,<,-1,58,59,<,-1,43.333333333333336,41.666666666666664,>,1.6666666666666714,33,33,=,0,58,55,>,3,130,206,<,-76
0,11,47.333333333333336,44.0,>,3.3333333333333357,12,24,<,-12,72,60,>,12,43.333333333333336,45.666666666666664,<,-2.3333333333333286,33,34,<,-1,58,59,<,-1,130,205,<,-75
0,11,44.0,47.333333333333336,<,-3.3333333333333357,24,12,>,12,60,72,<,-12,45.666666666666664,43.333333333333336,>,2.3333333333333286,34,33,>,1,59,58,>,1,205,130,>,75
0,11,47.333333333333336,41.0,>,6.333333333333336,12,30,<,-18,72,52,>,20,43.333333333333336,44.0,<,-0.6666666666666643,33,30,>,3,58,56,>,2,130,308,<,-178
96,11,41.0,47.333333333333336,<,-6.333333333333336,30,12,>,18,52,72,<,-20,44.0,43.333333333333336,>,0.6666666666666643,30,33,<,-3,56,58,<,-2,308,130,>,178
0,11,47.333333333333336,49.0,<,-1.6666666666666643,12,12,=,0,72,80,<,-8,43.333333333333336,46.0,<,-2.6666666666666643,33,39,<,-6,58,56,>,2,130,299,<,-169
116,11,49.0,47.333333333333336,>,1.6666666666666643,12,12,=,0,80,72,>,8,46.0,43.333333333333336,>,2.6666666666666643,39,33,>,6,56,58,<,-2,299,130,>,169
0,11,47.333333333333336,29.0,>,18.333333333333336,12,21,<,-9,72,43,>,29,43.333333333333336,38.0,>,5.333333333333336,33,30,>,3,58,46,>,12,130,274,<,-144
79,11,29.0,47.333333333333336,<,-18.333333333333336,21,12,>,9,43,72,<,-29,38.0,43.333333333333336,<,-5.333333333333336,30,33,<,-3,46,58,<,-12,274,130,>,144
0,11,47.333333333333336,42.0,>,5.333333333333336,12,26,<,-14,72,72,=,0,43.333333333333336,46.666666666666664,<,-3.3333333333333286,33,36,<,-3,58,55,>,3,130,213,<,-83
105,11,42.0,47.333333333333336,<,-5.333333333333336,26,12,>,14,72,72,=,0,46.666666666666664,43.333333333333336,>,3.3333333333333286,36,33,>,3,55,58,<,-3,213,130,>,83
0,11,47.333333333333336,44.333333333333336,>,3.0,12,24,<,-12,72,70,>,2,43.333333333333336,35.333333333333336,>,8.0,33,30,>,3,58,40,>,18,130,253,<,-123
0,11,44.333333333333336,47.333333333333336,<,-3.0,24,12,>,12,70,72,<,-2,35.333333333333336,43.333333333333336,<,-8.0,30,33,<,-3,40,58,<,-18,253,130,>,123
0,11,47.333333333333336,28.666666666666668,>,18.666666666666668,12,26,<,-14,72,33,>,39,43.333333333333336,46.0,<,-2.6666666666666643,33,30,>,3,58,55,>,3,130,319,<,-189
63,11,28.666666666666668,47.333333333333336,<,-18.666666666666668,26,12,>,14,33,72,<,-39,46.0,43.333333333333336,>,2.6666666666666643,30,33,<,-3,55,58,<,-3,319,130,>,189
0,11,47.333333333333336,49.333333333333336,<,-2.0,12,32,<,-20,72,78,<,-6,43.333333333333336,51.666666666666664,<,-8.333333333333329,33,44,<,-11,58,56,>,2,130,216,<,-86
181,11,49.333333333333336,47.333333333333336,>,2.0,32,12,>,20,78,72,>,6,51.666666666666664,43.333333333333336,>,8.333333333333329,44,33,>,11,56,58,<,-2,216,130,>,86
0,11,47.333333333333336,46.0,>,1.3333333333333357,12,15,<,-3,72,73,<,-1,43.333333333333336,48.0,<,-4.666666666666664,33,43,<,-10,58,53,>,5,130,277,<,-147
192,11,46.0,47.333333333333336,<,-1.3333333333333357,15,12,>,3,73,72,>,1,48.0,43.333333333333336,>,4.666666666666664,43,33,>,10,53,58,<,-5,277,130,>,147
0,11,47.333333333333336,55.0,<,-7.666666666666664,12,28,<,-16,72,82,<,-10,43.333333333333336,37.666666666666664,>,5.666666666666671,33,32,>,1,58,42,>,16,130,305,<,-175
203,11,55.0,47.333333333333336,>,7.666666666666664,28,12,>,16,82,72,>,10,37.666666666666664,43.333333333333336,<,-5.666666666666671,32,33,<,-1,42,58,<,-16,305,130,>,175
0,10,47.666666666666664,46.666666666666664,>,1.0,24,24,=,0,80,60,>,20,35.333333333333336,45.666666666666664,<,-10.333333333333329,30,34,<,-4,40,59,<,-19,253,205,>,48
0,10,46.666666666666664,47.666666666666664,<,-1.0,24,24,=,0,60,80,<,-20,45.666666666666664,35.333333333333336,>,10.333333333333329,34,30,>,4,59,40,>,19,205,253,<,-48
0,10,47.666666666666664,38.666666666666664,>,9.0,24,26,<,-2,80,57,>,23,35.333333333333336,46.0,<,-10.666666666666664,30,30,=,0,40,55,<,-15,253,319,<,-66
63,10,38.666666666666664,47.666666666666664,<,-9.0,26,24,>,2,57,80,<,-23,46.0,35.333333333333336,>,10.666666666666664,30,30,=,0,55,40,>,15,319,253,>,66
0,10,47.666666666666664,42.0,>,5.666666666666664,24,21,>,3,80,82,<,-2,35.333333333333336,38.0,<,-2.6666666666666643,30,30,=,0,40,46,<,-6,253,274,<,-21
79,10,42.0,47.666666666666664,<,-5.666666666666664,21,24,<,-3,82,80,>,2,38.0,35.333333333333336,>,2.6666666666666643,30,30,=,0,46,40,>,6,274,253,>,21
0,10,47.666666666666664,58.0,<,-10.333333333333336,24,41,<,-17,80,81,<,-1,35.333333333333336,44.0,<,-8.666666666666664,30,30,=,0,40,56,<,-16,253,308,<,-55
96,10,58.0,47.666666666666664,>,10.333333333333336,41,24,>,17,81,80,>,1,44.0,35.333333333333336,>,8.666666666666664,30,30,=,0,56,40,>,16,308,253,>,55
0,10,47.666666666666664,41.666666666666664,>,6.0,24,25,<,-1,80,72,>,8,35.333333333333336,46.666666666666664,<,-11.333333333333329,30,36,<,-6,40,55,<,-15,253,213,>,40
84,10,41.666666666666664,47.666666666666664,<,-6.0,25,24,>,1,72,80,<,-8,46.666666666666664,35.333333333333336,>,11.333333333333329,36,30,>,6,55,40,>,15,213,253,<,-40
0,10,47.666666666666664,59.333333333333336,<,-11.666666666666671,24,12,>,12,80,86,<,-6,35.333333333333336,46.0,<,-10.666666666666664,30,39,<,-9,40,56,<,-16,253,299,<,-46
116,10,59.333333333333336,47.666666666666664,>,11.666666666666671,12,24,<,-12,86,80,>,6,46.0,35.333333333333336,>,10.666666666666664,39,30,>,9,56,40,>,16,299,253,>,46
0,10,47.666666666666664,40.666666666666664,>,7.0,24,12,>,12,80,78,>,2,35.333333333333336,51.666666666666664,<,-16.33333333333333,30,44,<,-14,40,56,<,-16,253,216,>,37
0,10,40.666666666666664,47.666666666666664,<,-7.0,12,24,<,-12,78,80,<,-2,51.666666666666664,35.333333333333336,>,16.33333333333333,44,30,>,14,56,40,>,16,216,253,<,-37
0,10,47.666666666666664,45.333333333333336,>,2.3333333333333286,24,13,>,11,80,73,>,7,35.333333333333336,48.0,<,-12.666666666666664,30,43,<,-13,40,53,<,-13,253,277,<,-24
100,10,45.333333333333336,47.666666666666664,<,-2.3333333333333286,13,24,<,-11,73,80,<,-7,48.0,35.333333333333336,>,12.666666666666664,43,30,>,13,53,40,>,13,277,253,>,24
0,10,47.666666666666664,58.0,<,-10.333333333333336,24,37,<,-13,80,82,<,-2,35.333333333333336,37.666666666666664,<,-2.3333333333333286,30,32,<,-2,40,42,<,-2,253,305,<,-52
190,10,58.0,47.666666666666664,>,10.333333333333336,37,24,>,13,82,80,>,2,37.666666666666664,35.333333333333336,>,2.3333333333333286,32,30,>,2,42,40,>,2,305,253,>,52
0,9,33.0,32.0,>,1.0,19,12,>,7,56,52,>,4,45.666666666666664,51.666666666666664,<,-6.0,34,44,<,-10,59,56,>,3,205,216,<,-11
0,9,32.0,33.0,<,-1.0,12,19,<,-7,52,56,<,-4,51.666666666666664,45.666666666666664,>,6.0,44,34,>,10,56,59,<,-3,216,205,>,11
0,9,33.0,35.0,<,-2.0,19,15,>,4,56,57,<,-1,45.666666666666664,46.0,<,-0.3333333333333357,34,30,>,4,59,55,>,4,205,319,<,-114
0,9,35.0,33.0,>,2.0,15,19,<,-4,57,56,>,1,46.0,45.666666666666664,>,0.3333333333333357,30,34,<,-4,55,59,<,-4,319,205,>,114
0,9,33.0,53.0,<,-20.0,19,21,<,-2,56,82,<,-26,45.666666666666664,38.0,>,7.666666666666664,34,30,>,4,59,46,>,13,205,274,<,-69
133,9,53.0,33.0,>,20.0,21,19,>,2,82,56,>,26,38.0,45.666666666666664,<,-7.666666666666664,30,34,<,-4,46,59,<,-13,274,205,>,69
0,9,33.0,35.666666666666664,<,-2.6666666666666643,19,10,>,9,56,72,<,-16,45.666666666666664,46.666666666666664,<,-1.0,34,36,<,-2,59,55,>,4,205,213,<,-8
52,9,35.666666666666664,33.0,>,2.6666666666666643,10,19,<,-9,72,56,>,16,46.666666666666664,45.666666666666664,>,1.0,36,34,>,2,55,59,<,-4,213,205,>,8
0,9,33.0,62.0,<,-29.0,19,52,<,-33,56,81,<,-25,45.666666666666664,44.0,>,1.6666666666666643,34,30,>,4,59,56,>,3,205,308,<,-103
103,9,62.0,33.0,>,29.0,52,19,>,33,81,56,>,25,44.0,45.666666666666664,<,-1.6666666666666643,30,34,<,-4,56,59,<,-3,308,205,>,103
0,9,33.0,49.666666666666664,<,-16.666666666666664,19,13,>,6,56,86,<,-30,45.666666666666664,48.0,<,-2.3333333333333357,34,43,<,-9,59,53,>,6,205,277,<,-72
100,9,49.666666666666664,33.0,>,16.666666666666664,13,19,<,-6,86,56,>,30,48.0,45.666666666666664,>,2.3333333333333357,43,34,>,9,53,59,<,-6,277,205,>,72
0,9,33.0,41.666666666666664,<,-8.666666666666664,19,12,>,7,56,86,<,-30,45.666666666666664,46.0,<,-0.3333333333333357,34,39,<,-5,59,56,>,3,205,299,<,-94
116,9,41.666666666666664,33.0,>,8.666666666666664,12,19,<,-7,86,56,>,30,46.0,45.666666666666664,>,0.3333333333333357,39,34,>,5,56,59,<,-3,299,205,>,94
0,9,33.0,36.0,<,-3.0,19,16,>,3,56,55,>,1,45.666666666666664,37.666666666666664,>,8.0,34,32,>,2,59,42,>,17,205,305,<,-100
58,9,36.0,33.0,>,3.0,16,19,<,-3,55,56,<,-1,37.666666666666664,45.666666666666664,<,-8.0,32,34,<,-2,42,59,<,-17,305,205,>,100
0,8,41.666666666666664,34.0,>,7.666666666666664,15,12,>,3,57,52,>,5,46.0,51.666666666666664,<,-5.666666666666664,30,44,<,-14,55,56,<,-1,319,216,>,103
0,8,34.0,41.666666666666664,<,-7.666666666666664,12,15,<,-3,52,57,<,-5,51.666666666666664,46.0,>,5.666666666666664,44,30,>,14,56,55,>,1,216,319,<,-103
0,8,41.666666666666664,34.333333333333336,>,7.333333333333329,15,10,>,5,57,68,<,-11,46.0,46.666666666666664,<,-0.6666666666666643,30,36,<,-6,55,55,=,0,319,213,>,106
52,8,34.333333333333336,41.666666666666664,<,-7.333333333333329,10,15,<,-5,68,57,>,11,46.666666666666664,46.0,>,0.6666666666666643,36,30,>,6,55,55,=,0,213,319,<,-106
0,8,41.666666666666664,32.0,>,9.666666666666664,15,16,<,-1,57,43,>,14,46.0,37.666666666666664,>,8.333333333333336,30,32,<,-2,55,42,>,13,319,305,>,14
58,8,32.0,41.666666666666664,<,-9.666666666666664,16,15,>,1,43,57,<,-14,37.666666666666664,46.0,<,-8.333333333333336,32,30,>,2,42,55,<,-13,305,319,<,-14
0,8,41.666666666666664,57.0,<,-15.333333333333336,15,13,>,2,57,86,<,-29,46.0,48.0,<,-2.0,30,43,<,-13,55,53,>,2,319,277,>,42
100,8,57.0,41.666666666666664,>,15.333333333333336,13,15,<,-2,86,57,>,29,48.0,46.0,>,2.0,43,30,>,13,53,55,<,-2,277,319,<,-42
0,8,41.666666666666664,57.333333333333336,<,-15.666666666666671,15,38,<,-23,57,81,<,-24,46.0,44.0,>,2.0,30,30,=,0,55,56,<,-1,319,308,>,11
103,8,57.333333333333336,41.666666666666664,>,15.666666666666671,38,15,>,23,81,57,>,24,44.0,46.0,<,-2.0,30,30,=,0,56,55,>,1,308,319,<,-11
0,8,41.666666666666664,42.0,<,-0.3333333333333357,15,13,>,2,57,86,<,-29,46.0,46.0,=,0.0,30,39,<,-9,55,56,<,-1,319,299,>,20
0,8,42.0,41.666666666666664,>,0.3333333333333357,13,15,<,-2,86,57,>,29,46.0,46.0,=,0.0,39,30,>,9,56,55,>,1,299,319,<,-20
0,8,41.666666666666664,62.0,<,-20.333333333333336,15,48,<,-33,57,82,<,-25,46.0,38.0,>,8.0,30,30,=,0,55,46,>,9,319,274,>,45
133,8,62.0,41.666666666666664,>,20.333333333333336,48,15,>,33,82,57,>,25,38.0,46.0,<,-8.0,30,30,=,0,46,55,<,-9,274,319,<,-45
0,7,48.0,31.0,>,17.0,13,12,>,1,86,43,>,43,46.0,51.666666666666664,<,-5.666666666666664,39,44,<,-5,56,56,=,0,299,216,>,83
0,7,31.0,48.0,<,-17.0,12,13,<,-1,43,86,<,-43,51.666666666666664,46.0,>,5.666666666666664,44,39,>,5,56,56,=,0,216,299,<,-83
0,7,48.0,60.666666666666664,<,-12.666666666666664,13,25,<,-12,86,89,<,-3,46.0,46.666666666666664,<,-0.6666666666666643,39,36,>,3,56,55,>,1,299,213,>,86
84,7,60.666666666666664,48.0,>,12.666666666666664,25,13,>,12,89,86,>,3,46.666666666666664,46.0,>,0.6666666666666643,36,39,<,-3,55,56,<,-1,213,299,<,-86
0,7,48.0,42.666666666666664,>,5.333333333333336,13,37,<,-24,86,48,>,38,46.0,37.666666666666664,>,8.333333333333336,39,32,>,7,56,42,>,14,299,305,<,-6
69,7,42.666666666666664,48.0,<,-5.333333333333336,37,13,>,24,48,86,<,-38,37.666666666666664,46.0,<,-8.333333333333336,32,39,<,-7,42,56,<,-14,305,299,>,6
0,7,48.0,51.666666666666664,<,-3.6666666666666643,13,13,=,0,86,72,>,14,46.0,48.0,<,-2.0,39,43,<,-4,56,53,>,3,299,277,>,22
100,7,51.666666666666664,48.0,>,3.6666666666666643,13,13,=,0,72,86,<,-14,48.0,46.0,>,2.0,43,39,>,4,53,56,<,-3,277,299,<,-22
0,7,48.0,50.666666666666664,<,-2.6666666666666643,13,33,<,-20,86,81,>,5,46.0,44.0,>,2.0,39,30,>,9,56,56,=,0,299,308,<,-9
0,7,50.666666666666664,48.0,>,2.6666666666666643,33,13,>,20,81,86,<,-5,44.0,46.0,<,-2.0,30,39,<,-9,56,56,=,0,308,299,>,9
0,7,48.0,53.0,<,-5.0,13,29,<,-16,86,82,>,4,46.0,38.0,>,8.0,39,30,>,9,56,46,>,10,299,274,>,25
70,7,53.0,48.0,>,5.0,29,13,>,16,82,86,<,-4,38.0,46.0,<,-8.0,30,39,<,-9,46,56,<,-10,274,299,<,-25
0,6,57.0,42.0,>,15.0,33,12,>,21,81,71,>,10,44.0,51.666666666666664,<,-7.666666666666664,30,44,<,-14,56,56,=,0,308,216,>,92
0,6,42.0,57.0,<,-15.0,12,33,<,-21,71,81,<,-10,51.666666666666664,44.0,>,7.666666666666664,44,30,>,14,56,56,=,0,216,308,<,-92
0,6,57.0,53.333333333333336,>,3.6666666666666643,33,37,<,-4,81,75,>,6,44.0,37.666666666666664,>,6.333333333333336,30,32,<,-2,56,42,>,14,308,305,>,3
69,6,53.333333333333336,57.0,<,-3.6666666666666643,37,33,>,4,75,81,<,-6,37.666666666666664,44.0,<,-6.333333333333336,32,30,>,2,42,56,<,-14,305,308,<,-3
0,6,57.0,43.0,>,14.0,33,18,>,15,81,82,<,-1,44.0,38.0,>,6.0,30,30,=,0,56,46,>,10,308,274,>,34
66,6,43.0,57.0,<,-14.0,18,33,<,-15,82,81,>,1,38.0,44.0,<,-6.0,30,30,=,0,46,56,<,-10,274,308,<,-34
0,6,57.0,42.333333333333336,>,14.666666666666664,33,13,>,20,81,89,<,-8,44.0,46.666666666666664,<,-2.6666666666666643,30,36,<,-6,56,55,>,1,308,213,>,95
0,6,42.333333333333336,57.0,<,-14.666666666666664,13,33,<,-20,89,81,>,8,46.666666666666664,44.0,>,2.6666666666666643,36,30,>,6,55,56,<,-1,213,308,<,-95
0,6,57.0,48.0,>,9.0,33,13,>,20,81,70,>,11,44.0,48.0,<,-4.0,30,43,<,-13,56,53,>,3,308,277,>,31
54,6,48.0,57.0,<,-9.0,13,33,<,-20,70,81,<,-11,48.0,44.0,>,4.0,43,30,>,13,53,56,<,-3,277,308,<,-31
0,5,30.0,48.0,<,-18.0,13,12,>,1,52,71,<,-19,46.666666666666664,51.666666666666664,<,-5.0,36,44,<,-8,55,56,<,-1,213,216,<,-3
0,5,48.0,30.0,>,18.0,12,13,<,-1,71,52,>,19,51.666666666666664,46.666666666666664,>,5.0,44,36,>,8,56,55,>,1,216,213,>,3
0,5,30.0,33.333333333333336,<,-3.3333333333333357,13,13,=,0,52,61,<,-9,46.666666666666664,48.0,<,-1.3333333333333357,36,43,<,-7,55,53,>,2,213,277,<,-64
54,5,33.333333333333336,30.0,>,3.3333333333333357,13,13,=,0,61,52,>,9,48.0,46.666666666666664,>,1.3333333333333357,43,36,>,7,53,55,<,-2,277,213,>,64
0,5,30.0,40.333333333333336,<,-10.333333333333336,13,18,<,-5,52,82,<,-30,46.666666666666664,38.0,>,8.666666666666664,36,30,>,6,55,46,>,9,213,274,<,-61
66,5,40.333333333333336,30.0,>,10.333333333333336,18,13,>,5,82,52,>,30,38.0,46.666666666666664,<,-8.666666666666664,30,36,<,-6,46,55,<,-9,274,213,>,61
0,5,30.0,44.0,<,-14.0,13,20,<,-7,52,75,<,-23,46.666666666666664,37.666666666666664,>,9.0,36,32,>,4,55,42,>,13,213,305,<,-92
74,5,44.0,30.0,>,14.0,20,13,>,7,75,52,>,23,37.666666666666664,46.666666666666664,<,-9.0,32,36,<,-4,42,55,<,-13,305,213,>,92
0,4,40.0,21.666666666666668,>,18.333333333333332,12,13,<,-1,61,26,>,35,51.666666666666664,48.0,>,3.6666666666666643,44,43,>,1,56,53,>,3,216,277,<,-61
97,4,21.666666666666668,40.0,<,-18.333333333333332,13,12,>,1,26,61,<,-35,48.0,51.666666666666664,<,-3.6666666666666643,43,44,<,-1,53,56,<,-3,277,216,>,61
0,4,40.0,50.666666666666664,<,-10.666666666666664,12,21,<,-9,61,82,<,-21,51.666666666666664,38.0,>,13.666666666666664,44,30,>,14,56,46,>,10,216,274,<,-58
156,4,50.666666666666664,40.0,>,10.666666666666664,21,12,>,9,82,61,>,21,38.0,51.666666666666664,<,-13.666666666666664,30,44,<,-14,46,56,<,-10,274,216,>,58
0,4,40.0,29.333333333333332,>,10.666666666666668,12,20,<,-8,61,37,>,24,51.666666666666664,37.666666666666664,>,14.0,44,32,>,12,56,42,>,14,216,305,<,-89
74,4,29.333333333333332,40.0,<,-10.666666666666668,20,12,>,8,37,61,<,-24,37.666666666666664,51.666666666666664,<,-14.0,32,44,<,-12,42,56,<,-14,305,216,>,89
0,3,30.333333333333332,40.666666666666664,<,-10.333333333333332,21,20,>,1,49,71,<,-22,38.0,37.666666666666664,>,0.3333333333333357,30,32,<,-2,46,42,>,4,274,305,<,-31
74,3,40.666666666666664,30.333333333333332,>,10.333333333333332,20,21,<,-1,71,49,>,22,37.666666666666664,38.0,<,-0.3333333333333357,32,30,>,2,42,46,<,-4,305,274,>,31
0,3,30.333333333333332,45.333333333333336,<,-15.000000000000004,21,26,<,-5,49,84,<,-35,38.0,48.0,<,-10.0,30,43,<,-13,46,53,<,-7,274,277,<,-3
97,3,45.333333333333336,30.333333333333332,>,15.000000000000004,26,21,>,5,84,49,>,35,48.0,38.0,>,10.0,43,30,>,13,53,46,>,7,277,274,>,3
0,2,21.666666666666668,26.0,<,-4.333333333333332,13,20,<,-7,26,31,<,-5,48.0,37.666666666666664,>,10.333333333333336,43,32,>,11,53,42,>,11,277,305,<,-28
16,2,26.0,21.666666666666668,>,4.333333333333332,20,13,>,7,31,26,>,5,37.666666666666664,48.0,<,-10.333333333333336,32,43,<,-11,42,53,<,-11,305,277,>,28
0,17,0.0,0.0,=,0.0,0,0,=,0,0,0,=,0,35.0,44.0,<,-9.0,32,38,<,-6,37,55,<,-18,150,205,<,-55
117,17,0.0,0.0,=,0.0,0,0,=,0,0,0,=,0,44.0,35.0,>,9.0,38,32,>,6,55,37,>,18,205,150,>,55
0,17,0.0,0.0,=,0.0,0,0,=,0,0,0,=,0,35.0,54.333333333333336,<,-19.333333333333336,32,53,<,-21,37,56,<,-19,150,217,<,-67
74,17,0.0,0.0,=,0.0,0,0,=,0,0,0,=,0,54.333333333333336,35.0,>,19.333333333333336,53,32,>,21,56,37,>,19,217,150,>,67
0,17,0.0,0.0,=,0.0,0,0,=,0,0,0,=,0,35.0,50.666666666666664,<,-15.666666666666664,32,35,<,-3,37,59,<,-22,150,236,<,-86
34,17,0.0,0.0,=,0.0,0,0,=,0,0,0,=,0,50.666666666666664,35.0,>,15.666666666666664,35,32,>,3,59,37,>,22,236,150,>,86
0,17,0.0,0.0,=,0.0,0,0,=,0,0,0,=,0,35.0,43.333333333333336,<,-8.333333333333336,32,32,=,0,37,54,<,-17,150,225,<,-75
52,17,0.0,0.0,=,0.0,0,0,=,0,0,0,=,0,43.333333333333336,35.0,>,8.333333333333336,32,32,=,0,54,37,>,17,225,150,>,75
0,17,0.0,0.0,=,0.0,0,0,=,0,0,0,=,0,35.0,38.666666666666664,<,-3.6666666666666643,32,31,>,1,37,49,<,-12,150,194,<,-44
35,17,0.0,0.0,=,0.0,0,0,=,0,0,0,=,0,38.666666666666664,35.0,>,3.6666666666666643,31,32,<,-1,49,37,>,12,194,150,>,44
0,17,0.0,0.0,=,0.0,0,0,=,0,0,0,=,0,35.0,44.666666666666664,<,-9.666666666666664,32,31,>,1,37,54,<,-17,150,198,<,-48
39,17,0.0,0.0,=,0.0,0,0,=,0,0,0,=,0,44.666666666666664,35.0,>,9.666666666666664,31,32,<,-1,54,37,>,17,198,150,>,48
0,17,0.0,0.0,=,0.0,0,0,=,0,0,0,=,0,35.0,42.0,<,-7.0,32,41,<,-9,37,43,<,-6,150,259,<,-109
110,17,0.0,0.0,=,0.0,0,0,=,0,0,0,=,0,42.0,35.0,>,7.0,41,32,>,9,43,37,>,6,259,150,>,109
0,17,0.0,0.0,=,0.0,0,0,=,0,0,0,=,0,35.0,45.0,<,-10.0,32,38,<,-6,37,57,<,-20,150,212,<,-62
74,17,0.0,0.0,=,0.0,0,0,=,0,0,0,=,0,45.0,35.0,>,10.0,38,32,>,6,57,37,>,20,212,150,>,62
0,17,0.0,0.0,=,0.0,0,0,=,0,0,0,=,0,35.0,47.333333333333336,<,-12.333333333333336,32,45,<,-13,37,50,<,-13,150,216,<,-66
44,17,0.0,0.0,=,0.0,0,0,=,0,0,0,=,0,47.333333333333336,35.0,>,12.333333333333336,45,32,>,13,50,37,>,13,216,150,>,66
0,17,0.0,0.0,=,0.0,0,0,=,0,0,0,=,0,35.0,38.333333333333336,<,-3.3333333333333357,32,30,>,2,37,51,<,-14,150,200,<,-50
68,17,0.0,0.0,=,0.0,0,0,=,0,0,0,=,0,38.333333333333336,35.0,>,3.3333333333333357,30,32,<,-2,51,37,>,14,200,150,>,50
0,17,0.0,0.0,=,0.0,0,0,=,0,0,0,=,0,35.0,44.333333333333336,<,-9.333333333333336,32,32,=,0,37,60,<,-23,150,143,>,7
0,17,0.0,0.0,=,0.0,0,0,=,0,0,0,=,0,44.333333333333336,35.0,>,9.333333333333336,32,32,=,0,60,37,>,23,143,150,<,-7
0,17,0.0,0.0,=,0.0,0,0,=,0,0,0,=,0,35.0,44.333333333333336,<,-9.333333333333336,32,33,<,-1,37,52,<,-15,150,106,>,44
66,17,0.0,0.0,=,0.0,0,0,=,0,0,0,=,0,44.333333333333336,35.0,>,9.333333333333336,33,32,>,1,52,37,>,15,106,150,<,-44
0,17,0.0,0.0,=,0.0,0,0,=,0,0,0,=,0,35.0,38.0,<,-3.0,32,31,>,1,37,42,<,-5,150,190,<,-40
57,17,0.0,0.0,=,0.0,0,0,=,0,0,0,=,0,38.0,35.0,>,3.0,31,32,<,-1,42,37,>,5,190,150,>,40
0,17,0.0,0.0,=,0.0,0,0,=,0,0,0,=,0,35.0,40.0,<,-5.0,32,33,<,-1,37,47,<,-10,150,98,>,52
88,17,0.0,0.0,=,0.0,0,0,=,0,0,0,=,0,40.0,35.0,>,5.0,33,32,>,1,47,37,>,10,98,150,<,-52
0,17,0.0,0.0,=,0.0,0,0,=,0,0,0,=,0,35.0,42.666666666666664,<,-7.666666666666664,32,32,=,0,37,60,<,-23,150,200,<,-50
39,17,0.0,0.0,=,0.0,0,0,=,0,0,0,=,0,42.666666666666664,35.0,>,7.666666666666664,32,32,=,0,60,37,>,23,200,150,>,50
0,17,0.0,0.0,=,0.0,0,0,=,0,0,0,=,0,35.0,43.333333333333336,<,-8.333333333333336,32,42,<,-10,37,45,<,-8,150,95,>,55
0,17,0.0,0.0,=,0.0,0,0,=,0,0,0,=,0,43.333333333333336,35.0,>,8.333333333333336,42,32,>,10,45,37,>,8,95,150,<,-55
0,16,28.666666666666668,22.666666666666668,>,6.0,0,0,=,0,86,68,>,18,44.333333333333336,43.333333333333336,>,1.0,32,42,<,-10,60,45,>,15,143,95,>,48
0,16,22.666666666666668,28.666666666666668,<,-6.0,0,0,=,0,68,86,<,-18,43.333333333333336,44.333333333333336,<,-1.0,42,32,>,10,45,60,<,-15,95,143,<,-48
0,16,28.666666666666668,14.666666666666666,>,14.000000000000002,0,0,=,0,86,44,>,42,44.333333333333336,50.666666666666664,<,-6.333333333333329,32,35,<,-3,60,59,>,1,143,236,<,-93
178,16,14.666666666666666,28.666666666666668,<,-14.000000000000002,0,0,=,0,44,86,<,-42,50.666666666666664,44.333333333333336,>,6.333333333333329,35,32,>,3,59,60,<,-1,236,143,>,93
0,16,28.666666666666668,10.0,>,18.666666666666668,0,0,=,0,86,30,>,56,44.333333333333336,38.666666666666664,>,5.666666666666671,32,31,>,1,60,49,>,11,143,194,<,-51
159,16,10.0,28.666666666666668,<,-18.666666666666668,0,0,=,0,30,86,<,-56,38.666666666666664,44.333333333333336,<,-5.666666666666671,31,32,<,-1,49,60,<,-11,194,143,>,51
0,16,28.666666666666668,16.0,>,12.666666666666668,0,0,=,0,86,48,>,38,44.333333333333336,44.666666666666664,<,-0.3333333333333286,32,31,>,1,60,54,>,6,143,198,<,-55
162,16,16.0,28.666666666666668,<,-12.666666666666668,0,0,=,0,48,86,<,-38,44.666666666666664,44.333333333333336,>,0.3333333333333286,31,32,<,-1,54,60,<,-6,198,143,>,55
0,16,28.666666666666668,7.666666666666667,>,21.0,0,0,=,0,86,23,>,63,44.333333333333336,42.666666666666664,>,1.6666666666666714,32,32,=,0,60,60,=,0,143,200,<,-57
0,16,7.666666666666667,28.666666666666668,<,-21.0,0,0,=,0,23,86,<,-63,42.666666666666664,44.333333333333336,<,-1.6666666666666714,32,32,=,0,60,60,=,0,200,143,>,57
0,16,28.666666666666668,25.0,>,3.666666666666668,0,0,=,0,86,75,>,11,44.333333333333336,47.333333333333336,<,-3.0,32,45,<,-13,60,50,>,10,143,216,<,-73
182,16,25.0,28.666666666666668,<,-3.666666666666668,0,0,=,0,75,86,<,-11,47.333333333333336,44.333333333333336,>,3.0,45,32,>,13,50,60,<,-10,216,143,>,73
0,16,28.666666666666668,14.333333333333334,>,14.333333333333334,0,0,=,0,86,43,>,43,44.333333333333336,43.333333333333336,>,1.0,32,32,=,0,60,54,>,6,143,225,<,-82
122,16,14.333333333333334,28.666666666666668,<,-14.333333333333334,0,0,=,0,43,86,<,-43,43.333333333333336,44.333333333333336,<,-1.0,32,32,=,0,54,60,<,-6,225,143,>,82
0,16,28.666666666666668,28.666666666666668,=,0.0,0,0,=,0,86,86,=,0,44.333333333333336,38.0,>,6.333333333333336,32,31,>,1,60,42,>,18,143,190,<,-47
161,16,28.666666666666668,28.666666666666668,=,0.0,0,0,=,0,86,86,=,0,38.0,44.333333333333336,<,-6.333333333333336,31,32,<,-1,42,60,<,-18,190,143,>,47
0,16,28.666666666666668,14.0,>,14.666666666666668,0,0,=,0,86,42,>,44,44.333333333333336,44.333333333333336,=,0.0,32,33,<,-1,60,52,>,8,143,106,>,37
73,16,14.0,28.666666666666668,<,-14.666666666666668,0,0,=,0,42,86,<,-44,44.333333333333336,44.333333333333336,=,0.0,33,32,>,1,52,60,<,-8,106,143,<,-37
0,16,28.666666666666668,11.0,>,17.666666666666668,0,0,=,0,86,33,>,53,44.333333333333336,38.333333333333336,>,6.0,32,30,>,2,60,51,>,9,143,200,<,-57
149,16,11.0,28.666666666666668,<,-17.666666666666668,0,0,=,0,33,86,<,-53,38.333333333333336,44.333333333333336,<,-6.0,30,32,<,-2,51,60,<,-9,200,143,>,57
0,16,28.666666666666668,18.333333333333332,>,10.333333333333336,0,0,=,0,86,55,>,31,44.333333333333336,54.333333333333336,<,-10.0,32,53,<,-21,60,56,>,4,143,217,<,-74
131,16,18.333333333333332,28.666666666666668,<,-10.333333333333336,0,0,=,0,55,86,<,-31,54.333333333333336,44.333333333333336,>,10.0,53,32,>,21,56,60,<,-4,217,143,>,74
0,16,28.666666666666668,10.333333333333334,>,18.333333333333336,0,0,=,0,86,31,>,55,44.333333333333336,45.0,<,-0.6666666666666643,32,38,<,-6,60,57,>,3,143,212,<,-69
127,16,10.333333333333334,28.666666666666668,<,-18.333333333333336,0,0,=,0,31,86,<,-55,45.0,44.333333333333336,>,0.6666666666666643,38,32,>,6,57,60,<,-3,212,143,>,69
0,16,28.666666666666668,26.333333333333332,>,2.3333333333333357,0,0,=,0,86,79,>,7,44.333333333333336,40.0,>,4.333333333333336,32,33,<,-1,60,47,>,13,143,98,>,45
127,16,26.333333333333332,28.666666666666668,<,-2.3333333333333357,0,0,=,0,79,86,<,-7,40.0,44.333333333333336,<,-4.333333333333336,33,32,>,1,47,60,<,-13,98,143,<,-45
0,16,28.666666666666668,28.333333333333332,>,0.3333333333333357,0,0,=,0,86,85,>,1,44.333333333333336,42.0,>,2.3333333333333357,32,41,<,-9,60,43,>,17,143,259,<,-116
118,16,28.333333333333332,28.666666666666668,<,-0.3333333333333357,0,0,=,0,85,86,<,-1,42.0,44.333333333333336,<,-2.3333333333333357,41,32,>,9,43,60,<,-17,259,143,>,116
0,16,28.666666666666668,10.0,>,18.666666666666668,0,0,=,0,86,30,>,56,44.333333333333336,44.0,>,0.3333333333333357,32,38,<,-6,60,55,>,5,143,205,<,-62
127,16,10.0,28.666666666666668,<,-18.666666666666668,0,0,=,0,30,86,<,-56,44.0,44.333333333333336,<,-0.3333333333333357,38,32,>,6,55,60,<,-5,205,143,>,62
0,15,24.666666666666668,45.0,<,-20.333333333333332,0,0,=,0,51,68,<,-17,42.666666666666664,43.333333333333336,<,-0.6666666666666714,32,42,<,-10,60,45,>,15,200,95,>,105
0,15,45.0,24.666666666666668,>,20.333333333333332,0,0,=,0,68,51,>,17,43.333333333333336,42.666666666666664,>,0.6666666666666714,42,32,>,10,45,60,<,-15,95,200,<,-105
0,15,24.666666666666668,20.666666666666668,>,4.0,0,0,=,0,51,42,>,9,42.666666666666664,44.333333333333336,<,-1.6666666666666714,32,33,<,-1,60,52,>,8,200,106,>,94
0,15,20.666666666666668,24.666666666666668,<,-4.0,0,0,=,0,42,51,<,-9,44.333333333333336,42.666666666666664,>,1.6666666666666714,33,32,>,1,52,60,<,-8,106,200,<,-94
0,15,24.666666666666668,36.0,<,-11.333333333333332,0,0,=,0,51,85,<,-34,42.666666666666664,42.0,>,0.6666666666666643,32,41,<,-9,60,43,>,17,200,259,<,-59
143,15,36.0,24.666666666666668,>,11.333333333333332,0,0,=,0,85,51,>,34,42.0,42.666666666666664,<,-0.6666666666666643,41,32,>,9,43,60,<,-17,259,200,>,59
0,15,24.666666666666668,37.666666666666664,<,-12.999999999999996,0,0,=,0,51,70,<,-19,42.666666666666664,43.333333333333336,<,-0.6666666666666714,32,32,=,0,60,54,>,6,200,225,<,-25
122,15,37.666666666666664,24.666666666666668,>,12.999999999999996,0,0,=,0,70,51,>,19,43.333333333333336,42.666666666666664,>,0.6666666666666714,32,32,=,0,54,60,<,-6,225,200,>,25
0,15,24.666666666666668,32.666666666666664,<,-7.9999999999999964,0,0,=,0,51,68,<,-17,42.666666666666664,44.0,<,-1.3333333333333357,32,38,<,-6,60,55,>,5,200,205,<,-5
106,15,32.666666666666664,24.666666666666668,>,7.9999999999999964,0,0,=,0,68,51,>,17,44.0,42.666666666666664,>,1.3333333333333357,38,32,>,6,55,60,<,-5,205,200,>,5
0,15,24.666666666666668,27.333333333333332,<,-2.6666666666666643,0,0,=,0,51,51,=,0,42.666666666666664,45.0,<,-2.3333333333333357,32,38,<,-6,60,57,>,3,200,212,<,-12
127,15,27.333333333333332,24.666666666666668,>,2.6666666666666643,0,0,=,0,51,51,=,0,45.0,42.666666666666664,>,2.3333333333333357,38,32,>,6,57,60,<,-3,212,200,>,12
0,15,24.666666666666668,52.333333333333336,<,-27.666666666666668,0,0,=,0,51,79,<,-28,42.666666666666664,40.0,>,2.6666666666666643,32,33,<,-1,60,47,>,13,200,98,>,102
157,15,52.333333333333336,24.666666666666668,>,27.666666666666668,0,0,=,0,79,51,>,28,40.0,42.666666666666664,<,-2.6666666666666643,33,32,>,1,47,60,<,-13,98,200,<,-102
0,15,24.666666666666668,24.333333333333332,>,0.3333333333333357,0,0,=,0,51,55,<,-4,42.666666666666664,54.333333333333336,<,-11.666666666666671,32,53,<,-21,60,56,>,4,200,217,<,-17
131,15,24.333333333333332,24.666666666666668,<,-0.3333333333333357,0,0,=,0,55,51,>,4,54.333333333333336,42.666666666666664,>,11.666666666666671,53,32,>,21,56,60,<,-4,217,200,>,17
0,15,24.666666666666668,29.0,<,-4.333333333333332,0,0,=,0,51,54,<,-3,42.666666666666664,38.333333333333336,>,4.333333333333329,32,30,>,2,60,51,>,9,200,200,=,0
149,15,29.0,24.666666666666668,>,4.333333333333332,0,0,=,0,54,51,>,3,38.333333333333336,42.666666666666664,<,-4.333333333333329,30,32,<,-2,51,60,<,-9,200,200,=,0
0,15,24.666666666666668,30.0,<,-5.333333333333332,0,0,=,0,51,60,<,-9,42.666666666666664,38.666666666666664,>,4.0,32,31,>,1,60,49,>,11,200,194,>,6
150,15,30.0,24.666666666666668,>,5.333333333333332,0,0,=,0,60,51,>,9,38.666666666666664,42.666666666666664,<,-4.0,31,32,<,-1,49,60,<,-11,194,200,<,-6
0,15,24.666666666666668,34.666666666666664,<,-9.999999999999996,0,0,=,0,51,86,<,-35,42.666666666666664,38.0,>,4.666666666666664,32,31,>,1,60,42,>,18,200,190,>,10
152,15,34.666666666666664,24.666666666666668,>,9.999999999999996,0,0,=,0,86,51,>,35,38.0,42.666666666666664,<,-4.666666666666664,31,32,<,-1,42,60,<,-18,190,200,<,-10
0,15,24.666666666666668,45.666666666666664,<,-20.999999999999996,0,0,=,0,51,89,<,-38,42.666666666666664,44.666666666666664,<,-2.0,32,31,>,1,60,54,>,6,200,198,>,2
172,15,45.666666666666664,24.666666666666668,>,20.999999999999996,0,0,=,0,89,51,>,38,44.666666666666664,42.666666666666664,>,2.0,31,32,<,-1,54,60,<,-6,198,200,<,-2
0,15,24.666666666666668,25.333333333333332,<,-0.6666666666666643,0,0,=,0,51,44,>,7,42.666666666666664,50.666666666666664,<,-8.0,32,35,<,-3,60,59,>,1,200,236,<,-36
178,15,25.333333333333332,24.666666666666668,>,0.6666666666666643,0,0,=,0,44,51,<,-7,50.666666666666664,42.666666666666664,>,8.0,35,32,>,3,59,60,<,-1,236,200,>,36
0,15,24.666666666666668,48.666666666666664,<,-23.999999999999996,0,0,=,0,51,75,<,-24,42.666666666666664,47.333333333333336,<,-4.666666666666671,32,45,<,-13,60,50,>,10,200,216,<,-16
194,15,48.666666666666664,24.666666666666668,>,23.999999999999996,0,0,=,0,75,51,>,24,47.333333333333336,42.666666666666664,>,4.666666666666671,45,32,>,13,50,60,<,-10,216,200,>,16
0,14,12.666666666666666,48.666666666666664,<,-36.0,0,0,=,0,20,79,<,-59,44.333333333333336,43.333333333333336,>,1.0,33,42,<,-9,52,45,>,7,106,95,>,11
0,14,48.666666666666664,12.666666666666666,>,36.0,0,0,=,0,79,20,>,59,43.333333333333336,44.333333333333336,<,-1.0,42,33,>,9,45,52,<,-7,95,106,<,-11
0,14,12.666666666666666,30.0,<,-17.333333333333336,0,0,=,0,20,68,<,-48,44.333333333333336,44.0,>,0.3333333333333357,33,38,<,-5,52,55,<,-3,106,205,<,-99
52,14,30.0,12.666666666666666,>,17.333333333333336,0,0,=,0,68,20,>,48,44.0,44.333333333333336,<,-0.3333333333333357,38,33,>,5,55,52,>,3,205,106,>,99
0,14,12.666666666666666,43.666666666666664,<,-31.0,0,0,=,0,20,70,<,-50,44.333333333333336,43.333333333333336,>,1.0,33,32,>,1,52,54,<,-2,106,225,<,-119
122,14,43.666666666666664,12.666666666666666,>,31.0,0,0,=,0,70,20,>,50,43.333333333333336,44.333333333333336,<,-1.0,32,33,<,-1,54,52,>,2,225,106,>,119
0,14,12.666666666666666,43.666666666666664,<,-31.0,0,0,=,0,20,80,<,-60,44.333333333333336,45.0,<,-0.6666666666666643,33,38,<,-5,52,57,<,-5,106,212,<,-106
127,14,43.666666666666664,12.666666666666666,>,31.0,0,0,=,0,80,20,>,60,45.0,44.333333333333336,>,0.6666666666666643,38,33,>,5,57,52,>,5,212,106,>,106
0,14,12.666666666666666,31.0,<,-18.333333333333336,0,0,=,0,20,75,<,-55,44.333333333333336,54.333333333333336,<,-10.0,33,53,<,-20,52,56,<,-4,106,217,<,-111
131,14,31.0,12.666666666666666,>,18.333333333333336,0,0,=,0,75,20,>,55,54.333333333333336,44.333333333333336,>,10.0,53,33,>,20,56,52,>,4,217,106,>,111
0,14,12.666666666666666,28.333333333333332,<,-15.666666666666666,0,0,=,0,20,62,<,-42,44.333333333333336,42.0,>,2.3333333333333357,33,41,<,-8,52,43,>,9,106,259,<,-153
143,14,28.333333333333332,12.666666666666666,>,15.666666666666666,0,0,=,0,62,20,>,42,42.0,44.333333333333336,<,-2.3333333333333357,41,33,>,8,43,52,<,-9,259,106,>,153
0,14,12.666666666666666,28.0,<,-15.333333333333334,0,0,=,0,20,54,<,-34,44.333333333333336,38.333333333333336,>,6.0,33,30,>,3,52,51,>,1,106,200,<,-94
139,14,28.0,12.666666666666666,>,15.333333333333334,0,0,=,0,54,20,>,34,38.333333333333336,44.333333333333336,<,-6.0,30,33,<,-3,51,52,<,-1,200,106,>,94
0,14,12.666666666666666,47.0,<,-34.333333333333336,0,0,=,0,20,81,<,-61,44.333333333333336,38.666666666666664,>,5.666666666666671,33,31,>,2,52,49,>,3,106,194,<,-88
159,14,47.0,12.666666666666666,>,34.333333333333336,0,0,=,0,81,20,>,61,38.666666666666664,44.333333333333336,<,-5.666666666666671,31,33,<,-2,49,52,<,-3,194,106,>,88
0,14,12.666666666666666,15.333333333333334,<,-2.666666666666668,0,0,=,0,20,28,<,-8,44.333333333333336,38.0,>,6.333333333333336,33,31,>,2,52,42,>,10,106,190,<,-84
0,14,15.333333333333334,12.666666666666666,>,2.666666666666668,0,0,=,0,28,20,>,8,38.0,44.333333333333336,<,-6.333333333333336,31,33,<,-2,42,52,<,-10,190,106,>,84
0,14,12.666666666666666,44.666666666666664,<,-32.0,0,0,=,0,20,78,<,-58,44.333333333333336,40.0,>,4.333333333333336,33,33,=,0,52,47,>,5,106,98,>,8
157,14,44.666666666666664,12.666666666666666,>,32.0,0,0,=,0,78,20,>,58,40.0,44.333333333333336,<,-4.333333333333336,33,33,=,0,47,52,<,-5,98,106,<,-8
0,14,12.666666666666666,45.666666666666664,<,-33.0,0,0,=,0,20,89,<,-69,44.333333333333336,44.666666666666664,<,-0.3333333333333286,33,31,>,2,52,54,<,-2,106,198,<,-92
180,14,45.666666666666664,12.666666666666666,>,33.0,0,0,=,0,89,20,>,69,44.666666666666664,44.333333333333336,>,0.3333333333333286,31,33,<,-2,54,52,>,2,198,106,>,92
0,14,12.666666666666666,38.666666666666664,<,-26.0,0,0,=,0,20,84,<,-64,44.333333333333336,50.666666666666664,<,-6.333333333333329,33,35,<,-2,52,59,<,-7,106,236,<,-130
178,14,38.666666666666664,12.666666666666666,>,26.0,0,0,=,0,84,20,>,64,50.666666666666664,44.333333333333336,>,6.333333333333329,35,33,>,2,59,52,>,7,236,106,>,130
0,14,12.666666666666666,53.666666666666664,<,-41.0,0,0,=,0,20,90,<,-70,44.333333333333336,47.333333333333336,<,-3.0,33,45,<,-12,52,50,>,2,106,216,<,-110
194,14,53.666666666666664,12.666666666666666,>,41.0,0,0,=,0,90,20,>,70,47.333333333333336,44.333333333333336,>,3.0,45,33,>,12,50,52,<,-2,216,106,>,110
0,13,16.333333333333332,55.666666666666664,<,-39.33333333333333,0,0,=,0,28,88,<,-60,38.0,43.333333333333336,<,-5.333333333333336,31,42,<,-11,42,45,<,-3,190,95,>,95
0,13,55.666666666666664,16.333333333333332,>,39.33333333333333,0,0,=,0,88,28,>,60,43.333333333333336,38.0,>,5.333333333333336,42,31,>,11,45,42,>,3,95,190,<,-95
0,13,16.333333333333332,27.0,<,-10.666666666666668,0,0,=,0,28,59,<,-31,38.0,44.0,<,-6.0,31,38,<,-7,42,55,<,-13,190,205,<,-15
52,13,27.0,16.333333333333332,>,10.666666666666668,0,0,=,0,59,28,>,31,44.0,38.0,>,6.0,38,31,>,7,55,42,>,13,205,190,>,15
0,13,16.333333333333332,47.0,<,-30.666666666666668,0,0,=,0,28,80,<,-52,38.0,43.333333333333336,<,-5.333333333333336,31,32,<,-1,42,54,<,-12,190,225,<,-35
122,13,47.0,16.333333333333332,>,30.666666666666668,0,0,=,0,80,28,>,52,43.333333333333336,38.0,>,5.333333333333336,32,31,>,1,54,42,>,12,225,190,>,35
0,13,16.333333333333332,30.333333333333332,<,-14.0,0,0,=,0,28,80,<,-52,38.0,45.0,<,-7.0,31,38,<,-7,42,57,<,-15,190,212,<,-22
19,13,30.333333333333332,16.333333333333332,>,14.0,0,0,=,0,80,28,>,52,45.0,38.0,>,7.0,38,31,>,7,57,42,>,15,212,190,>,22
0,13,16.333333333333332,35.333333333333336,<,-19.000000000000004,0,0,=,0,28,75,<,-47,38.0,54.333333333333336,<,-16.333333333333336,31,53,<,-22,42,56,<,-14,190,217,<,-27
97,13,35.333333333333336,16.333333333333332,>,19.000000000000004,0,0,=,0,75,28,>,47,54.333333333333336,38.0,>,16.333333333333336,53,31,>,22,56,42,>,14,217,190,>,27
0,13,16.333333333333332,18.0,<,-1.6666666666666679,0,0,=,0,28,30,<,-2,38.0,38.333333333333336,<,-0.3333333333333357,31,30,>,1,42,51,<,-9,190,200,<,-10
0,13,18.0,16.333333333333332,>,1.6666666666666679,0,0,=,0,30,28,>,2,38.333333333333336,38.0,>,0.3333333333333357,30,31,<,-1,51,42,>,9,200,190,>,10
0,13,16.333333333333332,38.0,<,-21.666666666666668,0,0,=,0,28,62,<,-34,38.0,42.0,<,-4.0,31,41,<,-10,42,43,<,-1,190,259,<,-69
137,13,38.0,16.333333333333332,>,21.666666666666668,0,0,=,0,62,28,>,34,42.0,38.0,>,4.0,41,31,>,10,43,42,>,1,259,190,>,69
0,13,16.333333333333332,26.666666666666668,<,-10.333333333333336,0,0,=,0,28,56,<,-28,38.0,40.0,<,-2.0,31,33,<,-2,42,47,<,-5,190,98,>,92
157,13,26.666666666666668,16.333333333333332,>,10.333333333333336,0,0,=,0,56,28,>,28,40.0,38.0,>,2.0,33,31,>,2,47,42,>,5,98,190,<,-92
0,13,16.333333333333332,34.666666666666664,<,-18.333333333333332,0,0,=,0,28,81,<,-53,38.0,38.666666666666664,<,-0.6666666666666643,31,31,=,0,42,49,<,-7,190,194,<,-4
66,13,34.666666666666664,16.333333333333332,>,18.333333333333332,0,0,=,0,81,28,>,53,38.666666666666664,38.0,>,0.6666666666666643,31,31,=,0,49,42,>,7,194,190,>,4
0,13,16.333333333333332,33.666666666666664,<,-17.333333333333332,0,0,=,0,28,84,<,-56,38.0,50.666666666666664,<,-12.666666666666664,31,35,<,-4,42,59,<,-17,190,236,<,-46
64,13,33.666666666666664,16.333333333333332,>,17.333333333333332,0,0,=,0,84,28,>,56,50.666666666666664,38.0,>,12.666666666666664,35,31,>,4,59,42,>,17,236,190,>,46
0,13,16.333333333333332,43.333333333333336,<,-27.000000000000004,0,0,=,0,28,82,<,-54,38.0,44.666666666666664,<,-6.666666666666664,31,31,=,0,42,54,<,-12,190,198,<,-8
154,13,43.333333333333336,16.333333333333332,>,27.000000000000004,0,0,=,0,82,28,>,54,44.666666666666664,38.0,>,6.666666666666664,31,31,=,0,54,42,>,12,198,190,>,8
0,13,16.333333333333332,46.0,<,-29.666666666666668,0,0,=,0,28,90,<,-62,38.0,47.333333333333336,<,-9.333333333333336,31,45,<,-14,42,50,<,-8,190,216,<,-26
107,13,46.0,16.333333333333332,>,29.666666666666668,0,0,=,0,90,28,>,62,47.333333333333336,38.0,>,9.333333333333336,45,31,>,14,50,42,>,8,216,190,>,26
0,12,37.666666666666664,34.0,>,3.6666666666666643,0,0,=,0,89,88,>,1,38.333333333333336,43.333333333333336,<,-5.0,30,42,<,-12,51,45,>,6,200,95,>,105
0,12,34.0,37.666666666666664,<,-3.6666666666666643,0,0,=,0,88,89,<,-1,43.333333333333336,38.333333333333336,>,5.0,42,30,>,12,45,51,<,-6,95,200,<,-105
0,12,37.666666666666664,27.333333333333332,>,10.333333333333332,0,0,=,0,89,71,>,18,38.333333333333336,45.0,<,-6.666666666666664,30,38,<,-8,51,57,<,-6,200,212,<,-12
19,12,27.333333333333332,37.666666666666664,<,-10.333333333333332,0,0,=,0,71,89,<,-18,45.0,38.333333333333336,>,6.666666666666664,38,30,>,8,57,51,>,6,212,200,>,12
0,12,37.666666666666664,44.0,<,-6.333333333333336,0,0,=,0,89,73,>,16,38.333333333333336,44.0,<,-5.666666666666664,30,38,<,-8,51,55,<,-4,200,205,<,-5
189,12,44.0,37.666666666666664,>,6.333333333333336,0,0,=,0,73,89,<,-16,44.0,38.333333333333336,>,5.666666666666664,38,30,>,8,55,51,>,4,205,200,>,5
0,12,37.666666666666664,13.0,>,24.666666666666664,0,0,=,0,89,22,>,67,38.333333333333336,50.666666666666664,<,-12.333333333333329,30,35,<,-5,51,59,<,-8,200,236,<,-36
64,12,13.0,37.666666666666664,<,-24.666666666666664,0,0,=,0,22,89,<,-67,50.666666666666664,38.333333333333336,>,12.333333333333329,35,30,>,5,59,51,>,8,236,200,>,36
0,12,37.666666666666664,12.333333333333334,>,25.33333333333333,0,0,=,0,89,23,>,66,38.333333333333336,38.666666666666664,<,-0.3333333333333286,30,31,<,-1,51,49,>,2,200,194,>,6
0,12,12.333333333333334,37.666666666666664,<,-25.33333333333333,0,0,=,0,23,89,<,-66,38.666666666666664,38.333333333333336,>,0.3333333333333286,31,30,>,1,49,51,<,-2,194,200,<,-6
0,12,37.666666666666664,32.0,>,5.666666666666664,0,0,=,0,89,65,>,24,38.333333333333336,54.333333333333336,<,-16.0,30,53,<,-23,51,56,<,-5,200,217,<,-17
97,12,32.0,37.666666666666664,<,-5.666666666666664,0,0,=,0,65,89,<,-24,54.333333333333336,38.333333333333336,>,16.0,53,30,>,23,56,51,>,5,217,200,>,17
0,12,37.666666666666664,40.0,<,-2.3333333333333357,0,0,=,0,89,72,>,17,38.333333333333336,47.333333333333336,<,-9.0,30,45,<,-15,51,50,>,1,200,216,<,-16
107,12,40.0,37.666666666666664,>,2.3333333333333357,0,0,=,0,72,89,<,-17,47.333333333333336,38.333333333333336,>,9.0,45,30,>,15,50,51,<,-1,216,200,>,16
0,12,37.666666666666664,41.333333333333336,<,-3.6666666666666714,0,0,=,0,89,80,>,9,38.333333333333336,43.333333333333336,<,-5.0,30,32,<,-2,51,54,<,-3,200,225,<,-25
97,12,41.333333333333336,37.666666666666664,>,3.6666666666666714,0,0,=,0,80,89,<,-9,43.333333333333336,38.333333333333336,>,5.0,32,30,>,2,54,51,>,3,225,200,>,25
0,12,37.666666666666664,34.0,>,3.6666666666666643,0,0,=,0,89,52,>,37,38.333333333333336,42.0,<,-3.6666666666666643,30,41,<,-11,51,43,>,8,200,259,<,-59
116,12,34.0,37.666666666666664,<,-3.6666666666666643,0,0,=,0,52,89,<,-37,42.0,38.333333333333336,>,3.6666666666666643,41,30,>,11,43,51,<,-8,259,200,>,59
0,12,37.666666666666664,53.666666666666664,<,-16.0,0,0,=,0,89,82,>,7,38.333333333333336,44.666666666666664,<,-6.333333333333329,30,31,<,-1,51,54,<,-3,200,198,>,2
154,12,53.666666666666664,37.666666666666664,>,16.0,0,0,=,0,82,89,<,-7,44.666666666666664,38.333333333333336,>,6.333333333333329,31,30,>,1,54,51,>,3,198,200,<,-2
0,12,37.666666666666664,17.0,>,20.666666666666664,0,0,=,0,89,27,>,62,38.333333333333336,40.0,<,-1.6666666666666643,30,33,<,-3,51,47,>,4,200,98,>,102
157,12,17.0,37.666666666666664,<,-20.666666666666664,0,0,=,0,27,89,<,-62,40.0,38.333333333333336,>,1.6666666666666643,33,30,>,3,47,51,<,-4,98,200,<,-102
0,11,34.0,33.333333333333336,>,0.6666666666666643,0,0,=,0,88,86,>,2,38.666666666666664,43.333333333333336,<,-4.666666666666671,31,42,<,-11,49,45,>,4,194,95,>,99
0,11,33.333333333333336,34.0,<,-0.6666666666666643,0,0,=,0,86,88,<,-2,43.333333333333336,38.666666666666664,>,4.666666666666671,42,31,>,11,45,49,<,-4,95,194,<,-99
0,11,34.0,39.666666666666664,<,-5.666666666666664,0,0,=,0,88,71,>,17,38.666666666666664,45.0,<,-6.333333333333336,31,38,<,-7,49,57,<,-8,194,212,<,-18
127,11,39.666666666666664,34.0,>,5.666666666666664,0,0,=,0,71,88,<,-17,45.0,38.666666666666664,>,6.333333333333336,38,31,>,7,57,49,>,8,212,194,>,18
0,11,34.0,19.333333333333332,>,14.666666666666668,0,0,=,0,88,36,>,52,38.666666666666664,50.666666666666664,<,-12.0,31,35,<,-4,49,59,<,-10,194,236,<,-42
72,11,19.333333333333332,34.0,<,-14.666666666666668,0,0,=,0,36,88,<,-52,50.666666666666664,38.666666666666664,>,12.0,35,31,>,4,59,49,>,10,236,194,>,42
0,11,34.0,32.666666666666664,>,1.3333333333333357,0,0,=,0,88,65,>,23,38.666666666666664,54.333333333333336,<,-15.666666666666671,31,53,<,-22,49,56,<,-7,194,217,<,-23
95,11,32.666666666666664,34.0,<,-1.3333333333333357,0,0,=,0,65,88,<,-23,54.333333333333336,38.666666666666664,>,15.666666666666671,53,31,>,22,56,49,>,7,217,194,>,23
0,11,34.0,38.666666666666664,<,-4.666666666666664,0,0,=,0,88,72,>,16,38.666666666666664,43.333333333333336,<,-4.666666666666671,31,32,<,-1,49,54,<,-5,194,225,<,-31
97,11,38.666666666666664,34.0,>,4.666666666666664,0,0,=,0,72,88,<,-16,43.333333333333336,38.666666666666664,>,4.666666666666671,32,31,>,1,54,49,>,5,225,194,>,31
0,11,34.0,45.666666666666664,<,-11.666666666666664,0,0,=,0,88,72,>,16,38.666666666666664,47.333333333333336,<,-8.666666666666671,31,45,<,-14,49,50,<,-1,194,216,<,-22
156,11,45.666666666666664,34.0,>,11.666666666666664,0,0,=,0,72,88,<,-16,47.333333333333336,38.666666666666664,>,8.666666666666671,45,31,>,14,50,49,>,1,216,194,>,22
0,11,34.0,31.333333333333332,>,2.666666666666668,0,0,=,0,88,50,>,38,38.666666666666664,42.0,<,-3.3333333333333357,31,41,<,-10,49,43,>,6,194,259,<,-65
78,11,31.333333333333332,34.0,<,-2.666666666666668,0,0,=,0,50,88,<,-38,42.0,38.666666666666664,>,3.3333333333333357,41,31,>,10,43,49,<,-6,259,194,>,65
0,11,34.0,35.333333333333336,<,-1.3333333333333357,0,0,=,0,88,79,>,9,38.666666666666664,44.666666666666664,<,-6.0,31,31,=,0,49,54,<,-5,194,198,<,-4
0,11,35.333333333333336,34.0,>,1.3333333333333357,0,0,=,0,79,88,<,-9,44.666666666666664,38.666666666666664,>,6.0,31,31,=,0,54,49,>,5,198,194,>,4
0,11,34.0,24.666666666666668,>,9.333333333333332,0,0,=,0,88,47,>,41,38.666666666666664,40.0,<,-1.3333333333333357,31,33,<,-2,49,47,>,2,194,98,>,96
157,11,24.666666666666668,34.0,<,-9.333333333333332,0,0,=,0,47,88,<,-41,40.0,38.666666666666664,>,1.3333333333333357,33,31,>,2,47,49,<,-2,98,194,<,-96
0,11,34.0,38.333333333333336,<,-4.333333333333336,0,0,=,0,88,73,>,15,38.666666666666664,44.0,<,-5.333333333333336,31,38,<,-7,49,55,<,-6,194,205,<,-11
189,11,38.333333333333336,34.0,>,4.333333333333336,0,0,=,0,73,88,<,-15,44.0,38.666666666666664,>,5.333333333333336,38,31,>,7,55,49,>,6,205,194,>,11
0,10,33.0,46.666666666666664,<,-13.666666666666664,0,0,=,0,72,86,<,-14,44.666666666666664,43.333333333333336,>,1.3333333333333286,31,42,<,-11,54,45,>,9,198,95,>,103
0,10,46.666666666666664,33.0,>,13.666666666666664,0,0,=,0,86,72,>,14,43.333333333333336,44.666666666666664,<,-1.3333333333333286,42,31,>,11,45,54,<,-9,95,198,<,-103
0,10,33.0,40.0,<,-7.0,0,0,=,0,72,84,<,-12,44.666666666666664,50.666666666666664,<,-6.0,31,35,<,-4,54,59,<,-5,198,236,<,-38
72,10,40.0,33.0,>,7.0,0,0,=,0,84,72,>,12,50.666666666666664,44.666666666666664,>,6.0,35,31,>,4,59,54,>,5,236,198,>,38
0,10,33.0,25.333333333333332,>,7.666666666666668,0,0,=,0,72,44,>,28,44.666666666666664,42.0,>,2.6666666666666643,31,41,<,-10,54,43,>,11,198,259,<,-61
70,10,25.333333333333332,33.0,<,-7.666666666666668,0,0,=,0,44,72,<,-28,42.0,44.666666666666664,<,-2.6666666666666643,41,31,>,10,43,54,<,-11,259,198,>,61
0,10,33.0,15.666666666666666,>,17.333333333333336,0,0,=,0,72,33,>,39,44.666666666666664,54.333333333333336,<,-9.666666666666671,31,53,<,-22,54,56,<,-2,198,217,<,-19
95,10,15.666666666666666,33.0,<,-17.333333333333336,0,0,=,0,33,72,<,-39,54.333333333333336,44.666666666666664,>,9.666666666666671,53,31,>,22,56,54,>,2,217,198,>,19
0,10,33.0,29.333333333333332,>,3.666666666666668,0,0,=,0,72,72,=,0,44.666666666666664,43.333333333333336,>,1.3333333333333286,31,32,<,-1,54,54,=,0,198,225,<,-27
0,10,29.333333333333332,33.0,<,-3.666666666666668,0,0,=,0,72,72,=,0,43.333333333333336,44.666666666666664,<,-1.3333333333333286,32,31,>,1,54,54,=,0,225,198,>,27
0,10,33.0,31.666666666666668,>,1.3333333333333321,0,0,=,0,72,48,>,24,44.666666666666664,45.0,<,-0.3333333333333357,31,38,<,-7,54,57,<,-3,198,212,<,-14
127,10,31.666666666666668,33.0,<,-1.3333333333333321,0,0,=,0,48,72,<,-24,45.0,44.666666666666664,>,0.3333333333333357,38,31,>,7,57,54,>,3,212,198,>,14
0,10,33.0,25.0,>,8.0,0,0,=,0,72,65,>,7,44.666666666666664,47.333333333333336,<,-2.6666666666666714,31,45,<,-14,54,50,>,4,198,216,<,-18
54,10,25.0,33.0,<,-8.0,0,0,=,0,65,72,<,-7,47.333333333333336,44.666666666666664,>,2.6666666666666714,45,31,>,14,50,54,<,-4,216,198,>,18
0,10,33.0,37.666666666666664,<,-4.666666666666664,0,0,=,0,72,66,>,6,44.666666666666664,40.0,>,4.666666666666664,31,33,<,-2,54,47,>,7,198,98,>,100
157,10,37.666666666666664,33.0,>,4.666666666666664,0,0,=,0,66,72,<,-6,40.0,44.666666666666664,<,-4.666666666666664,33,31,>,2,47,54,<,-7,98,198,<,-100
0,10,33.0,33.333333333333336,<,-0.3333333333333357,0,0,=,0,72,58,>,14,44.666666666666664,44.0,>,0.6666666666666643,31,38,<,-7,54,55,<,-1,198,205,<,-7
187,10,33.333333333333336,33.0,>,0.3333333333333357,0,0,=,0,58,72,<,-14,44.0,44.666666666666664,<,-0.6666666666666643,38,31,>,7,55,54,>,1,205,198,>,7
0,9,24.0,40.333333333333336,<,-16.333333333333336,0,0,=,0,56,67,<,-11,43.333333333333336,43.333333333333336,=,0.0,32,42,<,-10,54,45,>,9,225,95,>,130
0,9,40.333333333333336,24.0,>,16.333333333333336,0,0,=,0,67,56,>,11,43.333333333333336,43.333333333333336,=,0.0,42,32,>,10,45,54,<,-9,95,225,<,-130
0,9,24.0,24.333333333333332,<,-0.33333333333333215,0,0,=,0,56,63,<,-7,43.333333333333336,47.333333333333336,<,-4.0,32,45,<,-13,54,50,>,4,225,216,>,9
54,9,24.333333333333332,24.0,>,0.33333333333333215,0,0,=,0,63,56,>,7,47.333333333333336,43.333333333333336,>,4.0,45,32,>,13,50,54,<,-4,216,225,<,-9
0,9,24.0,35.666666666666664,<,-11.666666666666664,0,0,=,0,56,75,<,-19,43.333333333333336,42.0,>,1.3333333333333357,32,41,<,-9,54,43,>,11,225,259,<,-34
70,9,35.666666666666664,24.0,>,11.666666666666664,0,0,=,0,75,56,>,19,42.0,43.333333333333336,<,-1.3333333333333357,41,32,>,9,43,54,<,-11,259,225,>,34
0,9,24.0,31.666666666666668,<,-7.666666666666668,0,0,=,0,56,84,<,-28,43.333333333333336,50.666666666666664,<,-7.333333333333329,32,35,<,-3,54,59,<,-5,225,236,<,-11
0,9,31.666666666666668,24.0,>,7.666666666666668,0,0,=,0,84,56,>,28,50.666666666666664,43.333333333333336,>,7.333333333333329,35,32,>,3,59,54,>,5,236,225,>,11
0,9,24.0,29.0,<,-5.0,0,0,=,0,56,73,<,-17,43.333333333333336,54.333333333333336,<,-11.0,32,53,<,-21,54,56,<,-2,225,217,>,8
116,9,29.0,24.0,>,5.0,0,0,=,0,73,56,>,17,54.333333333333336,43.333333333333336,>,11.0,53,32,>,21,56,54,>,2,217,225,<,-8
0,9,24.0,26.0,<,-2.0,0,0,=,0,56,47,>,9,43.333333333333336,45.0,<,-1.6666666666666643,32,38,<,-6,54,57,<,-3,225,212,>,13
106,9,26.0,24.0,>,2.0,0,0,=,0,47,56,<,-9,45.0,43.333333333333336,>,1.6666666666666643,38,32,>,6,57,54,>,3,212,225,<,-13
0,9,24.0,32.333333333333336,<,-8.333333333333336,0,0,=,0,56,66,<,-10,43.333333333333336,40.0,>,3.3333333333333357,32,33,<,-1,54,47,>,7,225,98,>,127
157,9,32.333333333333336,24.0,>,8.333333333333336,0,0,=,0,66,56,>,10,40.0,43.333333333333336,<,-3.3333333333333357,33,32,>,1,47,54,<,-7,98,225,<,-127
0,9,24.0,29.0,<,-5.0,0,0,=,0,56,58,<,-2,43.333333333333336,44.0,<,-0.6666666666666643,32,38,<,-6,54,55,<,-1,225,205,>,20
155,9,29.0,24.0,>,5.0,0,0,=,0,58,56,>,2,44.0,43.333333333333336,>,0.6666666666666643,38,32,>,6,55,54,>,1,205,225,<,-20
0,8,30.0,41.0,<,-11.0,0,0,=,0,79,67,>,12,50.666666666666664,43.333333333333336,>,7.333333333333329,35,42,<,-7,59,45,>,14,236,95,>,141
0,8,41.0,30.0,>,11.0,0,0,=,0,67,79,<,-12,43.333333333333336,50.666666666666664,<,-7.333333333333329,42,35,>,7,45,59,<,-14,95,236,<,-141
0,8,30.0,24.333333333333332,>,5.666666666666668,0,0,=,0,79,63,>,16,50.666666666666664,47.333333333333336,>,3.3333333333333286,35,45,<,-10,59,50,>,9,236,216,>,20
0,8,24.333333333333332,30.0,<,-5.666666666666668,0,0,=,0,63,79,<,-16,47.333333333333336,50.666666666666664,<,-3.3333333333333286,45,35,>,10,50,59,<,-9,216,236,<,-20
0,8,30.0,48.0,<,-18.0,0,0,=,0,79,75,>,4,50.666666666666664,42.0,>,8.666666666666664,35,41,<,-6,59,43,>,16,236,259,<,-23
82,8,48.0,30.0,>,18.0,0,0,=,0,75,79,<,-4,42.0,50.666666666666664,<,-8.666666666666664,41,35,>,6,43,59,<,-16,259,236,>,23
0,8,30.0,19.333333333333332,>,10.666666666666668,0,0,=,0,79,31,>,48,50.666666666666664,45.0,>,5.666666666666664,35,38,<,-3,59,57,>,2,236,212,>,24
71,8,19.333333333333332,30.0,<,-10.666666666666668,0,0,=,0,31,79,<,-48,45.0,50.666666666666664,<,-5.666666666666664,38,35,>,3,57,59,<,-2,212,236,<,-24
0,8,30.0,41.666666666666664,<,-11.666666666666664,0,0,=,0,79,73,>,6,50.666666666666664,54.333333333333336,<,-3.6666666666666714,35,53,<,-18,59,56,>,3,236,217,>,19
94,8,41.666666666666664,30.0,>,11.666666666666664,0,0,=,0,73,79,<,-6,54.333333333333336,50.666666666666664,>,3.6666666666666714,53,35,>,18,56,59,<,-3,217,236,<,-19
0,8,30.0,26.333333333333332,>,3.666666666666668,0,0,=,0,79,50,>,29,50.666666666666664,44.0,>,6.666666666666664,35,38,<,-3,59,55,>,4,236,205,>,31
133,8,26.333333333333332,30.0,<,-3.666666666666668,0,0,=,0,50,79,<,-29,44.0,50.666666666666664,<,-6.666666666666664,38,35,>,3,55,59,<,-4,205,236,<,-31
0,8,30.0,35.333333333333336,<,-5.333333333333336,0,0,=,0,79,75,>,4,50.666666666666664,40.0,>,10.666666666666664,35,33,>,2,59,47,>,12,236,98,>,138
157,8,35.333333333333336,30.0,>,5.333333333333336,0,0,=,0,75,79,<,-4,40.0,50.666666666666664,<,-10.666666666666664,33,35,<,-2,47,59,<,-12,98,236,<,-138
0,7,14.0,24.666666666666668,<,-10.666666666666668,0,0,=,0,32,56,<,-24,47.333333333333336,43.333333333333336,>,4.0,45,42,>,3,50,45,>,5,216,95,>,121
0,7,24.666666666666668,14.0,>,10.666666666666668,0,0,=,0,56,32,>,24,43.333333333333336,47.333333333333336,<,-4.0,42,45,<,-3,45,50,<,-5,95,216,<,-121
0,7,14.0,25.666666666666668,<,-11.666666666666668,0,0,=,0,32,50,<,-18,47.333333333333336,45.0,>,2.3333333333333357,45,38,>,7,50,57,<,-7,216,212,>,4
71,7,25.666666666666668,14.0,>,11.666666666666668,0,0,=,0,50,32,>,18,45.0,47.333333333333336,<,-2.3333333333333357,38,45,<,-7,57,50,>,7,212,216,<,-4
0,7,14.0,26.333333333333332,<,-12.333333333333332,0,0,=,0,32,69,<,-37,47.333333333333336,42.0,>,5.333333333333336,45,41,>,4,50,43,>,7,216,259,<,-43
0,7,26.333333333333332,14.0,>,12.333333333333332,0,0,=,0,69,32,>,37,42.0,47.333333333333336,<,-5.333333333333336,41,45,<,-4,43,50,<,-7,259,216,>,43
0,7,14.0,35.666666666666664,<,-21.666666666666664,0,0,=,0,32,55,<,-23,47.333333333333336,54.333333333333336,<,-7.0,45,53,<,-8,50,56,<,-6,216,217,<,-1
94,7,35.666666666666664,14.0,>,21.666666666666664,0,0,=,0,55,32,>,23,54.333333333333336,47.333333333333336,>,7.0,53,45,>,8,56,50,>,6,217,216,>,1
0,7,14.0,29.0,<,-15.0,0,0,=,0,32,50,<,-18,47.333333333333336,44.0,>,3.3333333333333357,45,38,>,7,50,55,<,-5,216,205,>,11
133,7,29.0,14.0,>,15.0,0,0,=,0,50,32,>,18,44.0,47.333333333333336,<,-3.3333333333333357,38,45,<,-7,55,50,>,5,205,216,<,-11
0,7,14.0,44.0,<,-30.0,0,0,=,0,32,75,<,-43,47.333333333333336,40.0,>,7.333333333333336,45,33,>,12,50,47,>,3,216,98,>,118
157,7,44.0,14.0,>,30.0,0,0,=,0,75,32,>,43,40.0,47.333333333333336,<,-7.333333333333336,33,45,<,-12,47,50,<,-3,98,216,<,-118
0,6,23.333333333333332,25.666666666666668,<,-2.3333333333333357,0,0,=,0,60,59,>,1,42.0,43.333333333333336,<,-1.3333333333333357,41,42,<,-1,43,45,<,-2,259,95,>,164
0,6,25.666666666666668,23.333333333333332,>,2.3333333333333357,0,0,=,0,59,60,<,-1,43.333333333333336,42.0,>,1.3333333333333357,42,41,>,1,45,43,>,2,95,259,<,-164
0,6,23.333333333333332,37.666666666666664,<,-14.333333333333332,0,0,=,0,60,63,<,-3,42.0,45.0,<,-3.0,41,38,>,3,43,57,<,-14,259,212,>,47
87,6,37.666666666666664,23.333333333333332,>,14.333333333333332,0,0,=,0,63,60,>,3,45.0,42.0,>,3.0,38,41,<,-3,57,43,>,14,212,259,<,-47
0,6,23.333333333333332,36.333333333333336,<,-13.000000000000004,0,0,=,0,60,55,>,5,42.0,54.333333333333336,<,-12.333333333333336,41,53,<,-12,43,56,<,-13,259,217,>,42
102,6,36.333333333333336,23.333333333333332,>,13.000000000000004,0,0,=,0,55,60,<,-5,54.333333333333336,42.0,>,12.333333333333336,53,41,>,12,56,43,>,13,217,259,<,-42
0,6,23.333333333333332,21.0,>,2.333333333333332,0,0,=,0,60,37,>,23,42.0,44.0,<,-2.0,41,38,>,3,43,55,<,-12,259,205,>,54
157,6,21.0,23.333333333333332,<,-2.333333333333332,0,0,=,0,37,60,<,-23,44.0,42.0,>,2.0,38,41,<,-3,55,43,>,12,205,259,<,-54
0,6,23.333333333333332,29.666666666666668,<,-6.333333333333336,0,0,=,0,60,57,>,3,42.0,40.0,>,2.0,41,33,>,8,43,47,<,-4,259,98,>,161
157,6,29.666666666666668,23.333333333333332,>,6.333333333333336,0,0,=,0,57,60,<,-3,40.0,42.0,<,-2.0,33,41,<,-8,47,43,>,4,98,259,<,-161
0,5,46.666666666666664,27.0,>,19.666666666666664,0,0,=,0,81,63,>,18,43.333333333333336,45.0,<,-1.6666666666666643,42,38,>,4,45,57,<,-12,95,212,<,-117
127,5,27.0,46.666666666666664,<,-19.666666666666664,0,0,=,0,63,81,<,-18,45.0,43.333333333333336,>,1.6666666666666643,38,42,<,-4,57,45,>,12,212,95,>,117
0,5,46.666666666666664,37.666666666666664,>,9.0,0,0,=,0,81,59,>,22,43.333333333333336,54.333333333333336,<,-11.0,42,53,<,-11,45,56,<,-11,95,217,<,-122
149,5,37.666666666666664,46.666666666666664,<,-9.0,0,0,=,0,59,81,<,-22,54.333333333333336,43.333333333333336,>,11.0,53,42,>,11,56,45,>,11,217,95,>,122
0,5,46.666666666666664,36.0,>,10.666666666666664,0,0,=,0,81,82,<,-1,43.333333333333336,44.0,<,-0.6666666666666643,42,38,>,4,45,55,<,-10,95,205,<,-110
157,5,36.0,46.666666666666664,<,-10.666666666666664,0,0,=,0,82,81,>,1,44.0,43.333333333333336,>,0.6666666666666643,38,42,<,-4,55,45,>,10,205,95,>,110
0,5,46.666666666666664,28.666666666666668,>,17.999999999999996,0,0,=,0,81,54,>,27,43.333333333333336,40.0,>,3.3333333333333357,42,33,>,9,45,47,<,-2,95,98,<,-3
157,5,28.666666666666668,46.666666666666664,<,-17.999999999999996,0,0,=,0,54,81,<,-27,40.0,43.333333333333336,<,-3.3333333333333357,33,42,<,-9,47,45,>,2,98,95,>,3
0,4,32.0,38.0,<,-6.0,10,18,<,-8,54,63,<,-9,40.0,45.0,<,-5.0,33,38,<,-5,47,57,<,-10,98,212,<,-114
101,4,38.0,32.0,>,6.0,18,10,>,8,63,54,>,9,45.0,40.0,>,5.0,38,33,>,5,57,47,>,10,212,98,>,114
0,4,32.0,54.0,<,-22.0,10,49,<,-39,54,59,<,-5,40.0,54.333333333333336,<,-14.333333333333336,33,53,<,-20,47,56,<,-9,98,217,<,-119
149,4,54.0,32.0,>,22.0,49,10,>,39,59,54,>,5,54.333333333333336,40.0,>,14.333333333333336,53,33,>,20,56,47,>,9,217,98,>,119
0,4,32.0,54.333333333333336,<,-22.333333333333336,10,26,<,-16,54,82,<,-28,40.0,44.0,<,-4.0,33,38,<,-5,47,55,<,-8,98,205,<,-107
157,4,54.333333333333336,32.0,>,22.333333333333336,26,10,>,16,82,54,>,28,44.0,40.0,>,4.0,38,33,>,5,55,47,>,8,205,98,>,107
0,3,40.0,55.666666666666664,<,-15.666666666666664,12,18,<,-6,82,86,<,-4,44.0,45.0,<,-1.0,38,38,=,0,55,57,<,-2,205,212,<,-7
134,3,55.666666666666664,40.0,>,15.666666666666664,18,12,>,6,86,82,>,4,45.0,44.0,>,1.0,38,38,=,0,57,55,>,2,212,205,>,7
0,3,40.0,58.666666666666664,<,-18.666666666666664,12,54,<,-42,82,63,>,19,44.0,54.333333333333336,<,-10.333333333333336,38,53,<,-15,55,56,<,-1,205,217,<,-12
149,3,58.666666666666664,40.0,>,18.666666666666664,54,12,>,42,63,82,<,-19,54.333333333333336,44.0,>,10.333333333333336,53,38,>,15,56,55,>,1,217,205,>,12
0,2,42.333333333333336,41.0,>,1.3333333333333357,14,18,<,-4,59,63,<,-4,54.333333333333336,45.0,>,9.333333333333336,53,38,>,15,56,57,<,-1,217,212,>,5
114,2,41.0,42.333333333333336,<,-1.3333333333333357,18,14,>,4,63,59,>,4,45.0,54.333333333333336,<,-9.333333333333336,38,53,<,-15,57,56,>,1,212,217,<,-5
0,12,0.0,0.0,=,0.0,0,0,=,0,0,0,=,0,40.0,42.666666666666664,<,-2.6666666666666643,36,30,>,6,44,59,<,-15,144,141,>,3
22,12,0.0,0.0,=,0.0,0,0,=,0,0,0,=,0,42.666666666666664,40.0,>,2.6666666666666643,30,36,<,-6,59,44,>,15,141,144,<,-3
0,12,0.0,0.0,=,0.0,0,0,=,0,0,0,=,0,40.0,51.333333333333336,<,-11.333333333333336,36,37,<,-1,44,60,<,-16,144,137,>,7
56,12,0.0,0.0,=,0.0,0,0,=,0,0,0,=,0,51.333333333333336,40.0,>,11.333333333333336,37,36,>,1,60,44,>,16,137,144,<,-7
0,12,0.0,0.0,=,0.0,0,0,=,0,0,0,=,0,40.0,40.666666666666664,<,-0.6666666666666643,36,31,>,5,44,55,<,-11,144,125,>,19
6,12,0.0,0.0,=,0.0,0,0,=,0,0,0,=,0,40.666666666666664,40.0,>,0.6666666666666643,31,36,<,-5,55,44,>,11,125,144,<,-19
0,12,0.0,0.0,=,0.0,0,0,=,0,0,0,=,0,40.0,48.333333333333336,<,-8.333333333333336,36,45,<,-9,44,54,<,-10,144,175,<,-31
68,12,0.0,0.0,=,0.0,0,0,=,0,0,0,=,0,48.333333333333336,40.0,>,8.333333333333336,45,36,>,9,54,44,>,10,175,144,>,31
0,12,0.0,0.0,=,0.0,0,0,=,0,0,0,=,0,40.0,39.666666666666664,>,0.3333333333333357,36,32,>,4,44,51,<,-7,144,66,>,78
30,12,0.0,0.0,=,0.0,0,0,=,0,0,0,=,0,39.666666666666664,40.0,<,-0.3333333333333357,32,36,<,-4,51,44,>,7,66,144,<,-78
0,12,0.0,0.0,=,0.0,0,0,=,0,0,0,=,0,40.0,45.666666666666664,<,-5.666666666666664,36,34,>,2,44,55,<,-11,144,154,<,-10
74,12,0.0,0.0,=,0.0,0,0,=,0,0,0,=,0,45.666666666666664,40.0,>,5.666666666666664,34,36,<,-2,55,44,>,11,154,144,>,10
0,12,0.0,0.0,=,0.0,0,0,=,0,0,0,=,0,40.0,45.333333333333336,<,-5.333333333333336,36,34,>,2,44,58,<,-14,144,92,>,52
0,12,0.0,0.0,=,0.0,0,0,=,0,0,0,=,0,45.333333333333336,40.0,>,5.333333333333336,34,36,<,-2,58,44,>,14,92,144,<,-52
0,12,0.0,0.0,=,0.0,0,0,=,0,0,0,=,0,40.0,49.666666666666664,<,-9.666666666666664,36,37,<,-1,44,58,<,-14,144,69,>,75
0,12,0.0,0.0,=,0.0,0,0,=,0,0,0,=,0,49.666666666666664,40.0,>,9.666666666666664,37,36,>,1,58,44,>,14,69,144,<,-75
0,12,0.0,0.0,=,0.0,0,0,=,0,0,0,=,0,40.0,44.0,<,-4.0,36,32,>,4,44,56,<,-12,144,180,<,-36
66,12,0.0,0.0,=,0.0,0,0,=,0,0,0,=,0,44.0,40.0,>,4.0,32,36,<,-4,56,44,>,12,180,144,>,36
0,12,0.0,0.0,=,0.0,0,0,=,0,0,0,=,0,40.0,49.0,<,-9.0,36,41,<,-5,44,55,<,-11,144,160,<,-16
41,12,0.0,0.0,=,0.0,0,0,=,0,0,0,=,0,49.0,40.0,>,9.0,41,36,>,5,55,44,>,11,160,144,>,16
0,12,0.0,0.0,=,0.0,0,0,=,0,0,0,=,0,40.0,42.0,<,-2.0,36,32,>,4,44,53,<,-9,144,165,<,-21
94,12,0.0,0.0,=,0.0,0,0,=,0,0,0,=,0,42.0,40.0,>,2.0,32,36,<,-4,53,44,>,9,165,144,>,21
0,11,9.0,18.666666666666668,<,-9.666666666666668,0,0,=,0,27,56,<,-29,45.333333333333336,49.666666666666664,<,-4.333333333333329,34,37,<,-3,58,58,=,0,92,69,>,23
0,11,18.666666666666668,9.0,>,9.666666666666668,0,0,=,0,56,27,>,29,49.666666666666664,45.333333333333336,>,4.333333333333329,37,34,>,3,58,58,=,0,69,92,<,-23
0,11,9.0,20.0,<,-11.0,0,0,=,0,27,60,<,-33,45.333333333333336,40.666666666666664,>,4.666666666666671,34,31,>,3,58,55,>,3,92,125,<,-33
6,11,20.0,9.0,>,11.0,0,0,=,0,60,27,>,33,40.666666666666664,45.333333333333336,<,-4.666666666666671,31,34,<,-3,55,58,<,-3,125,92,>,33
0,11,9.0,12.0,<,-3.0,0,0,=,0,27,36,<,-9,45.333333333333336,42.666666666666664,>,2.6666666666666714,34,30,>,4,58,59,<,-1,92,141,<,-49
22,11,12.0,9.0,>,3.0,0,0,=,0,36,27,>,9,42.666666666666664,45.333333333333336,<,-2.6666666666666714,30,34,<,-4,59,58,>,1,141,92,>,49
0,11,9.0,5.0,>,4.0,0,0,=,0,27,15,>,12,45.333333333333336,39.666666666666664,>,5.666666666666671,34,32,>,2,58,51,>,7,92,66,>,26
0,11,5.0,9.0,<,-4.0,0,0,=,0,15,27,<,-12,39.666666666666664,45.333333333333336,<,-5.666666666666671,32,34,<,-2,51,58,<,-7,66,92,<,-26
0,11,9.0,3.6666666666666665,>,5.333333333333334,0,0,=,0,27,11,>,16,45.333333333333336,49.0,<,-3.6666666666666643,34,41,<,-7,58,55,>,3,92,160,<,-68
41,11,3.6666666666666665,9.0,<,-5.333333333333334,0,0,=,0,11,27,<,-16,49.0,45.333333333333336,>,3.6666666666666643,41,34,>,7,55,58,<,-3,160,92,>,68
0,11,9.0,18.0,<,-9.0,0,0,=,0,27,54,<,-27,45.333333333333336,51.333333333333336,<,-6.0,34,37,<,-3,58,60,<,-2,92,137,<,-45
56,11,18.0,9.0,>,9.0,0,0,=,0,54,27,>,27,51.333333333333336,45.333333333333336,>,6.0,37,34,>,3,60,58,>,2,137,92,>,45
0,11,9.0,5.0,>,4.0,0,0,=,0,27,15,>,12,45.333333333333336,44.0,>,1.3333333333333357,34,32,>,2,58,56,>,2,92,180,<,-88
40,11,5.0,9.0,<,-4.0,0,0,=,0,15,27,<,-12,44.0,45.333333333333336,<,-1.3333333333333357,32,34,<,-2,56,58,<,-2,180,92,>,88
0,11,9.0,3.3333333333333335,>,5.666666666666666,0,0,=,0,27,10,>,17,45.333333333333336,48.333333333333336,<,-3.0,34,45,<,-11,58,54,>,4,92,175,<,-83
65,11,3.3333333333333335,9.0,<,-5.666666666666666,0,0,=,0,10,27,<,-17,48.333333333333336,45.333333333333336,>,3.0,45,34,>,11,54,58,<,-4,175,92,>,83
0,11,9.0,3.6666666666666665,>,5.333333333333334,0,0,=,0,27,11,>,16,45.333333333333336,45.666666666666664,<,-0.3333333333333286,34,34,=,0,58,55,>,3,92,154,<,-62
49,11,3.6666666666666665,9.0,<,-5.333333333333334,0,0,=,0,11,27,<,-16,45.666666666666664,45.333333333333336,>,0.3333333333333286,34,34,=,0,55,58,<,-3,154,92,>,62
0,11,9.0,25.666666666666668,<,-16.666666666666668,0,0,=,0,27,77,<,-50,45.333333333333336,42.0,>,3.3333333333333357,34,32,>,2,58,53,>,5,92,165,<,-73
97,11,25.666666666666668,9.0,>,16.666666666666668,0,0,=,0,77,27,>,50,42.0,45.333333333333336,<,-3.3333333333333357,32,34,<,-2,53,58,<,-5,165,92,>,73
0,10,22.666666666666668,41.333333333333336,<,-18.666666666666668,0,0,=,0,53,68,<,-15,39.666666666666664,49.666666666666664,<,-10.0,32,37,<,-5,51,58,<,-7,66,69,<,-3
0,10,41.333333333333336,22.666666666666668,>,18.666666666666668,0,0,=,0,68,53,>,15,49.666666666666664,39.666666666666664,>,10.0,37,32,>,5,58,51,>,7,69,66,>,3
0,10,22.666666666666668,24.0,<,-1.3333333333333321,0,0,=,0,53,60,<,-7,39.666666666666664,40.666666666666664,<,-1.0,32,31,>,1,51,55,<,-4,66,125,<,-59
0,10,24.0,22.666666666666668,>,1.3333333333333321,0,0,=,0,60,53,>,7,40.666666666666664,39.666666666666664,>,1.0,31,32,<,-1,55,51,>,4,125,66,>,59
0,10,22.666666666666668,34.333333333333336,<,-11.666666666666668,0,0,=,0,53,67,<,-14,39.666666666666664,42.666666666666664,<,-3.0,32,30,>,2,51,59,<,-8,66,141,<,-75
22,10,34.333333333333336,22.666666666666668,>,11.666666666666668,0,0,=,0,67,53,>,14,42.666666666666664,39.666666666666664,>,3.0,30,32,<,-2,59,51,>,8,141,66,>,75
0,10,22.666666666666668,33.333333333333336,<,-10.666666666666668,0,0,=,0,53,85,<,-32,39.666666666666664,44.0,<,-4.333333333333336,32,32,=,0,51,56,<,-5,66,180,<,-114
40,10,33.333333333333336,22.666666666666668,>,10.666666666666668,0,0,=,0,85,53,>,32,44.0,39.666666666666664,>,4.333333333333336,32,32,=,0,56,51,>,5,180,66,>,114
0,10,22.666666666666668,19.666666666666668,>,3.0,0,0,=,0,53,48,>,5,39.666666666666664,49.0,<,-9.333333333333336,32,41,<,-9,51,55,<,-4,66,160,<,-94
56,10,19.666666666666668,22.666666666666668,<,-3.0,0,0,=,0,48,53,<,-5,49.0,39.666666666666664,>,9.333333333333336,41,32,>,9,55,51,>,4,160,66,>,94
0,10,22.666666666666668,16.666666666666668,>,6.0,0,0,=,0,53,39,>,14,39.666666666666664,45.666666666666664,<,-6.0,32,34,<,-2,51,55,<,-4,66,154,<,-88
49,10,16.666666666666668,22.666666666666668,<,-6.0,0,0,=,0,39,53,<,-14,45.666666666666664,39.666666666666664,>,6.0,34,32,>,2,55,51,>,4,154,66,>,88
0,10,22.666666666666668,27.333333333333332,<,-4.666666666666664,0,0,=,0,53,54,<,-1,39.666666666666664,51.333333333333336,<,-11.666666666666671,32,37,<,-5,51,60,<,-9,66,137,<,-71
10,10,27.333333333333332,22.666666666666668,>,4.666666666666664,0,0,=,0,54,53,>,1,51.333333333333336,39.666666666666664,>,11.666666666666671,37,32,>,5,60,51,>,9,137,66,>,71
0,10,22.666666666666668,12.333333333333334,>,10.333333333333334,0,0,=,0,53,27,>,26,39.666666666666664,48.333333333333336,<,-8.666666666666671,32,45,<,-13,51,54,<,-3,66,175,<,-109
59,10,12.333333333333334,22.666666666666668,<,-10.333333333333334,0,0,=,0,27,53,<,-26,48.333333333333336,39.666666666666664,>,8.666666666666671,45,32,>,13,54,51,>,3,175,66,>,109
0,10,22.666666666666668,48.666666666666664,<,-25.999999999999996,0,0,=,0,53,77,<,-24,39.666666666666664,42.0,<,-2.3333333333333357,32,32,=,0,51,53,<,-2,66,165,<,-99
97,10,48.666666666666664,22.666666666666668,>,25.999999999999996,0,0,=,0,77,53,>,24,42.0,39.666666666666664,>,2.3333333333333357,32,32,=,0,53,51,>,2,165,66,>,99
0,9,23.0,29.0,<,-6.0,0,0,=,0,57,68,<,-11,40.666666666666664,49.666666666666664,<,-9.0,31,37,<,-6,55,58,<,-3,125,69,>,56
0,9,29.0,23.0,>,6.0,0,0,=,0,68,57,>,11,49.666666666666664,40.666666666666664,>,9.0,37,31,>,6,58,55,>,3,69,125,<,-56
0,9,23.0,22.0,>,1.0,0,0,=,0,57,38,>,19,40.666666666666664,51.333333333333336,<,-10.666666666666671,31,37,<,-6,55,60,<,-5,125,137,<,-12
10,9,22.0,23.0,<,-1.0,0,0,=,0,38,57,<,-19,51.333333333333336,40.666666666666664,>,10.666666666666671,37,31,>,6,60,55,>,5,137,125,>,12
0,9,23.0,49.0,<,-26.0,0,0,=,0,57,80,<,-23,40.666666666666664,42.666666666666664,<,-2.0,31,30,>,1,55,59,<,-4,125,141,<,-16
22,9,49.0,23.0,>,26.0,0,0,=,0,80,57,>,23,42.666666666666664,40.666666666666664,>,2.0,30,31,<,-1,59,55,>,4,141,125,>,16
0,9,23.0,58.333333333333336,<,-35.333333333333336,0,0,=,0,57,90,<,-33,40.666666666666664,44.0,<,-3.3333333333333357,31,32,<,-1,55,56,<,-1,125,180,<,-55
66,9,58.333333333333336,23.0,>,35.333333333333336,0,0,=,0,90,57,>,33,44.0,40.666666666666664,>,3.3333333333333357,32,31,>,1,56,55,>,1,180,125,>,55
0,9,23.0,43.0,<,-20.0,0,0,=,0,57,90,<,-33,40.666666666666664,45.666666666666664,<,-5.0,31,34,<,-3,55,55,=,0,125,154,<,-29
101,9,43.0,23.0,>,20.0,0,0,=,0,90,57,>,33,45.666666666666664,40.666666666666664,>,5.0,34,31,>,3,55,55,=,0,154,125,>,29
0,9,23.0,29.333333333333332,<,-6.333333333333332,0,0,=,0,57,48,>,9,40.666666666666664,49.0,<,-8.333333333333336,31,41,<,-10,55,55,=,0,125,160,<,-35
64,9,29.333333333333332,23.0,>,6.333333333333332,0,0,=,0,48,57,<,-9,49.0,40.666666666666664,>,8.333333333333336,41,31,>,10,55,55,=,0,160,125,>,35
0,9,23.0,19.666666666666668,>,3.333333333333332,0,0,=,0,57,32,>,25,40.666666666666664,48.333333333333336,<,-7.666666666666671,31,45,<,-14,55,54,>,1,125,175,<,-50
24,9,19.666666666666668,23.0,<,-3.333333333333332,0,0,=,0,32,57,<,-25,48.333333333333336,40.666666666666664,>,7.666666666666671,45,31,>,14,54,55,<,-1,175,125,>,50
0,9,23.0,30.0,<,-7.0,0,0,=,0,57,69,<,-12,40.666666666666664,42.0,<,-1.3333333333333357,31,32,<,-1,55,53,>,2,125,165,<,-40
0,9,30.0,23.0,>,7.0,0,0,=,0,69,57,>,12,42.0,40.666666666666664,>,1.3333333333333357,32,31,>,1,53,55,<,-2,165,125,>,40
0,8,16.333333333333332,19.333333333333332,<,-3.0,0,0,=,0,30,37,<,-7,49.666666666666664,42.0,>,7.666666666666664,37,32,>,5,58,53,>,5,69,165,<,-96
0,8,19.333333333333332,16.333333333333332,>,3.0,0,0,=,0,37,30,>,7,42.0,49.666666666666664,<,-7.666666666666664,32,37,<,-5,53,58,<,-5,165,69,>,96
0,8,16.333333333333332,22.0,<,-5.666666666666668,0,0,=,0,30,38,<,-8,49.666666666666664,51.333333333333336,<,-1.6666666666666714,37,37,=,0,58,60,<,-2,69,137,<,-68
0,8,22.0,16.333333333333332,>,5.666666666666668,0,0,=,0,38,30,>,8,51.333333333333336,49.666666666666664,>,1.6666666666666714,37,37,=,0,60,58,>,2,137,69,>,68
0,8,16.333333333333332,46.0,<,-29.666666666666668,0,0,=,0,30,80,<,-50,49.666666666666664,42.666666666666664,>,7.0,37,30,>,7,58,59,<,-1,69,141,<,-72
22,8,46.0,16.333333333333332,>,29.666666666666668,0,0,=,0,80,30,>,50,42.666666666666664,49.666666666666664,<,-7.0,30,37,<,-7,59,58,>,1,141,69,>,72
0,8,16.333333333333332,23.666666666666668,<,-7.333333333333336,0,0,=,0,30,39,<,-9,49.666666666666664,48.333333333333336,>,1.3333333333333286,37,45,<,-8,58,54,>,4,69,175,<,-106
24,8,23.666666666666668,16.333333333333332,>,7.333333333333336,0,0,=,0,39,30,>,9,48.333333333333336,49.666666666666664,<,-1.3333333333333286,45,37,>,8,54,58,<,-4,175,69,>,106
0,8,16.333333333333332,30.666666666666668,<,-14.333333333333336,0,0,=,0,30,52,<,-22,49.666666666666664,49.0,>,0.6666666666666643,37,41,<,-4,58,55,>,3,69,160,<,-91
68,8,30.666666666666668,16.333333333333332,>,14.333333333333336,0,0,=,0,52,30,>,22,49.0,49.666666666666664,<,-0.6666666666666643,41,37,>,4,55,58,<,-3,160,69,>,91
0,8,16.333333333333332,57.333333333333336,<,-41.0,0,0,=,0,30,90,<,-60,49.666666666666664,44.0,>,5.666666666666664,37,32,>,5,58,56,>,2,69,180,<,-111
66,8,57.333333333333336,16.333333333333332,>,41.0,0,0,=,0,90,30,>,60,44.0,49.666666666666664,<,-5.666666666666664,32,37,<,-5,56,58,<,-2,180,69,>,111
0,8,16.333333333333332,52.0,<,-35.66666666666667,0,0,=,0,30,90,<,-60,49.666666666666664,45.666666666666664,>,4.0,37,34,>,3,58,55,>,3,69,154,<,-85
101,8,52.0,16.333333333333332,>,35.66666666666667,0,0,=,0,90,30,>,60,45.666666666666664,49.666666666666664,<,-4.0,34,37,<,-3,55,58,<,-3,154,69,>,85
0,7,34.666666666666664,48.0,<,-13.333333333333336,28,21,>,7,38,86,<,-48,51.333333333333336,42.0,>,9.333333333333336,37,32,>,5,60,53,>,7,137,165,<,-28
0,7,48.0,34.666666666666664,>,13.333333333333336,21,28,<,-7,86,38,>,48,42.0,51.333333333333336,<,-9.333333333333336,32,37,<,-5,53,60,<,-7,165,137,>,28
0,7,34.666666666666664,62.333333333333336,<,-27.66666666666667,28,49,<,-21,38,80,<,-42,51.333333333333336,42.666666666666664,>,8.666666666666671,37,30,>,7,60,59,>,1,137,141,<,-4
0,7,62.333333333333336,34.666666666666664,>,27.66666666666667,49,28,>,21,80,38,>,42,42.666666666666664,51.333333333333336,<,-8.666666666666671,30,37,<,-7,59,60,<,-1,141,137,>,4
0,7,34.666666666666664,27.0,>,7.666666666666664,28,10,>,18,38,39,<,-1,51.333333333333336,48.333333333333336,>,3.0,37,45,<,-8,60,54,>,6,137,175,<,-38
24,7,27.0,34.666666666666664,<,-7.666666666666664,10,28,<,-18,39,38,>,1,48.333333333333336,51.333333333333336,<,-3.0,45,37,>,8,54,60,<,-6,175,137,>,38
0,7,34.666666666666664,72.33333333333333,<,-37.666666666666664,28,45,<,-17,38,90,<,-52,51.333333333333336,44.0,>,7.333333333333336,37,32,>,5,60,56,>,4,137,180,<,-43
104,7,72.33333333333333,34.666666666666664,>,37.666666666666664,45,28,>,17,90,38,>,52,44.0,51.333333333333336,<,-7.333333333333336,32,37,<,-5,56,60,<,-4,180,137,>,43
0,7,34.666666666666664,43.666666666666664,<,-9.0,28,39,<,-11,38,52,<,-14,51.333333333333336,49.0,>,2.3333333333333357,37,41,<,-4,60,55,>,5,137,160,<,-23
65,7,43.666666666666664,34.666666666666664,>,9.0,39,28,>,11,52,38,>,14,49.0,51.333333333333336,<,-2.3333333333333357,41,37,>,4,55,60,<,-5,160,137,>,23
0,7,34.666666666666664,70.66666666666667,<,-36.00000000000001,28,56,<,-28,38,90,<,-52,51.333333333333336,45.666666666666664,>,5.666666666666671,37,34,>,3,60,55,>,5,137,154,<,-17
66,7,70.66666666666667,34.666666666666664,>,36.00000000000001,56,28,>,28,90,38,>,52,45.666666666666664,51.333333333333336,<,-5.666666666666671,34,37,<,-3,55,60,<,-5,154,137,>,17
0,6,56.666666666666664,55.0,>,1.6666666666666643,41,21,>,20,80,86,<,-6,42.666666666666664,42.0,>,0.6666666666666643,30,32,<,-2,59,53,>,6,141,165,<,-24
0,6,55.0,56.666666666666664,<,-1.6666666666666643,21,41,<,-20,86,80,>,6,42.0,42.666666666666664,<,-0.6666666666666643,32,30,>,2,53,59,<,-6,165,141,>,24
0,6,56.666666666666664,39.0,>,17.666666666666664,41,10,>,31,80,75,>,5,42.666666666666664,48.333333333333336,<,-5.666666666666671,30,45,<,-15,59,54,>,5,141,175,<,-34
24,6,39.0,56.666666666666664,<,-17.666666666666664,10,41,<,-31,75,80,<,-5,48.333333333333336,42.666666666666664,>,5.666666666666671,45,30,>,15,54,59,<,-5,175,141,>,34
0,6,56.666666666666664,32.0,>,24.666666666666664,41,17,>,24,80,40,>,40,42.666666666666664,49.0,<,-6.333333333333336,30,41,<,-11,59,55,>,4,141,160,<,-19
0,6,32.0,56.666666666666664,<,-24.666666666666664,17,41,<,-24,40,80,<,-40,49.0,42.666666666666664,>,6.333333333333336,41,30,>,11,55,59,<,-4,160,141,>,19
0,6,56.666666666666664,52.0,>,4.666666666666664,41,10,>,31,80,90,<,-10,42.666666666666664,45.666666666666664,<,-3.0,30,34,<,-4,59,55,>,4,141,154,<,-13
40,6,52.0,56.666666666666664,<,-4.666666666666664,10,41,<,-31,90,80,>,10,45.666666666666664,42.666666666666664,>,3.0,34,30,>,4,55,59,<,-4,154,141,>,13
0,6,56.666666666666664,69.66666666666667,<,-13.000000000000007,41,45,<,-4,80,90,<,-10,42.666666666666664,44.0,<,-1.3333333333333357,30,32,<,-2,59,56,>,3,141,180,<,-39
44,6,69.66666666666667,56.666666666666664,>,13.000000000000007,45,41,>,4,90,80,>,10,44.0,42.666666666666664,>,1.3333333333333357,32,30,>,2,56,59,<,-3,180,141,>,39
0,5,25.666666666666668,38.666666666666664,<,-12.999999999999996,17,21,<,-4,40,58,<,-18,49.0,42.0,>,7.0,41,32,>,9,55,53,>,2,160,165,<,-5
0,5,38.666666666666664,25.666666666666668,>,12.999999999999996,21,17,>,4,58,40,>,18,42.0,49.0,<,-7.0,32,41,<,-9,53,55,<,-2,165,160,>,5
0,5,25.666666666666668,45.0,<,-19.333333333333332,17,28,<,-11,40,75,<,-35,49.0,48.333333333333336,>,0.6666666666666643,41,45,<,-4,55,54,>,1,160,175,<,-15
0,5,45.0,25.666666666666668,>,19.333333333333332,28,17,>,11,75,40,>,35,48.333333333333336,49.0,<,-0.6666666666666643,45,41,>,4,54,55,<,-1,175,160,>,15
0,5,25.666666666666668,43.666666666666664,<,-17.999999999999996,17,10,>,7,40,90,<,-50,49.0,45.666666666666664,>,3.3333333333333357,41,34,>,7,55,55,=,0,160,154,>,6
40,5,43.666666666666664,25.666666666666668,>,17.999999999999996,10,17,<,-7,90,40,>,50,45.666666666666664,49.0,<,-3.3333333333333357,34,41,<,-7,55,55,=,0,154,160,<,-6
0,5,25.666666666666668,59.0,<,-33.33333333333333,17,13,>,4,40,90,<,-50,49.0,44.0,>,5.0,41,32,>,9,55,56,<,-1,160,180,<,-20
14,5,59.0,25.666666666666668,>,33.33333333333333,13,17,<,-4,90,40,>,50,44.0,49.0,<,-5.0,32,41,<,-9,56,55,>,1,180,160,>,20
0,4,38.0,27.0,>,11.0,28,21,>,7,54,37,>,17,48.333333333333336,42.0,>,6.333333333333336,45,32,>,13,54,53,>,1,175,165,>,10
0,4,27.0,38.0,<,-11.0,21,28,<,-7,37,54,<,-17,42.0,48.333333333333336,<,-6.333333333333336,32,45,<,-13,53,54,<,-1,165,175,<,-10
0,4,38.0,43.333333333333336,<,-5.333333333333336,28,13,>,15,54,90,<,-36,48.333333333333336,44.0,>,4.333333333333336,45,32,>,13,54,56,<,-2,175,180,<,-5
0,4,43.333333333333336,38.0,>,5.333333333333336,13,28,<,-15,90,54,>,36,44.0,48.333333333333336,<,-4.333333333333336,32,45,<,-13,56,54,>,2,180,175,>,5
0,4,38.0,64.0,<,-26.0,28,31,<,-3,54,90,<,-36,48.333333333333336,45.666666666666664,>,2.6666666666666714,45,34,>,11,54,55,<,-1,175,154,>,21
42,4,64.0,38.0,>,26.0,31,28,>,3,90,54,>,36,45.666666666666664,48.333333333333336,<,-2.6666666666666714,34,45,<,-11,55,54,>,1,154,175,<,-21
0,3,54.666666666666664,39.666666666666664,>,15.0,27,21,>,6,90,75,>,15,44.0,42.0,>,2.0,32,32,=,0,56,53,>,3,180,165,>,15
0,3,39.666666666666664,54.666666666666664,<,-15.0,21,27,<,-6,75,90,<,-15,42.0,44.0,<,-2.0,32,32,=,0,53,56,<,-3,165,180,<,-15
0,3,54.666666666666664,71.0,<,-16.333333333333336,27,52,<,-25,90,90,=,0,44.0,45.666666666666664,<,-1.6666666666666643,32,34,<,-2,56,55,>,1,180,154,>,26
72,3,71.0,54.666666666666664,>,16.333333333333336,52,27,>,25,90,90,=,0,45.666666666666664,44.0,>,1.6666666666666643,34,32,>,2,55,56,<,-1,154,180,<,-26
0,2,37.333333333333336,63.0,<,-25.666666666666664,16,47,<,-31,75,90,<,-15,42.0,45.666666666666664,<,-3.6666666666666643,32,34,<,-2,53,55,<,-2,165,154,>,11
102,2,63.0,37.333333333333336,>,25.666666666666664,47,16,>,31,90,75,>,15,45.666666666666664,42.0,>,3.6666666666666643,34,32,>,2,55,53,>,2,154,165,<,-11
0,20,0.0,0.0,=,0.0,0,0,=,0,0,0,=,0,42.0,49.333333333333336,<,-7.333333333333336,35,41,<,-6,47,58,<,-11,157,167,<,-10
91,20,0.0,0.0,=,0.0,0,0,=,0,0,0,=,0,49.333333333333336,42.0,>,7.333333333333336,41,35,>,6,58,47,>,11,167,157,>,10
0,20,0.0,0.0,=,0.0,0,0,=,0,0,0,=,0,42.0,40.0,>,2.0,35,30,>,5,47,46,>,1,157,287,<,-130
148,20,0.0,0.0,=,0.0,0,0,=,0,0,0,=,0,40.0,42.0,<,-2.0,30,35,<,-5,46,47,<,-1,287,157,>,130
0,20,0.0,0.0,=,0.0,0,0,=,0,0,0,=,0,42.0,43.666666666666664,<,-1.6666666666666643,35,32,>,3,47,58,<,-11,157,196,<,-39
120,20,0.0,0.0,=,0.0,0,0,=,0,0,0,=,0,43.666666666666664,42.0,>,1.6666666666666643,32,35,<,-3,58,47,>,11,196,157,>,39
0,20,0.0,0.0,=,0.0,0,0,=,0,0,0,=,0,42.0,51.0,<,-9.0,35,45,<,-10,47,54,<,-7,157,136,>,21
54,20,0.0,0.0,=,0.0,0,0,=,0,0,0,=,0,51.0,42.0,>,9.0,45,35,>,10,54,47,>,7,136,157,<,-21
0,20,0.0,0.0,=,0.0,0,0,=,0,0,0,=,0,42.0,50.666666666666664,<,-8.666666666666664,35,39,<,-4,47,58,<,-11,157,196,<,-39
85,20,0.0,0.0,=,0.0,0,0,=,0,0,0,=,0,50.666666666666664,42.0,>,8.666666666666664,39,35,>,4,58,47,>,11,196,157,>,39
0,20,0.0,0.0,=,0.0,0,0,=,0,0,0,=,0,42.0,46.666666666666664,<,-4.666666666666664,35,30,>,5,47,60,<,-13,157,270,<,-113
130,20,0.0,0.0,=,0.0,0,0,=,0,0,0,=,0,46.666666666666664,42.0,>,4.666666666666664,30,35,<,-5,60,47,>,13,270,157,>,113
0,20,0.0,0.0,=,0.0,0,0,=,0,0,0,=,0,42.0,46.0,<,-4.0,35,31,>,4,47,54,<,-7,157,147,>,10
232,20,0.0,0.0,=,0.0,0,0,=,0,0,0,=,0,46.0,42.0,>,4.0,31,35,<,-4,54,47,>,7,147,157,<,-10
0,20,0.0,0.0,=,0.0,0,0,=,0,0,0,=,0,42.0,48.333333333333336,<,-6.333333333333336,35,38,<,-3,47,59,<,-12,157,312,<,-155
130,20,0.0,0.0,=,0.0,0,0,=,0,0,0,=,0,48.333333333333336,42.0,>,6.333333333333336,38,35,>,3,59,47,>,12,312,157,>,155
0,20,0.0,0.0,=,0.0,0,0,=,0,0,0,=,0,42.0,46.666666666666664,<,-4.666666666666664,35,40,<,-5,47,57,<,-10,157,167,<,-10
37,20,0.0,0.0,=,0.0,0,0,=,0,0,0,=,0,46.666666666666664,42.0,>,4.666666666666664,40,35,>,5,57,47,>,10,167,157,>,10
0,20,0.0,0.0,=,0.0,0,0,=,0,0,0,=,0,42.0,49.666666666666664,<,-7.666666666666664,35,38,<,-3,47,59,<,-12,157,227,<,-70
81,20,0.0,0.0,=,0.0,0,0,=,0,0,0,=,0,49.666666666666664,42.0,>,7.666666666666664,38,35,>,3,59,47,>,12,227,157,>,70
0,20,0.0,0.0,=,0.0,0,0,=,0,0,0,=,0,42.0,37.666666666666664,>,4.333333333333336,35,32,>,3,47,47,=,0,157,298,<,-141
151,20,0.0,0.0,=,0.0,0,0,=,0,0,0,=,0,37.666666666666664,42.0,<,-4.333333333333336,32,35,<,-3,47,47,=,0,298,157,>,141
0,20,0.0,0.0,=,0.0,0,0,=,0,0,0,=,0,42.0,51.0,<,-9.0,35,44,<,-9,47,59,<,-12,157,116,>,41
52,20,0.0,0.0,=,0.0,0,0,=,0,0,0,=,0,51.0,42.0,>,9.0,44,35,>,9,59,47,>,12,116,157,<,-41
0,20,0.0,0.0,=,0.0,0,0,=,0,0,0,=,0,42.0,43.0,<,-1.0,35,30,>,5,47,59,<,-12,157,297,<,-140
120,20,0.0,0.0,=,0.0,0,0,=,0,0,0,=,0,43.0,42.0,>,1.0,30,35,<,-5,59,47,>,12,297,157,>,140
0,20,0.0,0.0,=,0.0,0,0,=,0,0,0,=,0,42.0,39.0,>,3.0,35,34,>,1,47,45,>,2,157,316,<,-159
155,20,0.0,0.0,=,0.0,0,0,=,0,0,0,=,0,39.0,42.0,<,-3.0,34,35,<,-1,45,47,<,-2,316,157,>,159
0,20,0.0,0.0,=,0.0,0,0,=,0,0,0,=,0,42.0,45.0,<,-3.0,35,42,<,-7,47,49,<,-2,157,160,<,-3
54,20,0.0,0.0,=,0.0,0,0,=,0,0,0,=,0,45.0,42.0,>,3.0,42,35,>,7,49,47,>,2,160,157,>,3
0,20,0.0,0.0,=,0.0,0,0,=,0,0,0,=,0,42.0,44.0,<,-2.0,35,31,>,4,47,52,<,-5,157,280,<,-123
184,20,0.0,0.0,=,0.0,0,0,=,0,0,0,=,0,44.0,42.0,>,2.0,31,35,<,-4,52,47,>,5,280,157,>,123
0,20,0.0,0.0,=,0.0,0,0,=,0,0,0,=,0,42.0,44.666666666666664,<,-2.6666666666666643,35,41,<,-6,47,51,<,-4,157,210,<,-53
102,20,0.0,0.0,=,0.0,0,0,=,0,0,0,=,0,44.666666666666664,42.0,>,2.6666666666666643,41,35,>,6,51,47,>,4,210,157,>,53
0,20,0.0,0.0,=,0.0,0,0,=,0,0,0,=,0,42.0,44.333333333333336,<,-2.3333333333333357,35,34,>,1,47,54,<,-7,157,211,<,-54
85,20,0.0,0.0,=,0.0,0,0,=,0,0,0,=,0,44.333333333333336,42.0,>,2.3333333333333357,34,35,<,-1,54,47,>,7,211,157,>,54
0,20,0.0,0.0,=,0.0,0,0,=,0,0,0,=,0,42.0,44.333333333333336,<,-2.3333333333333357,35,39,<,-4,47,53,<,-6,157,303,<,-146
64,20,0.0,0.0,=,0.0,0,0,=,0,0,0,=,0,44.333333333333336,42.0,>,2.3333333333333357,39,35,>,4,53,47,>,6,303,157,>,146
0,19,5.333333333333333,10.0,<,-4.666666666666667,0,0,=,0,16,30,<,-14,45.0,46.666666666666664,<,-1.6666666666666643,42,40,>,2,49,57,<,-8,160,167,<,-7
38,19,10.0,5.333333333333333,>,4.666666666666667,0,0,=,0,30,16,>,14,46.666666666666664,45.0,>,1.6666666666666643,40,42,<,-2,57,49,>,8,167,160,>,7
0,19,5.333333333333333,12.0,<,-6.666666666666667,0,0,=,0,16,36,<,-20,45.0,51.0,<,-6.0,42,44,<,-2,49,59,<,-10,160,116,>,44
27,19,12.0,5.333333333333333,>,6.666666666666667,0,0,=,0,36,16,>,20,51.0,45.0,>,6.0,44,42,>,2,59,49,>,10,116,160,<,-44
0,19,5.333333333333333,15.666666666666666,<,-10.333333333333332,0,0,=,0,16,47,<,-31,45.0,51.0,<,-6.0,42,45,<,-3,49,54,<,-5,160,136,>,24
85,19,15.666666666666666,5.333333333333333,>,10.333333333333332,0,0,=,0,47,16,>,31,51.0,45.0,>,6.0,45,42,>,3,54,49,>,5,136,160,<,-24
0,19,5.333333333333333,18.333333333333332,<,-13.0,0,0,=,0,16,55,<,-39,45.0,44.333333333333336,>,0.6666666666666643,42,39,>,3,49,53,<,-4,160,303,<,-143
176,19,18.333333333333332,5.333333333333333,>,13.0,0,0,=,0,55,16,>,39,44.333333333333336,45.0,<,-0.6666666666666643,39,42,<,-3,53,49,>,4,303,160,>,143
0,19,5.333333333333333,23.0,<,-17.666666666666668,0,0,=,0,16,69,<,-53,45.0,49.666666666666664,<,-4.666666666666664,42,38,>,4,49,59,<,-10,160,227,<,-67
94,19,23.0,5.333333333333333,>,17.666666666666668,0,0,=,0,69,16,>,53,49.666666666666664,45.0,>,4.666666666666664,38,42,<,-4,59,49,>,10,227,160,>,67
0,19,5.333333333333333,16.333333333333332,<,-11.0,0,0,=,0,16,49,<,-33,45.0,50.666666666666664,<,-5.666666666666664,42,39,>,3,49,58,<,-9,160,196,<,-36
78,19,16.333333333333332,5.333333333333333,>,11.0,0,0,=,0,49,16,>,33,50.666666666666664,45.0,>,5.666666666666664,39,42,<,-3,58,49,>,9,196,160,>,36
0,19,5.333333333333333,13.333333333333334,<,-8.0,0,0,=,0,16,40,<,-24,45.0,44.333333333333336,>,0.6666666666666643,42,34,>,8,49,54,<,-5,160,211,<,-51
36,19,13.333333333333334,5.333333333333333,>,8.0,0,0,=,0,40,16,>,24,44.333333333333336,45.0,<,-0.6666666666666643,34,42,<,-8,54,49,>,5,211,160,>,51
0,19,5.333333333333333,12.0,<,-6.666666666666667,0,0,=,0,16,36,<,-20,45.0,49.333333333333336,<,-4.333333333333336,42,41,>,1,49,58,<,-9,160,167,<,-7
37,19,12.0,5.333333333333333,>,6.666666666666667,0,0,=,0,36,16,>,20,49.333333333333336,45.0,>,4.333333333333336,41,42,<,-1,58,49,>,9,167,160,>,7
0,19,5.333333333333333,7.666666666666667,<,-2.333333333333334,0,0,=,0,16,23,<,-7,45.0,44.666666666666664,>,0.3333333333333357,42,41,>,1,49,51,<,-2,160,210,<,-50
185,19,7.666666666666667,5.333333333333333,>,2.333333333333334,0,0,=,0,23,16,>,7,44.666666666666664,45.0,<,-0.3333333333333357,41,42,<,-1,51,49,>,2,210,160,>,50
0,19,5.333333333333333,19.333333333333332,<,-14.0,0,0,=,0,16,58,<,-42,45.0,43.666666666666664,>,1.3333333333333357,42,32,>,10,49,58,<,-9,160,196,<,-36
111,19,19.333333333333332,5.333333333333333,>,14.0,0,0,=,0,58,16,>,42,43.666666666666664,45.0,<,-1.3333333333333357,32,42,<,-10,58,49,>,9,196,160,>,36
0,19,5.333333333333333,9.333333333333334,<,-4.000000000000001,0,0,=,0,16,28,<,-12,45.0,43.0,>,2.0,42,30,>,12,49,59,<,-10,160,297,<,-137
193,19,9.333333333333334,5.333333333333333,>,4.000000000000001,0,0,=,0,28,16,>,12,43.0,45.0,<,-2.0,30,42,<,-12,59,49,>,10,297,160,>,137
0,19,5.333333333333333,26.0,<,-20.666666666666668,0,0,=,0,16,78,<,-62,45.0,46.666666666666664,<,-1.6666666666666643,42,30,>,12,49,60,<,-11,160,270,<,-110
211,19,26.0,5.333333333333333,>,20.666666666666668,0,0,=,0,78,16,>,62,46.666666666666664,45.0,>,1.6666666666666643,30,42,<,-12,60,49,>,11,270,160,>,110
0,19,5.333333333333333,19.666666666666668,<,-14.333333333333336,0,0,=,0,16,59,<,-43,45.0,48.333333333333336,<,-3.3333333333333357,42,38,>,4,49,59,<,-10,160,312,<,-152
143,19,19.666666666666668,5.333333333333333,>,14.333333333333336,0,0,=,0,59,16,>,43,48.333333333333336,45.0,>,3.3333333333333357,38,42,<,-4,59,49,>,10,312,160,>,152
0,19,5.333333333333333,7.0,<,-1.666666666666667,0,0,=,0,16,21,<,-5,45.0,40.0,>,5.0,42,30,>,12,49,46,>,3,160,287,<,-127
79,19,7.0,5.333333333333333,>,1.666666666666667,0,0,=,0,21,16,>,5,40.0,45.0,<,-5.0,30,42,<,-12,46,49,<,-3,287,160,>,127
0,19,5.333333333333333,29.333333333333332,<,-24.0,0,0,=,0,16,88,<,-72,45.0,37.666666666666664,>,7.333333333333336,42,32,>,10,49,47,>,2,160,298,<,-138
157,19,29.333333333333332,5.333333333333333,>,24.0,0,0,=,0,88,16,>,72,37.666666666666664,45.0,<,-7.333333333333336,32,42,<,-10,47,49,<,-2,298,160,>,138
0,19,5.333333333333333,26.0,<,-20.666666666666668,0,0,=,0,16,78,<,-62,45.0,39.0,>,6.0,42,34,>,8,49,45,>,4,160,316,<,-156
235,19,26.0,5.333333333333333,>,20.666666666666668,0,0,=,0,78,16,>,62,39.0,45.0,<,-6.0,34,42,<,-8,45,49,<,-4,316,160,>,156
0,19,5.333333333333333,12.333333333333334,<,-7.000000000000001,0,0,=,0,16,37,<,-21,45.0,44.0,>,1.0,42,31,>,11,49,52,<,-3,160,280,<,-120
133,19,12.333333333333334,5.333333333333333,>,7.000000000000001,0,0,=,0,37,16,>,21,44.0,45.0,<,-1.0,31,42,<,-11,52,49,>,3,280,160,>,120
0,19,5.333333333333333,14.333333333333334,<,-9.0,0,0,=,0,16,43,<,-27,45.0,46.0,<,-1.0,42,31,>,11,49,54,<,-5,160,147,>,13
164,19,14.333333333333334,5.333333333333333,>,9.0,0,0,=,0,43,16,>,27,46.0,45.0,>,1.0,31,42,<,-11,54,49,>,5,147,160,<,-13
0,18,21.0,22.0,<,-1.0,0,0,=,0,63,66,<,-3,46.666666666666664,51.0,<,-4.333333333333336,40,44,<,-4,57,59,<,-2,167,116,>,51
27,18,22.0,21.0,>,1.0,0,0,=,0,66,63,>,3,51.0,46.666666666666664,>,4.333333333333336,44,40,>,4,59,57,>,2,116,167,<,-51
0,18,21.0,20.333333333333332,>,0.6666666666666679,0,0,=,0,63,61,>,2,46.666666666666664,44.333333333333336,>,2.3333333333333286,40,34,>,6,57,54,>,3,167,211,<,-44
36,18,20.333333333333332,21.0,<,-0.6666666666666679,0,0,=,0,61,63,<,-2,44.333333333333336,46.666666666666664,<,-2.3333333333333286,34,40,<,-6,54,57,<,-3,211,167,>,44
0,18,21.0,3.3333333333333335,>,17.666666666666668,0,0,=,0,63,10,>,53,46.666666666666664,49.333333333333336,<,-2.6666666666666714,40,41,<,-1,57,58,<,-1,167,167,=,0
37,18,3.3333333333333335,21.0,<,-17.666666666666668,0,0,=,0,10,63,<,-53,49.333333333333336,46.666666666666664,>,2.6666666666666714,41,40,>,1,58,57,>,1,167,167,=,0
0,18,21.0,20.333333333333332,>,0.6666666666666679,0,0,=,0,63,61,>,2,46.666666666666664,50.666666666666664,<,-4.0,40,39,>,1,57,58,<,-1,167,196,<,-29
78,18,20.333333333333332,21.0,<,-0.6666666666666679,0,0,=,0,61,63,<,-2,50.666666666666664,46.666666666666664,>,4.0,39,40,<,-1,58,57,>,1,196,167,>,29
0,18,21.0,21.666666666666668,<,-0.6666666666666679,0,0,=,0,63,65,<,-2,46.666666666666664,40.0,>,6.666666666666664,40,30,>,10,57,46,>,11,167,287,<,-120
79,18,21.666666666666668,21.0,>,0.6666666666666679,0,0,=,0,65,63,>,2,40.0,46.666666666666664,<,-6.666666666666664,30,40,<,-10,46,57,<,-11,287,167,>,120
0,18,21.0,18.333333333333332,>,2.666666666666668,0,0,=,0,63,55,>,8,46.666666666666664,51.0,<,-4.333333333333336,40,45,<,-5,57,54,>,3,167,136,>,31
85,18,18.333333333333332,21.0,<,-2.666666666666668,0,0,=,0,55,63,<,-8,51.0,46.666666666666664,>,4.333333333333336,45,40,>,5,54,57,<,-3,136,167,<,-31
0,18,21.0,29.0,<,-8.0,0,0,=,0,63,87,<,-24,46.666666666666664,49.666666666666664,<,-3.0,40,38,>,2,57,59,<,-2,167,227,<,-60
94,18,29.0,21.0,>,8.0,0,0,=,0,87,63,>,24,49.666666666666664,46.666666666666664,>,3.0,38,40,<,-2,59,57,>,2,227,167,>,60
0,18,21.0,19.0,>,2.0,0,0,=,0,63,57,>,6,46.666666666666664,43.666666666666664,>,3.0,40,32,>,8,57,58,<,-1,167,196,<,-29
111,18,19.0,21.0,<,-2.0,0,0,=,0,57,63,<,-6,43.666666666666664,46.666666666666664,<,-3.0,32,40,<,-8,58,57,>,1,196,167,>,29
0,18,21.0,11.666666666666666,>,9.333333333333334,0,0,=,0,63,35,>,28,46.666666666666664,44.0,>,2.6666666666666643,40,31,>,9,57,52,>,5,167,280,<,-113
140,18,11.666666666666666,21.0,<,-9.333333333333334,0,0,=,0,35,63,<,-28,44.0,46.666666666666664,<,-2.6666666666666643,31,40,<,-9,52,57,<,-5,280,167,>,113
0,18,21.0,28.333333333333332,<,-7.333333333333332,0,0,=,0,63,85,<,-22,46.666666666666664,48.333333333333336,<,-1.6666666666666714,40,38,>,2,57,59,<,-2,167,312,<,-145
143,18,28.333333333333332,21.0,>,7.333333333333332,0,0,=,0,85,63,>,22,48.333333333333336,46.666666666666664,>,1.6666666666666714,38,40,<,-2,59,57,>,2,312,167,>,145
0,18,21.0,20.0,>,1.0,0,0,=,0,63,60,>,3,46.666666666666664,37.666666666666664,>,9.0,40,32,>,8,57,47,>,10,167,298,<,-131
164,18,20.0,21.0,<,-1.0,0,0,=,0,60,63,<,-3,37.666666666666664,46.666666666666664,<,-9.0,32,40,<,-8,47,57,<,-10,298,167,>,131
0,18,21.0,8.0,>,13.0,0,0,=,0,63,24,>,39,46.666666666666664,46.0,>,0.6666666666666643,40,31,>,9,57,54,>,3,167,147,>,20
0,18,8.0,21.0,<,-13.0,0,0,=,0,24,63,<,-39,46.0,46.666666666666664,<,-0.6666666666666643,31,40,<,-9,54,57,<,-3,147,167,<,-20
0,18,21.0,5.666666666666667,>,15.333333333333332,0,0,=,0,63,17,>,46,46.666666666666664,44.333333333333336,>,2.3333333333333286,40,39,>,1,57,53,>,4,167,303,<,-136
171,18,5.666666666666667,21.0,<,-15.333333333333332,0,0,=,0,17,63,<,-46,44.333333333333336,46.666666666666664,<,-2.3333333333333286,39,40,<,-1,53,57,<,-4,303,167,>,136
0,18,21.0,5.0,>,16.0,0,0,=,0,63,15,>,48,46.666666666666664,44.666666666666664,>,2.0,40,41,<,-1,57,51,>,6,167,210,<,-43
185,18,5.0,21.0,<,-16.0,0,0,=,0,15,63,<,-48,44.666666666666664,46.666666666666664,<,-2.0,41,40,>,1,51,57,<,-6,210,167,>,43
0,18,21.0,11.333333333333334,>,9.666666666666666,0,0,=,0,63,34,>,29,46.666666666666664,43.0,>,3.6666666666666643,40,30,>,10,57,59,<,-2,167,297,<,-130
193,18,11.333333333333334,21.0,<,-9.666666666666666,0,0,=,0,34,63,<,-29,43.0,46.666666666666664,<,-3.6666666666666643,30,40,<,-10,59,57,>,2,297,167,>,130
0,18,21.0,29.333333333333332,<,-8.333333333333332,0,0,=,0,63,88,<,-25,46.666666666666664,46.666666666666664,=,0.0,40,30,>,10,57,60,<,-3,167,270,<,-103
224,18,29.333333333333332,21.0,>,8.333333333333332,0,0,=,0,88,63,>,25,46.666666666666664,46.666666666666664,=,0.0,30,40,<,-10,60,57,>,3,270,167,>,103
0,18,21.0,10.666666666666666,>,10.333333333333334,0,0,=,0,63,32,>,31,46.666666666666664,39.0,>,7.666666666666664,40,34,>,6,57,45,>,12,167,316,<,-149
178,18,10.666666666666666,21.0,<,-10.333333333333334,0,0,=,0,32,63,<,-31,39.0,46.666666666666664,<,-7.666666666666664,34,40,<,-6,45,57,<,-12,316,167,>,149
0,17,22.0,32.0,<,-10.0,0,0,=,0,42,66,<,-24,46.0,51.0,<,-5.0,31,44,<,-13,54,59,<,-5,147,116,>,31
0,17,32.0,22.0,>,10.0,0,0,=,0,66,42,>,24,51.0,46.0,>,5.0,44,31,>,13,59,54,>,5,116,147,<,-31
0,17,22.0,33.666666666666664,<,-11.666666666666664,0,0,=,0,42,61,<,-19,46.0,44.333333333333336,>,1.6666666666666643,31,34,<,-3,54,54,=,0,147,211,<,-64
138,17,33.666666666666664,22.0,>,11.666666666666664,0,0,=,0,61,42,>,19,44.333333333333336,46.0,<,-1.6666666666666643,34,31,>,3,54,54,=,0,211,147,>,64
0,17,22.0,8.333333333333334,>,13.666666666666666,0,0,=,0,42,15,>,27,46.0,49.333333333333336,<,-3.3333333333333357,31,41,<,-10,54,58,<,-4,147,167,<,-20
0,17,8.333333333333334,22.0,<,-13.666666666666666,0,0,=,0,15,42,<,-27,49.333333333333336,46.0,>,3.3333333333333357,41,31,>,10,58,54,>,4,167,147,>,20
0,17,22.0,35.0,<,-13.0,0,0,=,0,42,61,<,-19,46.0,50.666666666666664,<,-4.666666666666664,31,39,<,-8,54,58,<,-4,147,196,<,-49
20,17,35.0,22.0,>,13.0,0,0,=,0,61,42,>,19,50.666666666666664,46.0,>,4.666666666666664,39,31,>,8,58,54,>,4,196,147,>,49
0,17,22.0,42.666666666666664,<,-20.666666666666664,0,0,=,0,42,65,<,-23,46.0,40.0,>,6.0,31,30,>,1,54,46,>,8,147,287,<,-140
79,17,42.666666666666664,22.0,>,20.666666666666664,0,0,=,0,65,42,>,23,40.0,46.0,<,-6.0,30,31,<,-1,46,54,<,-8,287,147,>,140
0,17,22.0,48.0,<,-26.0,0,0,=,0,42,89,<,-47,46.0,51.0,<,-5.0,31,45,<,-14,54,54,=,0,147,136,>,11
62,17,48.0,22.0,>,26.0,0,0,=,0,89,42,>,47,51.0,46.0,>,5.0,45,31,>,14,54,54,=,0,136,147,<,-11
0,17,22.0,38.666666666666664,<,-16.666666666666664,0,0,=,0,42,87,<,-45,46.0,49.666666666666664,<,-3.6666666666666643,31,38,<,-7,54,59,<,-5,147,227,<,-80
193,17,38.666666666666664,22.0,>,16.666666666666664,0,0,=,0,87,42,>,45,49.666666666666664,46.0,>,3.6666666666666643,38,31,>,7,59,54,>,5,227,147,>,80
0,17,22.0,24.666666666666668,<,-2.666666666666668,0,0,=,0,42,57,<,-15,46.0,43.666666666666664,>,2.3333333333333357,31,32,<,-1,54,58,<,-4,147,196,<,-49
111,17,24.666666666666668,22.0,>,2.666666666666668,0,0,=,0,57,42,>,15,43.666666666666664,46.0,<,-2.3333333333333357,32,31,>,1,58,54,>,4,196,147,>,49
0,17,22.0,39.333333333333336,<,-17.333333333333336,0,0,=,0,42,83,<,-41,46.0,44.0,>,2.0,31,31,=,0,54,52,>,2,147,280,<,-133
133,17,39.333333333333336,22.0,>,17.333333333333336,0,0,=,0,83,42,>,41,44.0,46.0,<,-2.0,31,31,=,0,52,54,<,-2,280,147,>,133
0,17,22.0,48.666666666666664,<,-26.666666666666664,0,0,=,0,42,85,<,-43,46.0,48.333333333333336,<,-2.3333333333333357,31,38,<,-7,54,59,<,-5,147,312,<,-165
112,17,48.666666666666664,22.0,>,26.666666666666664,0,0,=,0,85,42,>,43,48.333333333333336,46.0,>,2.3333333333333357,38,31,>,7,59,54,>,5,312,147,>,165
0,17,22.0,47.333333333333336,<,-25.333333333333336,0,0,=,0,42,82,<,-40,46.0,37.666666666666664,>,8.333333333333336,31,32,<,-1,54,47,>,7,147,298,<,-151
172,17,47.333333333333336,22.0,>,25.333333333333336,0,0,=,0,82,42,>,40,37.666666666666664,46.0,<,-8.333333333333336,32,31,>,1,47,54,<,-7,298,147,>,151
0,17,22.0,18.333333333333332,>,3.666666666666668,0,0,=,0,42,38,>,4,46.0,44.333333333333336,>,1.6666666666666643,31,39,<,-8,54,53,>,1,147,303,<,-156
224,17,18.333333333333332,22.0,<,-3.666666666666668,0,0,=,0,38,42,<,-4,44.333333333333336,46.0,<,-1.6666666666666643,39,31,>,8,53,54,<,-1,303,147,>,156
0,17,22.0,35.0,<,-13.0,0,0,=,0,42,73,<,-31,46.0,39.0,>,7.0,31,34,<,-3,54,45,>,9,147,316,<,-169
191,17,35.0,22.0,>,13.0,0,0,=,0,73,42,>,31,39.0,46.0,<,-7.0,34,31,>,3,45,54,<,-9,316,147,>,169
0,17,22.0,8.666666666666666,>,13.333333333333334,0,0,=,0,42,15,>,27,46.0,44.666666666666664,>,1.3333333333333357,31,41,<,-10,54,51,>,3,147,210,<,-63
212,17,8.666666666666666,22.0,<,-13.333333333333334,0,0,=,0,15,42,<,-27,44.666666666666664,46.0,<,-1.3333333333333357,41,31,>,10,51,54,<,-3,210,147,>,63
0,17,22.0,34.0,<,-12.0,0,0,=,0,42,68,<,-26,46.0,43.0,>,3.0,31,30,>,1,54,59,<,-5,147,297,<,-150
217,17,34.0,22.0,>,12.0,0,0,=,0,68,42,>,26,43.0,46.0,<,-3.0,30,31,<,-1,59,54,>,5,297,147,>,150
0,17,22.0,57.666666666666664,<,-35.666666666666664,0,0,=,0,42,88,<,-46,46.0,46.666666666666664,<,-0.6666666666666643,31,30,>,1,54,60,<,-6,147,270,<,-123
300,17,57.666666666666664,22.0,>,35.666666666666664,0,0,=,0,88,42,>,46,46.666666666666664,46.0,>,0.6666666666666643,30,31,<,-1,60,54,>,6,270,147,>,123
0,16,27.666666666666668,19.333333333333332,>,8.333333333333336,0,0,=,0,68,30,>,38,49.333333333333336,51.0,<,-1.6666666666666643,41,44,<,-3,58,59,<,-1,167,116,>,51
0,16,19.333333333333332,27.666666666666668,<,-8.333333333333336,0,0,=,0,30,68,<,-38,51.0,49.333333333333336,>,1.6666666666666643,44,41,>,3,59,58,>,1,116,167,<,-51
0,16,27.666666666666668,37.333333333333336,<,-9.666666666666668,0,0,=,0,68,68,=,0,49.333333333333336,50.666666666666664,<,-1.3333333333333286,41,39,>,2,58,58,=,0,167,196,<,-29
20,16,37.333333333333336,27.666666666666668,>,9.666666666666668,0,0,=,0,68,68,=,0,50.666666666666664,49.333333333333336,>,1.3333333333333286,39,41,<,-2,58,58,=,0,196,167,>,29
0,16,27.666666666666668,42.333333333333336,<,-14.666666666666668,0,0,=,0,68,89,<,-21,49.333333333333336,51.0,<,-1.6666666666666643,41,45,<,-4,58,54,>,4,167,136,>,31
62,16,42.333333333333336,27.666666666666668,>,14.666666666666668,0,0,=,0,89,68,>,21,51.0,49.333333333333336,>,1.6666666666666643,45,41,>,4,54,58,<,-4,136,167,<,-31
0,16,27.666666666666668,30.333333333333332,<,-2.6666666666666643,0,0,=,0,68,63,>,5,49.333333333333336,40.0,>,9.333333333333336,41,30,>,11,58,46,>,12,167,287,<,-120
79,16,30.333333333333332,27.666666666666668,>,2.6666666666666643,0,0,=,0,63,68,<,-5,40.0,49.333333333333336,<,-9.333333333333336,30,41,<,-11,46,58,<,-12,287,167,>,120
0,16,27.666666666666668,19.666666666666668,>,8.0,0,0,=,0,68,42,>,26,49.333333333333336,43.666666666666664,>,5.666666666666671,41,32,>,9,58,58,=,0,167,196,<,-29
111,16,19.666666666666668,27.666666666666668,<,-8.0,0,0,=,0,42,68,<,-26,43.666666666666664,49.333333333333336,<,-5.666666666666671,32,41,<,-9,58,58,=,0,196,167,>,29
0,16,27.666666666666668,23.666666666666668,>,4.0,0,0,=,0,68,61,>,7,49.333333333333336,48.333333333333336,>,1.0,41,38,>,3,58,59,<,-1,167,312,<,-145
112,16,23.666666666666668,27.666666666666668,<,-4.0,0,0,=,0,61,68,<,-7,48.333333333333336,49.333333333333336,<,-1.0,38,41,<,-3,59,58,>,1,312,167,>,145
0,16,27.666666666666668,52.0,<,-24.333333333333332,0,0,=,0,68,83,<,-15,49.333333333333336,44.0,>,5.333333333333336,41,31,>,10,58,52,>,6,167,280,<,-113
133,16,52.0,27.666666666666668,>,24.333333333333332,0,0,=,0,83,68,>,15,44.0,49.333333333333336,<,-5.333333333333336,31,41,<,-10,52,58,<,-6,280,167,>,113
0,16,27.666666666666668,30.0,<,-2.333333333333332,0,0,=,0,68,50,>,18,49.333333333333336,44.333333333333336,>,5.0,41,34,>,7,58,54,>,4,167,211,<,-44
138,16,30.0,27.666666666666668,>,2.333333333333332,0,0,=,0,50,68,<,-18,44.333333333333336,49.333333333333336,<,-5.0,34,41,<,-7,54,58,<,-4,211,167,>,44
0,16,27.666666666666668,40.333333333333336,<,-12.666666666666668,0,0,=,0,68,82,<,-14,49.333333333333336,37.666666666666664,>,11.666666666666671,41,32,>,9,58,47,>,11,167,298,<,-131
172,16,40.333333333333336,27.666666666666668,>,12.666666666666668,0,0,=,0,82,68,>,14,37.666666666666664,49.333333333333336,<,-11.666666666666671,32,41,<,-9,47,58,<,-11,298,167,>,131
0,16,27.666666666666668,38.666666666666664,<,-10.999999999999996,0,0,=,0,68,73,<,-5,49.333333333333336,39.0,>,10.333333333333336,41,34,>,7,58,45,>,13,167,316,<,-149
191,16,38.666666666666664,27.666666666666668,>,10.999999999999996,0,0,=,0,73,68,>,5,39.0,49.333333333333336,<,-10.333333333333336,34,41,<,-7,45,58,<,-13,316,167,>,149
0,16,27.666666666666668,37.0,<,-9.333333333333332,0,0,=,0,68,82,<,-14,49.333333333333336,49.666666666666664,<,-0.3333333333333286,41,38,>,3,58,59,<,-1,167,227,<,-60
188,16,37.0,27.666666666666668,>,9.333333333333332,0,0,=,0,82,68,>,14,49.666666666666664,49.333333333333336,>,0.3333333333333286,38,41,<,-3,59,58,>,1,227,167,>,60
0,16,27.666666666666668,7.333333333333333,>,20.333333333333336,0,0,=,0,68,11,>,57,49.333333333333336,44.666666666666664,>,4.666666666666671,41,41,=,0,58,51,>,7,167,210,<,-43
0,16,7.333333333333333,27.666666666666668,<,-20.333333333333336,0,0,=,0,11,68,<,-57,44.666666666666664,49.333333333333336,<,-4.666666666666671,41,41,=,0,51,58,<,-7,210,167,>,43
0,16,27.666666666666668,48.333333333333336,<,-20.666666666666668,0,0,=,0,68,77,<,-9,49.333333333333336,43.0,>,6.333333333333336,41,30,>,11,58,59,<,-1,167,297,<,-130
204,16,48.333333333333336,27.666666666666668,>,20.666666666666668,0,0,=,0,77,68,>,9,43.0,49.333333333333336,<,-6.333333333333336,30,41,<,-11,59,58,>,1,297,167,>,130
0,16,27.666666666666668,42.333333333333336,<,-14.666666666666668,0,0,=,0,68,89,<,-21,49.333333333333336,44.333333333333336,>,5.0,41,39,>,2,58,53,>,5,167,303,<,-136
224,16,42.333333333333336,27.666666666666668,>,14.666666666666668,0,0,=,0,89,68,>,21,44.333333333333336,49.333333333333336,<,-5.0,39,41,<,-2,53,58,<,-5,303,167,>,136
0,16,27.666666666666668,34.333333333333336,<,-6.666666666666668,0,0,=,0,68,85,<,-17,49.333333333333336,46.666666666666664,>,2.6666666666666714,41,30,>,11,58,60,<,-2,167,270,<,-103
73,16,34.333333333333336,27.666666666666668,>,6.666666666666668,0,0,=,0,85,68,>,17,46.666666666666664,49.333333333333336,<,-2.6666666666666714,30,41,<,-11,60,58,>,2,270,167,>,103
0,15,46.666666666666664,21.333333333333332,>,25.333333333333332,28,11,>,17,82,42,>,40,51.0,44.666666666666664,>,6.333333333333336,44,41,>,3,59,51,>,8,116,210,<,-94
0,15,21.333333333333332,46.666666666666664,<,-25.333333333333332,11,28,<,-17,42,82,<,-40,44.666666666666664,51.0,<,-6.333333333333336,41,44,<,-3,51,59,<,-8,210,116,>,94
0,15,46.666666666666664,60.333333333333336,<,-13.666666666666671,28,44,<,-16,82,69,>,13,51.0,50.666666666666664,>,0.3333333333333357,44,39,>,5,59,58,>,1,116,196,<,-80
216,15,60.333333333333336,46.666666666666664,>,13.666666666666671,44,28,>,16,69,82,<,-13,50.666666666666664,51.0,<,-0.3333333333333357,39,44,<,-5,58,59,<,-1,196,116,>,80
0,15,46.666666666666664,46.333333333333336,>,0.3333333333333286,28,12,>,16,82,89,<,-7,51.0,51.0,=,0.0,44,45,<,-1,59,54,>,5,116,136,<,-20
0,15,46.333333333333336,46.666666666666664,<,-0.3333333333333286,12,28,<,-16,89,82,>,7,51.0,51.0,=,0.0,45,44,>,1,54,59,<,-5,136,116,>,20
0,15,46.666666666666664,51.333333333333336,<,-4.666666666666671,28,18,>,10,82,85,<,-3,51.0,46.666666666666664,>,4.333333333333336,44,30,>,14,59,60,<,-1,116,270,<,-154
73,15,51.333333333333336,46.666666666666664,>,4.666666666666671,18,28,<,-10,85,82,>,3,46.666666666666664,51.0,<,-4.333333333333336,30,44,<,-14,60,59,>,1,270,116,>,154
0,15,46.666666666666664,41.333333333333336,>,5.333333333333329,28,28,=,0,82,63,>,19,51.0,40.0,>,11.0,44,30,>,14,59,46,>,13,116,287,<,-171
206,15,41.333333333333336,46.666666666666664,<,-5.333333333333329,28,28,=,0,63,82,<,-19,40.0,51.0,<,-11.0,30,44,<,-14,46,59,<,-13,287,116,>,171
0,15,46.666666666666664,27.666666666666668,>,18.999999999999996,28,17,>,11,82,42,>,40,51.0,43.666666666666664,>,7.333333333333336,44,32,>,12,59,58,>,1,116,196,<,-80
226,15,27.666666666666668,46.666666666666664,<,-18.999999999999996,17,28,<,-11,42,82,<,-40,43.666666666666664,51.0,<,-7.333333333333336,32,44,<,-12,58,59,<,-1,196,116,>,80
0,15,46.666666666666664,28.666666666666668,>,17.999999999999996,28,10,>,18,82,61,>,21,51.0,48.333333333333336,>,2.6666666666666643,44,38,>,6,59,59,=,0,116,312,<,-196
155,15,28.666666666666668,46.666666666666664,<,-17.999999999999996,10,28,<,-18,61,82,<,-21,48.333333333333336,51.0,<,-2.6666666666666643,38,44,<,-6,59,59,=,0,312,116,>,196
0,15,46.666666666666664,73.66666666666667,<,-27.000000000000007,28,65,<,-37,82,83,<,-1,51.0,44.0,>,7.0,44,31,>,13,59,52,>,7,116,280,<,-164
274,15,73.66666666666667,46.666666666666664,>,27.000000000000007,65,28,>,37,83,82,>,1,44.0,51.0,<,-7.0,31,44,<,-13,52,59,<,-7,280,116,>,164
0,15,46.666666666666664,43.666666666666664,>,3.0,28,40,<,-12,82,50,>,32,51.0,44.333333333333336,>,6.666666666666664,44,34,>,10,59,54,>,5,116,211,<,-95
206,15,43.666666666666664,46.666666666666664,<,-3.0,40,28,>,12,50,82,<,-32,44.333333333333336,51.0,<,-6.666666666666664,34,44,<,-10,54,59,<,-5,211,116,>,95
0,15,46.666666666666664,48.0,<,-1.3333333333333357,28,23,>,5,82,82,=,0,51.0,37.666666666666664,>,13.333333333333336,44,32,>,12,59,47,>,12,116,298,<,-182
256,15,48.0,46.666666666666664,>,1.3333333333333357,23,28,<,-5,82,82,=,0,37.666666666666664,51.0,<,-13.333333333333336,32,44,<,-12,47,59,<,-12,298,116,>,182
0,15,46.666666666666664,57.333333333333336,<,-10.666666666666671,28,29,<,-1,82,82,=,0,51.0,49.666666666666664,>,1.3333333333333357,44,38,>,6,59,59,=,0,116,227,<,-111
188,15,57.333333333333336,46.666666666666664,>,10.666666666666671,29,28,>,1,82,82,=,0,49.666666666666664,51.0,<,-1.3333333333333357,38,44,<,-6,59,59,=,0,227,116,>,111
0,15,46.666666666666664,42.333333333333336,>,4.333333333333329,28,11,>,17,82,73,>,9,51.0,39.0,>,12.0,44,34,>,10,59,45,>,14,116,316,<,-200
144,15,42.333333333333336,46.666666666666664,<,-4.333333333333329,11,28,<,-17,73,82,<,-9,39.0,51.0,<,-12.0,34,44,<,-10,45,59,<,-14,316,116,>,200
0,15,46.666666666666664,57.0,<,-10.333333333333336,28,26,>,2,82,77,>,5,51.0,43.0,>,8.0,44,30,>,14,59,59,=,0,116,297,<,-181
236,15,57.0,46.666666666666664,>,10.333333333333336,26,28,<,-2,77,82,<,-5,43.0,51.0,<,-8.0,30,44,<,-14,59,59,=,0,297,116,>,181
0,15,46.666666666666664,52.0,<,-5.333333333333336,28,29,<,-1,82,89,<,-7,51.0,44.333333333333336,>,6.666666666666664,44,39,>,5,59,53,>,6,116,303,<,-187
224,15,52.0,46.666666666666664,>,5.333333333333336,29,28,>,1,89,82,>,7,44.333333333333336,51.0,<,-6.666666666666664,39,44,<,-5,53,59,<,-6,303,116,>,187
0,14,39.666666666666664,30.333333333333332,>,9.333333333333332,12,11,>,1,69,42,>,27,51.0,44.666666666666664,>,6.333333333333336,45,41,>,4,54,51,>,3,136,210,<,-74
0,14,30.333333333333332,39.666666666666664,<,-9.333333333333332,11,12,<,-1,42,69,<,-27,44.666666666666664,51.0,<,-6.333333333333336,41,45,<,-4,51,54,<,-3,210,136,>,74
0,14,39.666666666666664,42.333333333333336,<,-2.6666666666666714,12,18,<,-6,69,58,>,11,51.0,46.666666666666664,>,4.333333333333336,45,30,>,15,54,60,<,-6,136,270,<,-134
73,14,42.333333333333336,39.666666666666664,>,2.6666666666666714,18,12,>,6,58,69,<,-11,46.666666666666664,51.0,<,-4.333333333333336,30,45,<,-15,60,54,>,6,270,136,>,134
0,14,39.666666666666664,29.666666666666668,>,9.999999999999996,12,11,>,1,69,43,>,26,51.0,39.0,>,12.0,45,34,>,11,54,45,>,9,136,316,<,-180
144,14,29.666666666666668,39.666666666666664,<,-9.999999999999996,11,12,<,-1,43,69,<,-26,39.0,51.0,<,-12.0,34,45,<,-11,45,54,<,-9,316,136,>,180
0,14,39.666666666666664,27.666666666666668,>,11.999999999999996,12,10,>,2,69,58,>,11,51.0,48.333333333333336,>,2.6666666666666643,45,38,>,7,54,59,<,-5,136,312,<,-176
155,14,27.666666666666668,39.666666666666664,<,-11.999999999999996,10,12,<,-2,58,69,<,-11,48.333333333333336,51.0,<,-2.6666666666666643,38,45,<,-7,59,54,>,5,312,136,>,176
0,14,39.666666666666664,66.0,<,-26.333333333333336,12,55,<,-43,69,82,<,-13,51.0,49.666666666666664,>,1.3333333333333357,45,38,>,7,54,59,<,-5,136,227,<,-91
200,14,66.0,39.666666666666664,>,26.333333333333336,55,12,>,43,82,69,>,13,49.666666666666664,51.0,<,-1.3333333333333357,38,45,<,-7,59,54,>,5,227,136,>,91
0,14,39.666666666666664,35.333333333333336,>,4.333333333333329,12,28,<,-16,69,45,>,24,51.0,40.0,>,11.0,45,30,>,15,54,46,>,8,136,287,<,-151
206,14,35.333333333333336,39.666666666666664,<,-4.333333333333329,28,12,>,16,45,69,<,-24,40.0,51.0,<,-11.0,30,45,<,-15,46,54,<,-8,287,136,>,151
0,14,39.666666666666664,36.0,>,3.6666666666666643,12,17,<,-5,69,50,>,19,51.0,44.333333333333336,>,6.666666666666664,45,34,>,11,54,54,=,0,136,211,<,-75
0,14,36.0,39.666666666666664,<,-3.6666666666666643,17,12,>,5,50,69,<,-19,44.333333333333336,51.0,<,-6.666666666666664,34,45,<,-11,54,54,=,0,211,136,>,75
0,14,39.666666666666664,53.0,<,-13.333333333333336,12,22,<,-10,69,69,=,0,51.0,50.666666666666664,>,0.3333333333333357,45,39,>,6,54,58,<,-4,136,196,<,-60
186,14,53.0,39.666666666666664,>,13.333333333333336,22,12,>,10,69,69,=,0,50.666666666666664,51.0,<,-0.3333333333333357,39,45,<,-6,58,54,>,4,196,136,>,60
0,14,39.666666666666664,52.333333333333336,<,-12.666666666666671,12,29,<,-17,69,89,<,-20,51.0,44.333333333333336,>,6.666666666666664,45,39,>,6,54,53,>,1,136,303,<,-167
136,14,52.333333333333336,39.666666666666664,>,12.666666666666671,29,12,>,17,89,69,>,20,44.333333333333336,51.0,<,-6.666666666666664,39,45,<,-6,53,54,<,-1,303,136,>,167
0,14,39.666666666666664,47.0,<,-7.333333333333336,12,24,<,-12,69,75,<,-6,51.0,43.666666666666664,>,7.333333333333336,45,32,>,13,54,58,<,-4,136,196,<,-60
234,14,47.0,39.666666666666664,>,7.333333333333336,24,12,>,12,75,69,>,6,43.666666666666664,51.0,<,-7.333333333333336,32,45,<,-13,58,54,>,4,196,136,>,60
0,14,39.666666666666664,58.0,<,-18.333333333333336,12,26,<,-14,69,77,<,-8,51.0,43.0,>,8.0,45,30,>,15,54,59,<,-5,136,297,<,-161
236,14,58.0,39.666666666666664,>,18.333333333333336,26,12,>,14,77,69,>,8,43.0,51.0,<,-8.0,30,45,<,-15,59,54,>,5,297,136,>,161
0,14,39.666666666666664,27.0,>,12.666666666666664,12,19,<,-7,69,39,>,30,51.0,37.666666666666664,>,13.333333333333336,45,32,>,13,54,47,>,7,136,298,<,-162
196,14,27.0,39.666666666666664,<,-12.666666666666664,19,12,>,7,39,69,<,-30,37.666666666666664,51.0,<,-13.333333333333336,32,45,<,-13,47,54,<,-7,298,136,>,162
0,14,39.666666666666664,64.66666666666667,<,-25.000000000000007,12,56,<,-44,69,73,<,-4,51.0,44.0,>,7.0,45,31,>,14,54,52,>,2,136,280,<,-144
274,14,64.66666666666667,39.666666666666664,>,25.000000000000007,56,12,>,44,73,69,>,4,44.0,51.0,<,-7.0,31,45,<,-14,52,54,<,-2,280,136,>,144
0,13,21.666666666666668,26.0,<,-4.333333333333332,11,11,=,0,38,50,<,-12,44.666666666666664,44.333333333333336,>,0.3333333333333286,41,34,>,7,51,54,<,-3,210,211,<,-1
0,13,26.0,21.666666666666668,>,4.333333333333332,11,11,=,0,50,38,>,12,44.333333333333336,44.666666666666664,<,-0.3333333333333286,34,41,<,-7,54,51,>,3,211,210,>,1
0,13,21.666666666666668,48.0,<,-26.333333333333332,11,18,<,-7,38,68,<,-30,44.666666666666664,46.666666666666664,<,-2.0,41,30,>,11,51,60,<,-9,210,270,<,-60
73,13,48.0,21.666666666666668,>,26.333333333333332,18,11,>,7,68,38,>,30,46.666666666666664,44.666666666666664,>,2.0,30,41,<,-11,60,51,>,9,270,210,>,60
0,13,21.666666666666668,71.33333333333333,<,-49.66666666666666,11,39,<,-28,38,89,<,-51,44.666666666666664,44.333333333333336,>,0.3333333333333286,41,39,>,2,51,53,<,-2,210,303,<,-93
136,13,71.33333333333333,21.666666666666668,>,49.66666666666666,39,11,>,28,89,38,>,51,44.333333333333336,44.666666666666664,<,-0.3333333333333286,39,41,<,-2,53,51,>,2,303,210,>,93
0,13,21.666666666666668,52.666666666666664,<,-30.999999999999996,11,35,<,-24,38,80,<,-42,44.666666666666664,39.0,>,5.666666666666664,41,34,>,7,51,45,>,6,210,316,<,-106
206,13,52.666666666666664,21.666666666666668,>,30.999999999999996,35,11,>,24,80,38,>,42,39.0,44.666666666666664,<,-5.666666666666664,34,41,<,-7,45,51,<,-6,316,210,>,106
0,13,21.666666666666668,49.0,<,-27.333333333333332,11,10,>,1,38,79,<,-41,44.666666666666664,48.333333333333336,<,-3.6666666666666714,41,38,>,3,51,59,<,-8,210,312,<,-102
217,13,49.0,21.666666666666668,>,27.333333333333332,10,11,<,-1,79,38,>,41,48.333333333333336,44.666666666666664,>,3.6666666666666714,38,41,<,-3,59,51,>,8,312,210,>,102
0,13,21.666666666666668,39.0,<,-17.333333333333332,11,22,<,-11,38,68,<,-30,44.666666666666664,50.666666666666664,<,-6.0,41,39,>,2,51,58,<,-7,210,196,>,14
0,13,39.0,21.666666666666668,>,17.333333333333332,22,11,>,11,68,38,>,30,50.666666666666664,44.666666666666664,>,6.0,39,41,<,-2,58,51,>,7,196,210,<,-14
0,13,21.666666666666668,33.0,<,-11.333333333333332,11,19,<,-8,38,41,<,-3,44.666666666666664,37.666666666666664,>,7.0,41,32,>,9,51,47,>,4,210,298,<,-88
196,13,33.0,21.666666666666668,>,11.333333333333332,19,11,>,8,41,38,>,3,37.666666666666664,44.666666666666664,<,-7.0,32,41,<,-9,47,51,<,-4,298,210,>,88
0,13,21.666666666666668,58.666666666666664,<,-37.0,11,39,<,-28,38,82,<,-44,44.666666666666664,49.666666666666664,<,-5.0,41,38,>,3,51,59,<,-8,210,227,<,-17
187,13,58.666666666666664,21.666666666666668,>,37.0,39,11,>,28,82,38,>,44,49.666666666666664,44.666666666666664,>,5.0,38,41,<,-3,59,51,>,8,227,210,>,17
0,13,21.666666666666668,48.0,<,-26.333333333333332,11,28,<,-17,38,71,<,-33,44.666666666666664,40.0,>,4.666666666666664,41,30,>,11,51,46,>,5,210,287,<,-77
206,13,48.0,21.666666666666668,>,26.333333333333332,28,11,>,17,71,38,>,33,40.0,44.666666666666664,<,-4.666666666666664,30,41,<,-11,46,51,<,-5,287,210,>,77
0,13,21.666666666666668,47.666666666666664,<,-25.999999999999996,11,26,<,-15,38,75,<,-37,44.666666666666664,43.666666666666664,>,1.0,41,32,>,9,51,58,<,-7,210,196,>,14
125,13,47.666666666666664,21.666666666666668,>,25.999999999999996,26,11,>,15,75,38,>,37,43.666666666666664,44.666666666666664,<,-1.0,32,41,<,-9,58,51,>,7,196,210,<,-14
0,13,21.666666666666668,60.0,<,-38.33333333333333,11,32,<,-21,38,77,<,-39,44.666666666666664,43.0,>,1.6666666666666643,41,30,>,11,51,59,<,-8,210,297,<,-87
201,13,60.0,21.666666666666668,>,38.33333333333333,32,11,>,21,77,38,>,39,43.0,44.666666666666664,<,-1.6666666666666643,30,41,<,-11,59,51,>,8,297,210,>,87
0,13,21.666666666666668,66.66666666666667,<,-45.0,11,56,<,-45,38,73,<,-35,44.666666666666664,44.0,>,0.6666666666666643,41,31,>,10,51,52,<,-1,210,280,<,-70
254,13,66.66666666666667,21.666666666666668,>,45.0,56,11,>,45,73,38,>,35,44.0,44.666666666666664,<,-0.6666666666666643,31,41,<,-10,52,51,>,1,280,210,>,70
0,12,23.333333333333332,31.666666666666668,<,-8.333333333333336,21,11,>,10,27,67,<,-40,50.666666666666664,44.333333333333336,>,6.333333333333329,39,34,>,5,58,54,>,4,196,211,<,-15
0,12,31.666666666666668,23.333333333333332,>,8.333333333333336,11,21,<,-10,67,27,>,40,44.333333333333336,50.666666666666664,<,-6.333333333333329,34,39,<,-5,54,58,<,-4,211,196,>,15
0,12,23.333333333333332,49.333333333333336,<,-26.000000000000004,21,22,<,-1,27,68,<,-41,50.666666666666664,46.666666666666664,>,4.0,39,30,>,9,58,60,<,-2,196,270,<,-74
0,12,49.333333333333336,23.333333333333332,>,26.000000000000004,22,21,>,1,68,27,>,41,46.666666666666664,50.666666666666664,<,-4.0,30,39,<,-9,60,58,>,2,270,196,>,74
0,12,23.333333333333332,49.666666666666664,<,-26.333333333333332,21,26,<,-5,27,75,<,-48,50.666666666666664,43.666666666666664,>,7.0,39,32,>,7,58,58,=,0,196,196,=,0
125,12,49.666666666666664,23.333333333333332,>,26.333333333333332,26,21,>,5,75,27,>,48,43.666666666666664,50.666666666666664,<,-7.0,32,39,<,-7,58,58,=,0,196,196,=,0
0,12,23.333333333333332,62.666666666666664,<,-39.33333333333333,21,39,<,-18,27,86,<,-59,50.666666666666664,44.333333333333336,>,6.333333333333329,39,39,=,0,58,53,>,5,196,303,<,-107
126,12,62.666666666666664,23.333333333333332,>,39.33333333333333,39,21,>,18,86,27,>,59,44.333333333333336,50.666666666666664,<,-6.333333333333329,39,39,=,0,53,58,<,-5,303,196,>,107
0,12,23.333333333333332,61.0,<,-37.66666666666667,21,39,<,-18,27,89,<,-62,50.666666666666664,49.666666666666664,>,1.0,39,38,>,1,58,59,<,-1,196,227,<,-31
187,12,61.0,23.333333333333332,>,37.66666666666667,39,21,>,18,89,27,>,62,49.666666666666664,50.666666666666664,<,-1.0,38,39,<,-1,59,58,>,1,227,196,>,31
0,12,23.333333333333332,30.333333333333332,<,-7.0,21,19,>,2,27,41,<,-14,50.666666666666664,37.666666666666664,>,13.0,39,32,>,7,58,47,>,11,196,298,<,-102
141,12,30.333333333333332,23.333333333333332,>,7.0,19,21,<,-2,41,27,>,14,37.666666666666664,50.666666666666664,<,-13.0,32,39,<,-7,47,58,<,-11,298,196,>,102
0,12,23.333333333333332,38.333333333333336,<,-15.000000000000004,21,12,>,9,27,71,<,-44,50.666666666666664,43.0,>,7.666666666666664,39,30,>,9,58,59,<,-1,196,297,<,-101
95,12,38.333333333333336,23.333333333333332,>,15.000000000000004,12,21,<,-9,71,27,>,44,43.0,50.666666666666664,<,-7.666666666666664,30,39,<,-9,59,58,>,1,297,196,>,101
0,12,23.333333333333332,48.666666666666664,<,-25.333333333333332,21,30,<,-9,27,71,<,-44,50.666666666666664,40.0,>,10.666666666666664,39,30,>,9,58,46,>,12,196,287,<,-91
108,12,48.666666666666664,23.333333333333332,>,25.333333333333332,30,21,>,9,71,27,>,44,40.0,50.666666666666664,<,-10.666666666666664,30,39,<,-9,46,58,<,-12,287,196,>,91
0,12,23.333333333333332,65.33333333333333,<,-42.0,21,35,<,-14,27,81,<,-54,50.666666666666664,39.0,>,11.666666666666664,39,34,>,5,58,45,>,13,196,316,<,-120
185,12,65.33333333333333,23.333333333333332,>,42.0,35,21,>,14,81,27,>,54,39.0,50.666666666666664,<,-11.666666666666664,34,39,<,-5,45,58,<,-13,316,196,>,120
0,12,23.333333333333332,54.0,<,-30.666666666666668,21,25,<,-4,27,79,<,-52,50.666666666666664,48.333333333333336,>,2.3333333333333286,39,38,>,1,58,59,<,-1,196,312,<,-116
140,12,54.0,23.333333333333332,>,30.666666666666668,25,21,>,4,79,27,>,52,48.333333333333336,50.666666666666664,<,-2.3333333333333286,38,39,<,-1,59,58,>,1,312,196,>,116
0,12,23.333333333333332,59.666666666666664,<,-36.33333333333333,21,52,<,-31,27,71,<,-44,50.666666666666664,44.0,>,6.666666666666664,39,31,>,8,58,52,>,6,196,280,<,-84
172,12,59.666666666666664,23.333333333333332,>,36.33333333333333,52,21,>,31,71,27,>,44,44.0,50.666666666666664,<,-6.666666666666664,31,39,<,-8,52,58,<,-6,280,196,>,84
0,11,30.333333333333332,34.666666666666664,<,-4.333333333333332,11,17,<,-6,58,67,<,-9,46.666666666666664,44.333333333333336,>,2.3333333333333286,30,34,<,-4,60,54,>,6,270,211,>,59
0,11,34.666666666666664,30.333333333333332,>,4.333333333333332,17,11,>,6,67,58,>,9,44.333333333333336,46.666666666666664,<,-2.3333333333333286,34,30,>,4,54,60,<,-6,211,270,<,-59
0,11,30.333333333333332,52.0,<,-21.666666666666668,11,12,<,-1,58,73,<,-15,46.666666666666664,43.0,>,3.6666666666666643,30,30,=,0,60,59,>,1,270,297,<,-27
95,11,52.0,30.333333333333332,>,21.666666666666668,12,11,>,1,73,58,>,15,43.0,46.666666666666664,<,-3.6666666666666643,30,30,=,0,59,60,<,-1,297,270,>,27
0,11,30.333333333333332,43.666666666666664,<,-13.333333333333332,11,30,<,-19,58,56,>,2,46.666666666666664,40.0,>,6.666666666666664,30,30,=,0,60,46,>,14,270,287,<,-17
108,11,43.666666666666664,30.333333333333332,>,13.333333333333332,30,11,>,19,56,58,<,-2,40.0,46.666666666666664,<,-6.666666666666664,30,30,=,0,46,60,<,-14,287,270,>,17
0,11,30.333333333333332,45.666666666666664,<,-15.333333333333332,11,14,<,-3,58,75,<,-17,46.666666666666664,43.666666666666664,>,3.0,30,32,<,-2,60,58,>,2,270,196,>,74
0,11,45.666666666666664,30.333333333333332,>,15.333333333333332,14,11,>,3,75,58,>,17,43.666666666666664,46.666666666666664,<,-3.0,32,30,>,2,58,60,<,-2,196,270,<,-74
0,11,30.333333333333332,57.0,<,-26.666666666666668,11,39,<,-28,58,69,<,-11,46.666666666666664,44.333333333333336,>,2.3333333333333286,30,39,<,-9,60,53,>,7,270,303,<,-33
126,11,57.0,30.333333333333332,>,26.666666666666668,39,11,>,28,69,58,>,11,44.333333333333336,46.666666666666664,<,-2.3333333333333286,39,30,>,9,53,60,<,-7,303,270,>,33
0,11,30.333333333333332,44.666666666666664,<,-14.333333333333332,11,25,<,-14,58,58,=,0,46.666666666666664,48.333333333333336,<,-1.6666666666666714,30,38,<,-8,60,59,>,1,270,312,<,-42
140,11,44.666666666666664,30.333333333333332,>,14.333333333333332,25,11,>,14,58,58,=,0,48.333333333333336,46.666666666666664,>,1.6666666666666714,38,30,>,8,59,60,<,-1,312,270,>,42
0,11,30.333333333333332,43.666666666666664,<,-13.333333333333332,11,19,<,-8,58,81,<,-23,46.666666666666664,37.666666666666664,>,9.0,30,32,<,-2,60,47,>,13,270,298,<,-28
141,11,43.666666666666664,30.333333333333332,>,13.333333333333332,19,11,>,8,81,58,>,23,37.666666666666664,46.666666666666664,<,-9.0,32,30,>,2,47,60,<,-13,298,270,>,28
0,11,30.333333333333332,58.0,<,-27.666666666666668,11,52,<,-41,58,66,<,-8,46.666666666666664,44.0,>,2.6666666666666643,30,31,<,-1,60,52,>,8,270,280,<,-10
172,11,58.0,30.333333333333332,>,27.666666666666668,52,11,>,41,66,58,>,8,44.0,46.666666666666664,<,-2.6666666666666643,31,30,>,1,52,60,<,-8,280,270,>,10
0,11,30.333333333333332,68.33333333333333,<,-38.0,11,35,<,-24,58,89,<,-31,46.666666666666664,39.0,>,7.666666666666664,30,34,<,-4,60,45,>,15,270,316,<,-46
185,11,68.33333333333333,30.333333333333332,>,38.0,35,11,>,24,89,58,>,31,39.0,46.666666666666664,<,-7.666666666666664,34,30,>,4,45,60,<,-15,316,270,>,46
0,11,30.333333333333332,55.666666666666664,<,-25.333333333333332,11,23,<,-12,58,89,<,-31,46.666666666666664,49.666666666666664,<,-3.0,30,38,<,-8,60,59,>,1,270,227,>,43
103,11,55.666666666666664,30.333333333333332,>,25.333333333333332,23,11,>,12,89,58,>,31,49.666666666666664,46.666666666666664,>,3.0,38,30,>,8,59,60,<,-1,227,270,<,-43
0,10,58.666666666666664,22.666666666666668,>,36.0,14,17,<,-3,87,31,>,56,43.666666666666664,44.333333333333336,<,-0.6666666666666714,32,34,<,-2,58,54,>,4,196,211,<,-15
0,10,22.666666666666668,58.666666666666664,<,-36.0,17,14,>,3,31,87,<,-56,44.333333333333336,43.666666666666664,>,0.6666666666666714,34,32,>,2,54,58,<,-4,211,196,>,15
0,10,58.666666666666664,53.333333333333336,>,5.333333333333329,14,16,<,-2,87,73,>,14,43.666666666666664,43.0,>,0.6666666666666643,32,30,>,2,58,59,<,-1,196,297,<,-101
38,10,53.333333333333336,58.666666666666664,<,-5.333333333333329,16,14,>,2,73,87,<,-14,43.0,43.666666666666664,<,-0.6666666666666643,30,32,<,-2,59,58,>,1,297,196,>,101
0,10,58.666666666666664,53.666666666666664,>,5.0,14,23,<,-9,87,83,>,4,43.666666666666664,49.666666666666664,<,-6.0,32,38,<,-6,58,59,<,-1,196,227,<,-31
103,10,53.666666666666664,58.666666666666664,<,-5.0,23,14,>,9,83,87,<,-4,49.666666666666664,43.666666666666664,>,6.0,38,32,>,6,59,58,>,1,227,196,>,31
0,10,58.666666666666664,43.333333333333336,>,15.333333333333329,14,29,<,-15,87,56,>,31,43.666666666666664,40.0,>,3.6666666666666643,32,30,>,2,58,46,>,12,196,287,<,-91
63,10,43.333333333333336,58.666666666666664,<,-15.333333333333329,29,14,>,15,56,87,<,-31,40.0,43.666666666666664,<,-3.6666666666666643,30,32,<,-2,46,58,<,-12,287,196,>,91
0,10,58.666666666666664,42.333333333333336,>,16.33333333333333,14,19,<,-5,87,69,>,18,43.666666666666664,44.333333333333336,<,-0.6666666666666714,32,39,<,-7,58,53,>,5,196,303,<,-107
0,10,42.333333333333336,58.666666666666664,<,-16.33333333333333,19,14,>,5,69,87,<,-18,44.333333333333336,43.666666666666664,>,0.6666666666666714,39,32,>,7,53,58,<,-5,303,196,>,107
0,10,58.666666666666664,59.333333333333336,<,-0.6666666666666714,14,51,<,-37,87,69,>,18,43.666666666666664,48.333333333333336,<,-4.666666666666671,32,38,<,-6,58,59,<,-1,196,312,<,-116
123,10,59.333333333333336,58.666666666666664,>,0.6666666666666714,51,14,>,37,69,87,<,-18,48.333333333333336,43.666666666666664,>,4.666666666666671,38,32,>,6,59,58,>,1,312,196,>,116
0,10,58.666666666666664,56.333333333333336,>,2.3333333333333286,14,19,<,-5,87,81,>,6,43.666666666666664,37.666666666666664,>,6.0,32,32,=,0,58,47,>,11,196,298,<,-102
115,10,56.333333333333336,58.666666666666664,<,-2.3333333333333286,19,14,>,5,81,87,<,-6,37.666666666666664,43.666666666666664,<,-6.0,32,32,=,0,47,58,<,-11,298,196,>,102
0,10,58.666666666666664,68.33333333333333,<,-9.666666666666664,14,56,<,-42,87,83,>,4,43.666666666666664,44.0,<,-0.3333333333333357,32,31,>,1,58,52,>,6,196,280,<,-84
139,10,68.33333333333333,58.666666666666664,>,9.666666666666664,56,14,>,42,83,87,<,-4,44.0,43.666666666666664,>,0.3333333333333357,31,32,<,-1,52,58,<,-6,280,196,>,84
0,10,58.666666666666664,71.33333333333333,<,-12.666666666666664,14,35,<,-21,87,90,<,-3,43.666666666666664,39.0,>,4.666666666666664,32,34,<,-2,58,45,>,13,196,316,<,-120
98,10,71.33333333333333,58.666666666666664,>,12.666666666666664,35,14,>,21,90,87,>,3,39.0,43.666666666666664,<,-4.666666666666664,34,32,>,2,45,58,<,-13,316,196,>,120
0,9,22.0,47.333333333333336,<,-25.333333333333336,17,19,<,-2,31,84,<,-53,44.333333333333336,44.333333333333336,=,0.0,34,39,<,-5,54,53,>,1,211,303,<,-92
0,9,47.333333333333336,22.0,>,25.333333333333336,19,17,>,2,84,31,>,53,44.333333333333336,44.333333333333336,=,0.0,39,34,>,5,53,54,<,-1,303,211,>,92
0,9,22.0,36.666666666666664,<,-14.666666666666664,17,16,>,1,31,71,<,-40,44.333333333333336,43.0,>,1.3333333333333357,34,30,>,4,54,59,<,-5,211,297,<,-86
0,9,36.666666666666664,22.0,>,14.666666666666664,16,17,<,-1,71,31,>,40,43.0,44.333333333333336,<,-1.3333333333333357,30,34,<,-4,59,54,>,5,297,211,>,86
0,9,22.0,36.333333333333336,<,-14.333333333333336,17,29,<,-12,31,45,<,-14,44.333333333333336,40.0,>,4.333333333333336,34,30,>,4,54,46,>,8,211,287,<,-76
63,9,36.333333333333336,22.0,>,14.333333333333336,29,17,>,12,45,31,>,14,40.0,44.333333333333336,<,-4.333333333333336,30,34,<,-4,46,54,<,-8,287,211,>,76
0,9,22.0,47.0,<,-25.0,17,16,>,1,31,90,<,-59,44.333333333333336,39.0,>,5.333333333333336,34,34,=,0,54,45,>,9,211,316,<,-105
71,9,47.0,22.0,>,25.0,16,17,<,-1,90,31,>,59,39.0,44.333333333333336,<,-5.333333333333336,34,34,=,0,45,54,<,-9,316,211,>,105
0,9,22.0,73.66666666666667,<,-51.66666666666667,17,55,<,-38,31,83,<,-52,44.333333333333336,49.666666666666664,<,-5.333333333333329,34,38,<,-4,54,59,<,-5,211,227,<,-16
200,9,73.66666666666667,22.0,>,51.66666666666667,55,17,>,38,83,31,>,52,49.666666666666664,44.333333333333336,>,5.333333333333329,38,34,>,4,59,54,>,5,227,211,>,16
0,9,22.0,45.0,<,-23.0,17,19,<,-2,31,69,<,-38,44.333333333333336,37.666666666666664,>,6.666666666666671,34,32,>,2,54,47,>,7,211,298,<,-87
115,9,45.0,22.0,>,23.0,19,17,>,2,69,31,>,38,37.666666666666664,44.333333333333336,<,-6.666666666666671,32,34,<,-2,47,54,<,-7,298,211,>,87
0,9,22.0,70.33333333333333,<,-48.33333333333333,17,58,<,-41,31,84,<,-53,44.333333333333336,48.333333333333336,<,-4.0,34,38,<,-4,54,59,<,-5,211,312,<,-101
123,9,70.33333333333333,22.0,>,48.33333333333333,58,17,>,41,84,31,>,53,48.333333333333336,44.333333333333336,>,4.0,38,34,>,4,59,54,>,5,312,211,>,101
0,9,22.0,55.333333333333336,<,-33.333333333333336,17,27,<,-10,31,83,<,-52,44.333333333333336,44.0,>,0.3333333333333357,34,31,>,3,54,52,>,2,211,280,<,-69
38,9,55.333333333333336,22.0,>,33.333333333333336,27,17,>,10,83,31,>,52,44.0,44.333333333333336,<,-0.3333333333333357,31,34,<,-3,52,54,<,-2,280,211,>,69
0,8,31.0,48.666666666666664,<,-17.666666666666664,16,19,<,-3,54,84,<,-30,43.0,44.333333333333336,<,-1.3333333333333357,30,39,<,-9,59,53,>,6,297,303,<,-6
0,8,48.666666666666664,31.0,>,17.666666666666664,19,16,>,3,84,54,>,30,44.333333333333336,43.0,>,1.3333333333333357,39,30,>,9,53,59,<,-6,303,297,>,6
0,8,31.0,58.333333333333336,<,-27.333333333333336,16,27,<,-11,54,83,<,-29,43.0,44.0,<,-1.0,30,31,<,-1,59,52,>,7,297,280,>,17
38,8,58.333333333333336,31.0,>,27.333333333333336,27,16,>,11,83,54,>,29,44.0,43.0,>,1.0,31,30,>,1,52,59,<,-7,280,297,<,-17
0,8,31.0,37.333333333333336,<,-6.333333333333336,16,29,<,-13,54,48,>,6,43.0,40.0,>,3.0,30,30,=,0,59,46,>,13,297,287,>,10
63,8,37.333333333333336,31.0,>,6.333333333333336,29,16,>,13,48,54,<,-6,40.0,43.0,<,-3.0,30,30,=,0,46,59,<,-13,287,297,<,-10
0,8,31.0,62.666666666666664,<,-31.666666666666664,16,16,=,0,54,90,<,-36,43.0,39.0,>,4.0,30,34,<,-4,59,45,>,14,297,316,<,-19
71,8,62.666666666666664,31.0,>,31.666666666666664,16,16,=,0,90,54,>,36,39.0,43.0,<,-4.0,34,30,>,4,45,59,<,-14,316,297,>,19
0,8,31.0,58.0,<,-27.0,16,47,<,-31,54,69,<,-15,43.0,37.666666666666664,>,5.333333333333336,30,32,<,-2,59,47,>,12,297,298,<,-1
115,8,58.0,31.0,>,27.0,47,16,>,31,69,54,>,15,37.666666666666664,43.0,<,-5.333333333333336,32,30,>,2,47,59,<,-12,298,297,>,1
0,8,31.0,67.66666666666667,<,-36.66666666666667,16,50,<,-34,54,84,<,-30,43.0,48.333333333333336,<,-5.333333333333336,30,38,<,-8,59,59,=,0,297,312,<,-15
123,8,67.66666666666667,31.0,>,36.66666666666667,50,16,>,34,84,54,>,30,48.333333333333336,43.0,>,5.333333333333336,38,30,>,8,59,59,=,0,312,297,>,15
0,8,31.0,59.333333333333336,<,-28.333333333333336,16,12,>,4,54,83,<,-29,43.0,49.666666666666664,<,-6.666666666666664,30,38,<,-8,59,59,=,0,297,227,>,70
0,8,59.333333333333336,31.0,>,28.333333333333336,12,16,<,-4,83,54,>,29,49.666666666666664,43.0,>,6.666666666666664,38,30,>,8,59,59,=,0,227,297,<,-70
0,7,38.333333333333336,44.0,<,-5.666666666666664,12,19,<,-7,83,70,>,13,49.666666666666664,44.333333333333336,>,5.333333333333329,38,39,<,-1,59,53,>,6,227,303,<,-76
0,7,44.0,38.333333333333336,>,5.666666666666664,19,12,>,7,70,83,<,-13,44.333333333333336,49.666666666666664,<,-5.333333333333329,39,38,>,1,53,59,<,-6,303,227,>,76
0,7,38.333333333333336,73.66666666666667,<,-35.333333333333336,12,65,<,-53,83,83,=,0,49.666666666666664,44.0,>,5.666666666666664,38,31,>,7,59,52,>,7,227,280,<,-53
139,7,73.66666666666667,38.333333333333336,>,35.333333333333336,65,12,>,53,83,83,=,0,44.0,49.666666666666664,<,-5.666666666666664,31,38,<,-7,52,59,<,-7,280,227,>,53
0,7,38.333333333333336,38.666666666666664,<,-0.3333333333333286,12,29,<,-17,83,48,>,35,49.666666666666664,40.0,>,9.666666666666664,38,30,>,8,59,46,>,13,227,287,<,-60
63,7,38.666666666666664,38.333333333333336,>,0.3333333333333286,29,12,>,17,48,83,<,-35,40.0,49.666666666666664,<,-9.666666666666664,30,38,<,-8,46,59,<,-13,287,227,>,60
0,7,38.333333333333336,85.33333333333333,<,-46.99999999999999,12,82,<,-70,83,90,<,-7,49.666666666666664,39.0,>,10.666666666666664,38,34,>,4,59,45,>,14,227,316,<,-89
98,7,85.33333333333333,38.333333333333336,>,46.99999999999999,82,12,>,70,90,83,>,7,39.0,49.666666666666664,<,-10.666666666666664,34,38,<,-4,45,59,<,-14,316,227,>,89
0,7,38.333333333333336,47.666666666666664,<,-9.333333333333329,12,16,<,-4,83,69,>,14,49.666666666666664,37.666666666666664,>,12.0,38,32,>,6,59,47,>,12,227,298,<,-71
51,7,47.666666666666664,38.333333333333336,>,9.333333333333329,16,12,>,4,69,83,<,-14,37.666666666666664,49.666666666666664,<,-12.0,32,38,<,-6,47,59,<,-12,298,227,>,71
0,7,38.333333333333336,46.333333333333336,<,-8.0,12,20,<,-8,83,69,>,14,49.666666666666664,48.333333333333336,>,1.3333333333333286,38,38,=,0,59,59,=,0,227,312,<,-85
0,7,46.333333333333336,38.333333333333336,>,8.0,20,12,>,8,69,83,<,-14,48.333333333333336,49.666666666666664,<,-1.3333333333333286,38,38,=,0,59,59,=,0,312,227,>,85
0,6,35.333333333333336,48.0,<,-12.666666666666664,17,19,<,-2,69,70,<,-1,48.333333333333336,44.333333333333336,>,4.0,38,39,<,-1,59,53,>,6,312,303,>,9
0,6,48.0,35.333333333333336,>,12.666666666666664,19,17,>,2,70,69,>,1,44.333333333333336,48.333333333333336,<,-4.0,39,38,>,1,53,59,<,-6,303,312,<,-9
0,6,35.333333333333336,35.333333333333336,=,0.0,17,16,>,1,69,69,=,0,48.333333333333336,37.666666666666664,>,10.666666666666671,38,32,>,6,59,47,>,12,312,298,>,14
51,6,35.333333333333336,35.333333333333336,=,0.0,16,17,<,-1,69,69,=,0,37.666666666666664,48.333333333333336,<,-10.666666666666671,32,38,<,-6,47,59,<,-12,298,312,<,-14
0,6,35.333333333333336,33.0,>,2.3333333333333357,17,29,<,-12,69,39,>,30,48.333333333333336,40.0,>,8.333333333333336,38,30,>,8,59,46,>,13,312,287,>,25
51,6,33.0,35.333333333333336,<,-2.3333333333333357,29,17,>,12,39,69,<,-30,40.0,48.333333333333336,<,-8.333333333333336,30,38,<,-8,46,59,<,-13,287,312,<,-25
0,6,35.333333333333336,70.0,<,-34.666666666666664,17,36,<,-19,69,90,<,-21,48.333333333333336,39.0,>,9.333333333333336,38,34,>,4,59,45,>,14,312,316,<,-4
98,6,70.0,35.333333333333336,>,34.666666666666664,36,17,>,19,90,69,>,21,39.0,48.333333333333336,<,-9.333333333333336,34,38,<,-4,45,59,<,-14,316,312,>,4
0,6,35.333333333333336,57.333333333333336,<,-22.0,17,16,>,1,69,83,<,-14,48.333333333333336,44.0,>,4.333333333333336,38,31,>,7,59,52,>,7,312,280,>,32
0,6,57.333333333333336,35.333333333333336,>,22.0,16,17,<,-1,83,69,>,14,44.0,48.333333333333336,<,-4.333333333333336,31,38,<,-7,52,59,<,-7,280,312,<,-32
0,5,46.333333333333336,34.0,>,12.333333333333336,16,19,<,-3,83,55,>,28,44.0,44.333333333333336,<,-0.3333333333333357,31,39,<,-8,52,53,<,-1,280,303,<,-23
0,5,34.0,46.333333333333336,<,-12.333333333333336,19,16,>,3,55,83,<,-28,44.333333333333336,44.0,>,0.3333333333333357,39,31,>,8,53,52,>,1,303,280,>,23
0,5,46.333333333333336,28.666666666666668,>,17.666666666666668,16,26,<,-10,83,31,>,52,44.0,40.0,>,4.0,31,30,>,1,52,46,>,6,280,287,<,-7
0,5,28.666666666666668,46.333333333333336,<,-17.666666666666668,26,16,>,10,31,83,<,-52,40.0,44.0,<,-4.0,30,31,<,-1,46,52,<,-6,287,280,>,7
0,5,46.333333333333336,48.333333333333336,<,-2.0,16,21,<,-5,83,69,>,14,44.0,37.666666666666664,>,6.333333333333336,31,32,<,-1,52,47,>,5,280,298,<,-18
73,5,48.333333333333336,46.333333333333336,>,2.0,21,16,>,5,69,83,<,-14,37.666666666666664,44.0,<,-6.333333333333336,32,31,>,1,47,52,<,-5,298,280,>,18
0,5,46.333333333333336,72.0,<,-25.666666666666664,16,36,<,-20,83,90,<,-7,44.0,39.0,>,5.0,31,34,<,-3,52,45,>,7,280,316,<,-36
98,5,72.0,46.333333333333336,>,25.666666666666664,36,16,>,20,90,83,>,7,39.0,44.0,<,-5.0,34,31,>,3,45,52,<,-7,316,280,>,36
0,4,46.666666666666664,40.0,>,6.666666666666664,26,19,>,7,85,73,>,12,40.0,44.333333333333336,<,-4.333333333333336,30,39,<,-9,46,53,<,-7,287,303,<,-16
0,4,40.0,46.666666666666664,<,-6.666666666666664,19,26,<,-7,73,85,<,-12,44.333333333333336,40.0,>,4.333333333333336,39,30,>,9,53,46,>,7,303,287,>,16
0,4,46.666666666666664,47.0,<,-0.3333333333333357,26,17,>,9,85,69,>,16,40.0,37.666666666666664,>,2.3333333333333357,30,32,<,-2,46,47,<,-1,287,298,<,-11
0,4,47.0,46.666666666666664,>,0.3333333333333357,17,26,<,-9,69,85,<,-16,37.666666666666664,40.0,<,-2.3333333333333357,32,30,>,2,47,46,>,1,298,287,>,11
0,4,46.666666666666664,86.66666666666667,<,-40.00000000000001,26,80,<,-54,85,90,<,-5,40.0,39.0,>,1.0,30,34,<,-4,46,45,>,1,287,316,<,-29
98,4,86.66666666666667,46.666666666666664,>,40.00000000000001,80,26,>,54,90,85,>,5,39.0,40.0,<,-1.0,34,30,>,4,45,46,<,-1,316,287,>,29
0,3,47.0,58.333333333333336,<,-11.333333333333336,17,19,<,-2,69,83,<,-14,37.666666666666664,44.333333333333336,<,-6.666666666666671,32,39,<,-7,47,53,<,-6,298,303,<,-5
0,3,58.333333333333336,47.0,>,11.333333333333336,19,17,>,2,83,69,>,14,44.333333333333336,37.666666666666664,>,6.666666666666671,39,32,>,7,53,47,>,6,303,298,>,5
0,3,47.0,65.0,<,-18.0,17,25,<,-8,69,90,<,-21,37.666666666666664,39.0,<,-1.3333333333333357,32,34,<,-2,47,45,>,2,298,316,<,-18
64,3,65.0,47.0,>,18.0,25,17,>,8,90,69,>,21,39.0,37.666666666666664,>,1.3333333333333357,34,32,>,2,45,47,<,-2,316,298,>,18
0,2,47.666666666666664,47.666666666666664,=,0.0,19,25,<,-6,83,90,<,-7,44.333333333333336,39.0,>,5.333333333333336,39,34,>,5,53,45,>,8,303,316,<,-13
23,2,47.666666666666664,47.666666666666664,=,0.0,25,19,>,6,90,83,>,7,39.0,44.333333333333336,<,-5.333333333333336,34,39,<,-5,45,53,<,-8,316,303,>,13
0,11,0.0,0.0,=,0.0,0,0,=,0,0,0,=,0,56.0,36.333333333333336,>,19.666666666666664,49,32,>,17,60,44,>,16,78,126,<,-48
43,11,0.0,0.0,=,0.0,0,0,=,0,0,0,=,0,36.333333333333336,56.0,<,-19.666666666666664,32,49,<,-17,44,60,<,-16,126,78,>,48
0,11,0.0,0.0,=,0.0,0,0,=,0,0,0,=,0,56.0,50.666666666666664,>,5.333333333333336,49,41,>,8,60,57,>,3,78,168,<,-90
79,11,0.0,0.0,=,0.0,0,0,=,0,0,0,=,0,50.666666666666664,56.0,<,-5.333333333333336,41,49,<,-8,57,60,<,-3,168,78,>,90
0,11,0.0,0.0,=,0.0,0,0,=,0,0,0,=,0,56.0,35.666666666666664,>,20.333333333333336,49,32,>,17,60,41,>,19,78,70,>,8
0,11,0.0,0.0,=,0.0,0,0,=,0,0,0,=,0,35.666666666666664,56.0,<,-20.333333333333336,32,49,<,-17,41,60,<,-19,70,78,<,-8
0,11,0.0,0.0,=,0.0,0,0,=,0,0,0,=,0,56.0,47.0,>,9.0,49,38,>,11,60,52,>,8,78,172,<,-94
38,11,0.0,0.0,=,0.0,0,0,=,0,0,0,=,0,47.0,56.0,<,-9.0,38,49,<,-11,52,60,<,-8,172,78,>,94
0,11,0.0,0.0,=,0.0,0,0,=,0,0,0,=,0,56.0,52.0,>,4.0,49,46,>,3,60,55,>,5,78,75,>,3
0,11,0.0,0.0,=,0.0,0,0,=,0,0,0,=,0,52.0,56.0,<,-4.0,46,49,<,-3,55,60,<,-5,75,78,<,-3
0,11,0.0,0.0,=,0.0,0,0,=,0,0,0,=,0,56.0,45.0,>,11.0,49,40,>,9,60,54,>,6,78,115,<,-37
28,11,0.0,0.0,=,0.0,0,0,=,0,0,0,=,0,45.0,56.0,<,-11.0,40,49,<,-9,54,60,<,-6,115,78,>,37
0,11,0.0,0.0,=,0.0,0,0,=,0,0,0,=,0,56.0,45.666666666666664,>,10.333333333333336,49,32,>,17,60,60,=,0,78,131,<,-53
65,11,0.0,0.0,=,0.0,0,0,=,0,0,0,=,0,45.666666666666664,56.0,<,-10.333333333333336,32,49,<,-17,60,60,=,0,131,78,>,53
0,11,0.0,0.0,=,0.0,0,0,=,0,0,0,=,0,56.0,40.333333333333336,>,15.666666666666664,49,34,>,15,60,51,>,9,78,73,>,5
8,11,0.0,0.0,=,0.0,0,0,=,0,0,0,=,0,40.333333333333336,56.0,<,-15.666666666666664,34,49,<,-15,51,60,<,-9,73,78,<,-5
0,11,0.0,0.0,=,0.0,0,0,=,0,0,0,=,0,56.0,48.0,>,8.0,49,30,>,19,60,58,>,2,78,127,<,-49
54,11,0.0,0.0,=,0.0,0,0,=,0,0,0,=,0,48.0,56.0,<,-8.0,30,49,<,-19,58,60,<,-2,127,78,>,49
0,11,0.0,0.0,=,0.0,0,0,=,0,0,0,=,0,56.0,51.0,>,5.0,49,36,>,13,60,60,=,0,78,157,<,-79
32,11,0.0,0.0,=,0.0,0,0,=,0,0,0,=,0,51.0,56.0,<,-5.0,36,49,<,-13,60,60,=,0,157,78,>,79
0,10,28.333333333333332,21.0,>,7.333333333333332,0,0,=,0,85,63,>,22,35.666666666666664,52.0,<,-16.333333333333336,32,46,<,-14,41,55,<,-14,70,75,<,-5
0,10,21.0,28.333333333333332,<,-7.333333333333332,0,0,=,0,63,85,<,-22,52.0,35.666666666666664,>,16.333333333333336,46,32,>,14,55,41,>,14,75,70,>,5
0,10,28.333333333333332,5.666666666666667,>,22.666666666666664,0,0,=,0,85,17,>,68,35.666666666666664,40.333333333333336,<,-4.666666666666671,32,34,<,-2,41,51,<,-10,70,73,<,-3
57,10,5.666666666666667,28.333333333333332,<,-22.666666666666664,0,0,=,0,17,85,<,-68,40.333333333333336,35.666666666666664,>,4.666666666666671,34,32,>,2,51,41,>,10,73,70,>,3
0,10,28.333333333333332,4.0,>,24.333333333333332,0,0,=,0,85,12,>,73,35.666666666666664,45.0,<,-9.333333333333336,32,40,<,-8,41,54,<,-13,70,115,<,-45
41,10,4.0,28.333333333333332,<,-24.333333333333332,0,0,=,0,12,85,<,-73,45.0,35.666666666666664,>,9.333333333333336,40,32,>,8,54,41,>,13,115,70,>,45
0,10,28.333333333333332,7.333333333333333,>,21.0,0,0,=,0,85,22,>,63,35.666666666666664,51.0,<,-15.333333333333336,32,36,<,-4,41,60,<,-19,70,157,<,-87
35,10,7.333333333333333,28.333333333333332,<,-21.0,0,0,=,0,22,85,<,-63,51.0,35.666666666666664,>,15.333333333333336,36,32,>,4,60,41,>,19,157,70,>,87
0,10,28.333333333333332,22.333333333333332,>,6.0,0,0,=,0,85,67,>,18,35.666666666666664,47.0,<,-11.333333333333336,32,38,<,-6,41,52,<,-11,70,172,<,-102
47,10,22.333333333333332,28.333333333333332,<,-6.0,0,0,=,0,67,85,<,-18,47.0,35.666666666666664,>,11.333333333333336,38,32,>,6,52,41,>,11,172,70,>,102
0,10,28.333333333333332,8.666666666666666,>,19.666666666666664,0,0,=,0,85,26,>,59,35.666666666666664,36.333333333333336,<,-0.6666666666666714,32,32,=,0,41,44,<,-3,70,126,<,-56
61,10,8.666666666666666,28.333333333333332,<,-19.666666666666664,0,0,=,0,26,85,<,-59,36.333333333333336,35.666666666666664,>,0.6666666666666714,32,32,=,0,44,41,>,3,126,70,>,56
0,10,28.333333333333332,4.333333333333333,>,24.0,0,0,=,0,85,13,>,72,35.666666666666664,48.0,<,-12.333333333333336,32,30,>,2,41,58,<,-17,70,127,<,-57
0,10,4.333333333333333,28.333333333333332,<,-24.0,0,0,=,0,13,85,<,-72,48.0,35.666666666666664,>,12.333333333333336,30,32,<,-2,58,41,>,17,127,70,>,57
0,10,28.333333333333332,24.666666666666668,>,3.6666666666666643,0,0,=,0,85,74,>,11,35.666666666666664,45.666666666666664,<,-10.0,32,32,=,0,41,60,<,-19,70,131,<,-61
109,10,24.666666666666668,28.333333333333332,<,-3.6666666666666643,0,0,=,0,74,85,<,-11,45.666666666666664,35.666666666666664,>,10.0,32,32,=,0,60,41,>,19,131,70,>,61
0,10,28.333333333333332,25.0,>,3.333333333333332,0,0,=,0,85,75,>,10,35.666666666666664,50.666666666666664,<,-15.0,32,41,<,-9,41,57,<,-16,70,168,<,-98
89,10,25.0,28.333333333333332,<,-3.333333333333332,0,0,=,0,75,85,<,-10,50.666666666666664,35.666666666666664,>,15.0,41,32,>,9,57,41,>,16,168,70,>,98
0,9,51.0,25.666666666666668,>,25.333333333333332,0,0,=,0,90,64,>,26,52.0,48.0,>,4.0,46,30,>,16,55,58,<,-3,75,127,<,-52
0,9,25.666666666666668,51.0,<,-25.333333333333332,0,0,=,0,64,90,<,-26,48.0,52.0,<,-4.0,30,46,<,-16,58,55,>,3,127,75,>,52
0,9,51.0,35.666666666666664,>,15.333333333333336,0,0,=,0,90,85,>,5,52.0,51.0,>,1.0,46,36,>,10,55,60,<,-5,75,157,<,-82
35,9,35.666666666666664,51.0,<,-15.333333333333336,0,0,=,0,85,90,<,-5,51.0,52.0,<,-1.0,36,46,<,-10,60,55,>,5,157,75,>,82
0,9,51.0,28.666666666666668,>,22.333333333333332,0,0,=,0,90,74,>,16,52.0,45.0,>,7.0,46,40,>,6,55,54,>,1,75,115,<,-40
41,9,28.666666666666668,51.0,<,-22.333333333333332,0,0,=,0,74,90,<,-16,45.0,52.0,<,-7.0,40,46,<,-6,54,55,<,-1,115,75,>,40
0,9,51.0,44.333333333333336,>,6.666666666666664,0,0,=,0,90,67,>,23,52.0,47.0,>,5.0,46,38,>,8,55,52,>,3,75,172,<,-97
47,9,44.333333333333336,51.0,<,-6.666666666666664,0,0,=,0,67,90,<,-23,47.0,52.0,<,-5.0,38,46,<,-8,52,55,<,-3,172,75,>,97
0,9,51.0,9.333333333333334,>,41.666666666666664,0,0,=,0,90,17,>,73,52.0,40.333333333333336,>,11.666666666666664,46,34,>,12,55,51,>,4,75,73,>,2
0,9,9.333333333333334,51.0,<,-41.666666666666664,0,0,=,0,17,90,<,-73,40.333333333333336,52.0,<,-11.666666666666664,34,46,<,-12,51,55,<,-4,73,75,<,-2
0,9,51.0,25.333333333333332,>,25.666666666666668,0,0,=,0,90,50,>,40,52.0,36.333333333333336,>,15.666666666666664,46,32,>,14,55,44,>,11,75,126,<,-51
61,9,25.333333333333332,51.0,<,-25.666666666666668,0,0,=,0,50,90,<,-40,36.333333333333336,52.0,<,-15.666666666666664,32,46,<,-14,44,55,<,-11,126,75,>,51
0,9,51.0,38.666666666666664,>,12.333333333333336,0,0,=,0,90,75,>,15,52.0,50.666666666666664,>,1.3333333333333357,46,41,>,5,55,57,<,-2,75,168,<,-93
89,9,38.666666666666664,51.0,<,-12.333333333333336,0,0,=,0,75,90,<,-15,50.666666666666664,52.0,<,-1.3333333333333357,41,46,<,-5,57,55,>,2,168,75,>,93
0,9,51.0,40.666666666666664,>,10.333333333333336,0,0,=,0,90,74,>,16,52.0,45.666666666666664,>,6.333333333333336,46,32,>,14,55,60,<,-5,75,131,<,-56
95,9,40.666666666666664,51.0,<,-10.333333333333336,0,0,=,0,74,90,<,-16,45.666666666666664,52.0,<,-6.333333333333336,32,46,<,-14,60,55,>,5,131,75,>,56
0,8,15.333333333333334,43.0,<,-27.666666666666664,11,13,<,-2,18,64,<,-46,40.333333333333336,48.0,<,-7.666666666666664,34,30,>,4,51,58,<,-7,73,127,<,-54
0,8,43.0,15.333333333333334,>,27.666666666666664,13,11,>,2,64,18,>,46,48.0,40.333333333333336,>,7.666666666666664,30,34,<,-4,58,51,>,7,127,73,>,54
0,8,15.333333333333334,62.333333333333336,<,-47.0,11,22,<,-11,18,85,<,-67,40.333333333333336,51.0,<,-10.666666666666664,34,36,<,-2,51,60,<,-9,73,157,<,-84
35,8,62.333333333333336,15.333333333333334,>,47.0,22,11,>,11,85,18,>,67,51.0,40.333333333333336,>,10.666666666666664,36,34,>,2,60,51,>,9,157,73,>,84
0,8,15.333333333333334,50.0,<,-34.666666666666664,11,12,<,-1,18,74,<,-56,40.333333333333336,45.0,<,-4.666666666666664,34,40,<,-6,51,54,<,-3,73,115,<,-42
30,8,50.0,15.333333333333334,>,34.666666666666664,12,11,>,1,74,18,>,56,45.0,40.333333333333336,>,4.666666666666664,40,34,>,6,54,51,>,3,115,73,>,42
0,8,15.333333333333334,71.66666666666667,<,-56.333333333333336,11,66,<,-55,18,82,<,-64,40.333333333333336,47.0,<,-6.666666666666664,34,38,<,-4,51,52,<,-1,73,172,<,-99
66,8,71.66666666666667,15.333333333333334,>,56.333333333333336,66,11,>,55,82,18,>,64,47.0,40.333333333333336,>,6.666666666666664,38,34,>,4,52,51,>,1,172,73,>,99
0,8,15.333333333333334,37.0,<,-21.666666666666664,11,26,<,-15,18,50,<,-32,40.333333333333336,36.333333333333336,>,4.0,34,32,>,2,51,44,>,7,73,126,<,-53
0,8,37.0,15.333333333333334,>,21.666666666666664,26,11,>,15,50,18,>,32,36.333333333333336,40.333333333333336,<,-4.0,32,34,<,-2,44,51,<,-7,126,73,>,53
0,8,15.333333333333334,65.33333333333333,<,-49.99999999999999,11,41,<,-30,18,80,<,-62,40.333333333333336,50.666666666666664,<,-10.333333333333329,34,41,<,-7,51,57,<,-6,73,168,<,-95
65,8,65.33333333333333,15.333333333333334,>,49.99999999999999,41,11,>,30,80,18,>,62,50.666666666666664,40.333333333333336,>,10.333333333333329,41,34,>,7,57,51,>,6,168,73,>,95
0,8,15.333333333333334,49.0,<,-33.666666666666664,11,25,<,-14,18,74,<,-56,40.333333333333336,45.666666666666664,<,-5.333333333333329,34,32,>,2,51,60,<,-9,73,131,<,-58
29,8,49.0,15.333333333333334,>,33.666666666666664,25,11,>,14,74,18,>,56,45.666666666666664,40.333333333333336,>,5.333333333333329,32,34,<,-2,60,51,>,9,131,73,>,58
0,7,26.0,25.333333333333332,>,0.6666666666666679,17,11,>,6,35,52,<,-17,36.333333333333336,48.0,<,-11.666666666666664,32,30,>,2,44,58,<,-14,126,127,<,-1
0,7,25.333333333333332,26.0,<,-0.6666666666666679,11,17,<,-6,52,35,>,17,48.0,36.333333333333336,>,11.666666666666664,30,32,<,-2,58,44,>,14,127,126,>,1
0,7,26.0,37.666666666666664,<,-11.666666666666664,17,14,>,3,35,74,<,-39,36.333333333333336,45.666666666666664,<,-9.333333333333329,32,32,=,0,44,60,<,-16,126,131,<,-5
0,7,37.666666666666664,26.0,>,11.666666666666664,14,17,<,-3,74,35,>,39,45.666666666666664,36.333333333333336,>,9.333333333333329,32,32,=,0,60,44,>,16,131,126,>,5
0,7,26.0,34.666666666666664,<,-8.666666666666664,17,12,>,5,35,64,<,-29,36.333333333333336,45.0,<,-8.666666666666664,32,40,<,-8,44,54,<,-10,126,115,>,11
29,7,34.666666666666664,26.0,>,8.666666666666664,12,17,<,-5,64,35,>,29,45.0,36.333333333333336,>,8.666666666666664,40,32,>,8,54,44,>,10,115,126,<,-11
0,7,26.0,43.333333333333336,<,-17.333333333333336,17,22,<,-5,35,80,<,-45,36.333333333333336,51.0,<,-14.666666666666664,32,36,<,-4,44,60,<,-16,126,157,<,-31
35,7,43.333333333333336,26.0,>,17.333333333333336,22,17,>,5,80,35,>,45,51.0,36.333333333333336,>,14.666666666666664,36,32,>,4,60,44,>,16,157,126,>,31
0,7,26.0,71.0,<,-45.0,17,58,<,-41,35,80,<,-45,36.333333333333336,50.666666666666664,<,-14.333333333333329,32,41,<,-9,44,57,<,-13,126,168,<,-42
65,7,71.0,26.0,>,45.0,58,17,>,41,80,35,>,45,50.666666666666664,36.333333333333336,>,14.333333333333329,41,32,>,9,57,44,>,13,168,126,>,42
0,7,26.0,60.0,<,-34.0,17,31,<,-14,35,82,<,-47,36.333333333333336,47.0,<,-10.666666666666664,32,38,<,-6,44,52,<,-8,126,172,<,-46
48,7,60.0,26.0,>,34.0,31,17,>,14,82,35,>,47,47.0,36.333333333333336,>,10.666666666666664,38,32,>,6,52,44,>,8,172,126,>,46
0,6,40.0,17.0,>,23.0,14,11,>,3,74,27,>,47,45.666666666666664,48.0,<,-2.3333333333333357,32,30,>,2,60,58,>,2,131,127,>,4
0,6,17.0,40.0,<,-23.0,11,14,<,-3,27,74,<,-47,48.0,45.666666666666664,>,2.3333333333333357,30,32,<,-2,58,60,<,-2,127,131,<,-4
0,6,40.0,25.666666666666668,>,14.333333333333332,14,12,>,2,74,37,>,37,45.666666666666664,45.0,>,0.6666666666666643,32,40,<,-8,60,54,>,6,131,115,>,16
41,6,25.666666666666668,40.0,<,-14.333333333333332,12,14,<,-2,37,74,<,-37,45.0,45.666666666666664,<,-0.6666666666666643,40,32,>,8,54,60,<,-6,115,131,<,-16
0,6,40.0,39.666666666666664,>,0.3333333333333357,14,22,<,-8,74,69,>,5,45.666666666666664,51.0,<,-5.333333333333336,32,36,<,-4,60,60,=,0,131,157,<,-26
26,6,39.666666666666664,40.0,<,-0.3333333333333357,22,14,>,8,69,74,<,-5,51.0,45.666666666666664,>,5.333333333333336,36,32,>,4,60,60,=,0,157,131,>,26
0,6,40.0,57.333333333333336,<,-17.333333333333336,14,31,<,-17,74,74,=,0,45.666666666666664,47.0,<,-1.3333333333333357,32,38,<,-6,60,52,>,8,131,172,<,-41
57,6,57.333333333333336,40.0,>,17.333333333333336,31,14,>,17,74,74,=,0,47.0,45.666666666666664,>,1.3333333333333357,38,32,>,6,52,60,<,-8,172,131,>,41
0,6,40.0,50.0,<,-10.0,14,17,<,-3,74,75,<,-1,45.666666666666664,50.666666666666664,<,-5.0,32,41,<,-9,60,57,>,3,131,168,<,-37
0,6,50.0,40.0,>,10.0,17,14,>,3,75,74,>,1,50.666666666666664,45.666666666666664,>,5.0,41,32,>,9,57,60,<,-3,168,131,>,37
0,5,35.666666666666664,34.0,>,1.6666666666666643,15,13,>,2,75,62,>,13,50.666666666666664,48.0,>,2.6666666666666643,41,30,>,11,57,58,<,-1,168,127,>,41
0,5,34.0,35.666666666666664,<,-1.6666666666666643,13,15,<,-2,62,75,<,-13,48.0,50.666666666666664,<,-2.6666666666666643,30,41,<,-11,58,57,>,1,127,168,<,-41
0,5,35.666666666666664,43.333333333333336,<,-7.666666666666671,15,22,<,-7,75,69,>,6,50.666666666666664,51.0,<,-0.3333333333333357,41,36,>,5,57,60,<,-3,168,157,>,11
26,5,43.333333333333336,35.666666666666664,>,7.666666666666671,22,15,>,7,69,75,<,-6,51.0,50.666666666666664,>,0.3333333333333357,36,41,<,-5,60,57,>,3,157,168,<,-11
0,5,35.666666666666664,19.666666666666668,>,15.999999999999996,15,10,>,5,75,37,>,38,50.666666666666664,45.0,>,5.666666666666664,41,40,>,1,57,54,>,3,168,115,>,53
34,5,19.666666666666668,35.666666666666664,<,-15.999999999999996,10,15,<,-5,37,75,<,-38,45.0,50.666666666666664,<,-5.666666666666664,40,41,<,-1,54,57,<,-3,115,168,<,-53
0,5,35.666666666666664,57.0,<,-21.333333333333336,15,30,<,-15,75,74,>,1,50.666666666666664,47.0,>,3.6666666666666643,41,38,>,3,57,52,>,5,168,172,<,-4
0,5,57.0,35.666666666666664,>,21.333333333333336,30,15,>,15,74,75,<,-1,47.0,50.666666666666664,<,-3.6666666666666643,38,41,<,-3,52,57,<,-5,172,168,>,4
0,4,51.333333333333336,54.666666666666664,<,-3.3333333333333286,30,13,>,17,67,89,<,-22,47.0,48.0,<,-1.0,38,30,>,8,52,58,<,-6,172,127,>,45
0,4,54.666666666666664,51.333333333333336,>,3.3333333333333286,13,30,<,-17,89,67,>,22,48.0,47.0,>,1.0,30,38,<,-8,58,52,>,6,127,172,<,-45
0,4,51.333333333333336,31.333333333333332,>,20.000000000000004,30,22,>,8,67,39,>,28,47.0,51.0,<,-4.0,38,36,>,2,52,60,<,-8,172,157,>,15
0,4,31.333333333333332,51.333333333333336,<,-20.000000000000004,22,30,<,-8,39,67,<,-28,51.0,47.0,>,4.0,36,38,<,-2,60,52,>,8,157,172,<,-15
0,4,51.333333333333336,30.0,>,21.333333333333336,30,10,>,20,67,68,<,-1,47.0,45.0,>,2.0,38,40,<,-2,52,54,<,-2,172,115,>,57
34,4,30.0,51.333333333333336,<,-21.333333333333336,10,30,<,-20,68,67,>,1,45.0,47.0,<,-2.0,40,38,>,2,54,52,>,2,115,172,<,-57
0,3,59.333333333333336,31.333333333333332,>,28.000000000000004,13,22,<,-9,89,39,>,50,48.0,51.0,<,-3.0,30,36,<,-6,58,60,<,-2,127,157,<,-30
0,3,31.333333333333332,59.333333333333336,<,-28.000000000000004,22,13,>,9,39,89,<,-50,51.0,48.0,>,3.0,36,30,>,6,60,58,>,2,157,127,>,30
0,3,59.333333333333336,55.333333333333336,>,4.0,13,12,>,1,89,86,>,3,48.0,45.0,>,3.0,30,40,<,-10,58,54,>,4,127,115,>,12
41,3,55.333333333333336,59.333333333333336,<,-4.0,12,13,<,-1,86,89,<,-3,45.0,48.0,<,-3.0,40,30,>,10,54,58,<,-4,115,127,<,-12
0,2,53.0,56.0,<,-3.0,33,14,>,19,87,86,>,1,51.0,45.0,>,6.0,36,40,<,-4,60,54,>,6,157,115,>,42
0,2,56.0,53.0,>,3.0,14,33,<,-19,86,87,<,-1,45.0,51.0,<,-6.0,40,36,>,4,54,60,<,-6,115,157,<,-42
0,13,0.0,0.0,=,0.0,0,0,=,0,0,0,=,0,47.666666666666664,50.666666666666664,<,-3.0,32,43,<,-11,59,56,>,3,87,176,<,-89
54,13,0.0,0.0,=,0.0,0,0,=,0,0,0,=,0,50.666666666666664,47.666666666666664,>,3.0,43,32,>,11,56,59,<,-3,176,87,>,89
0,13,0.0,0.0,=,0.0,0,0,=,0,0,0,=,0,47.666666666666664,41.0,>,6.666666666666664,32,32,=,0,59,49,>,10,87,115,<,-28
61,13,0.0,0.0,=,0.0,0,0,=,0,0,0,=,0,41.0,47.666666666666664,<,-6.666666666666664,32,32,=,0,49,59,<,-10,115,87,>,28
0,13,0.0,0.0,=,0.0,0,0,=,0,0,0,=,0,47.666666666666664,40.666666666666664,>,7.0,32,36,<,-4,59,50,>,9,87,166,<,-79
39,13,0.0,0.0,=,0.0,0,0,=,0,0,0,=,0,40.666666666666664,47.666666666666664,<,-7.0,36,32,>,4,50,59,<,-9,166,87,>,79
0,13,0.0,0.0,=,0.0,0,0,=,0,0,0,=,0,47.666666666666664,44.666666666666664,>,3.0,32,37,<,-5,59,53,>,6,87,87,=,0
32,13,0.0,0.0,=,0.0,0,0,=,0,0,0,=,0,44.666666666666664,47.666666666666664,<,-3.0,37,32,>,5,53,59,<,-6,87,87,=,0
0,13,0.0,0.0,=,0.0,0,0,=,0,0,0,=,0,47.666666666666664,41.0,>,6.666666666666664,32,30,>,2,59,57,>,2,87,74,>,13
0,13,0.0,0.0,=,0.0,0,0,=,0,0,0,=,0,41.0,47.666666666666664,<,-6.666666666666664,30,32,<,-2,57,59,<,-2,74,87,<,-13
0,13,0.0,0.0,=,0.0,0,0,=,0,0,0,=,0,47.666666666666664,47.0,>,0.6666666666666643,32,46,<,-14,59,48,>,11,87,138,<,-51
87,13,0.0,0.0,=,0.0,0,0,=,0,0,0,=,0,47.0,47.666666666666664,<,-0.6666666666666643,46,32,>,14,48,59,<,-11,138,87,>,51
0,13,0.0,0.0,=,0.0,0,0,=,0,0,0,=,0,47.666666666666664,48.666666666666664,<,-1.0,32,44,<,-12,59,54,>,5,87,205,<,-118
82,13,0.0,0.0,=,0.0,0,0,=,0,0,0,=,0,48.666666666666664,47.666666666666664,>,1.0,44,32,>,12,54,59,<,-5,205,87,>,118
0,13,0.0,0.0,=,0.0,0,0,=,0,0,0,=,0,47.666666666666664,44.0,>,3.6666666666666643,32,35,<,-3,59,59,=,0,87,119,<,-32
16,13,0.0,0.0,=,0.0,0,0,=,0,0,0,=,0,44.0,47.666666666666664,<,-3.6666666666666643,35,32,>,3,59,59,=,0,119,87,>,32
0,13,0.0,0.0,=,0.0,0,0,=,0,0,0,=,0,47.666666666666664,44.333333333333336,>,3.3333333333333286,32,33,<,-1,59,56,>,3,87,169,<,-82
27,13,0.0,0.0,=,0.0,0,0,=,0,0,0,=,0,44.333333333333336,47.666666666666664,<,-3.3333333333333286,33,32,>,1,56,59,<,-3,169,87,>,82
0,13,0.0,0.0,=,0.0,0,0,=,0,0,0,=,0,47.666666666666664,54.333333333333336,<,-6.666666666666671,32,53,<,-21,59,56,>,3,87,207,<,-120
129,13,0.0,0.0,=,0.0,0,0,=,0,0,0,=,0,54.333333333333336,47.666666666666664,>,6.666666666666671,53,32,>,21,56,59,<,-3,207,87,>,120
0,13,0.0,0.0,=,0.0,0,0,=,0,0,0,=,0,47.666666666666664,47.666666666666664,=,0.0,32,34,<,-2,59,59,=,0,87,113,<,-26
0,13,0.0,0.0,=,0.0,0,0,=,0,0,0,=,0,47.666666666666664,47.666666666666664,=,0.0,34,32,>,2,59,59,=,0,113,87,>,26
0,13,0.0,0.0,=,0.0,0,0,=,0,0,0,=,0,47.666666666666664,37.666666666666664,>,10.0,32,33,<,-1,59,45,>,14,87,125,<,-38
16,13,0.0,0.0,=,0.0,0,0,=,0,0,0,=,0,37.666666666666664,47.666666666666664,<,-10.0,33,32,>,1,45,59,<,-14,125,87,>,38
0,12,9.333333333333334,27.0,<,-17.666666666666664,0,0,=,0,28,81,<,-53,41.0,47.666666666666664,<,-6.666666666666664,30,34,<,-4,57,59,<,-2,74,113,<,-39
0,12,27.0,9.333333333333334,>,17.666666666666664,0,0,=,0,81,28,>,53,47.666666666666664,41.0,>,6.666666666666664,34,30,>,4,59,57,>,2,113,74,>,39
0,12,9.333333333333334,28.333333333333332,<,-19.0,0,0,=,0,28,85,<,-57,41.0,44.0,<,-3.0,30,35,<,-5,57,59,<,-2,74,119,<,-45
16,12,28.333333333333332,9.333333333333334,>,19.0,0,0,=,0,85,28,>,57,44.0,41.0,>,3.0,35,30,>,5,59,57,>,2,119,74,>,45
0,12,9.333333333333334,5.666666666666667,>,3.666666666666667,0,0,=,0,28,17,>,11,41.0,37.666666666666664,>,3.3333333333333357,30,33,<,-3,57,45,>,12,74,125,<,-51
0,12,5.666666666666667,9.333333333333334,<,-3.666666666666667,0,0,=,0,17,28,<,-11,37.666666666666664,41.0,<,-3.3333333333333357,33,30,>,3,45,57,<,-12,125,74,>,51
0,12,9.333333333333334,16.0,<,-6.666666666666666,0,0,=,0,28,48,<,-20,41.0,44.333333333333336,<,-3.3333333333333357,30,33,<,-3,57,56,>,1,74,169,<,-95
27,12,16.0,9.333333333333334,>,6.666666666666666,0,0,=,0,48,28,>,20,44.333333333333336,41.0,>,3.3333333333333357,33,30,>,3,56,57,<,-1,169,74,>,95
0,12,9.333333333333334,13.0,<,-3.666666666666666,0,0,=,0,28,39,<,-11,41.0,44.666666666666664,<,-3.6666666666666643,30,37,<,-7,57,53,>,4,74,87,<,-13
34,12,13.0,9.333333333333334,>,3.666666666666666,0,0,=,0,39,28,>,11,44.666666666666664,41.0,>,3.6666666666666643,37,30,>,7,53,57,<,-4,87,74,>,13
0,12,9.333333333333334,27.666666666666668,<,-18.333333333333336,0,0,=,0,28,83,<,-55,41.0,40.666666666666664,>,0.3333333333333357,30,36,<,-6,57,50,>,7,74,166,<,-92
39,12,27.666666666666668,9.333333333333334,>,18.333333333333336,0,0,=,0,83,28,>,55,40.666666666666664,41.0,<,-0.3333333333333357,36,30,>,6,50,57,<,-7,166,74,>,92
0,12,9.333333333333334,25.333333333333332,<,-15.999999999999998,0,0,=,0,28,76,<,-48,41.0,50.666666666666664,<,-9.666666666666664,30,43,<,-13,57,56,>,1,74,176,<,-102
54,12,25.333333333333332,9.333333333333334,>,15.999999999999998,0,0,=,0,76,28,>,48,50.666666666666664,41.0,>,9.666666666666664,43,30,>,13,56,57,<,-1,176,74,>,102
0,12,9.333333333333334,27.666666666666668,<,-18.333333333333336,0,0,=,0,28,83,<,-55,41.0,41.0,=,0.0,30,32,<,-2,57,49,>,8,74,115,<,-41
69,12,27.666666666666668,9.333333333333334,>,18.333333333333336,0,0,=,0,83,28,>,55,41.0,41.0,=,0.0,32,30,>,2,49,57,<,-8,115,74,>,41
0,12,9.333333333333334,24.0,<,-14.666666666666666,0,0,=,0,28,72,<,-44,41.0,48.666666666666664,<,-7.666666666666664,30,44,<,-14,57,54,>,3,74,205,<,-131
82,12,24.0,9.333333333333334,>,14.666666666666666,0,0,=,0,72,28,>,44,48.666666666666664,41.0,>,7.666666666666664,44,30,>,14,54,57,<,-3,205,74,>,131
0,12,9.333333333333334,9.0,>,0.3333333333333339,0,0,=,0,28,27,>,1,41.0,47.0,<,-6.0,30,46,<,-16,57,48,>,9,74,138,<,-64
46,12,9.0,9.333333333333334,<,-0.3333333333333339,0,0,=,0,27,28,<,-1,47.0,41.0,>,6.0,46,30,>,16,48,57,<,-9,138,74,>,64
0,12,9.333333333333334,7.0,>,2.333333333333334,0,0,=,0,28,21,>,7,41.0,54.333333333333336,<,-13.333333333333336,30,53,<,-23,57,56,>,1,74,207,<,-133
110,12,7.0,9.333333333333334,<,-2.333333333333334,0,0,=,0,21,28,<,-7,54.333333333333336,41.0,>,13.333333333333336,53,30,>,23,56,57,<,-1,207,74,>,133
0,11,42.333333333333336,21.333333333333332,>,21.000000000000004,0,0,=,0,81,47,>,34,47.666666666666664,37.666666666666664,>,10.0,34,33,>,1,59,45,>,14,113,125,<,-12
0,11,21.333333333333332,42.333333333333336,<,-21.000000000000004,0,0,=,0,47,81,<,-34,37.666666666666664,47.666666666666664,<,-10.0,33,34,<,-1,45,59,<,-14,125,113,>,12
0,11,42.333333333333336,48.666666666666664,<,-6.333333333333329,0,0,=,0,81,85,<,-4,47.666666666666664,44.0,>,3.6666666666666643,34,35,<,-1,59,59,=,0,113,119,<,-6
76,11,48.666666666666664,42.333333333333336,>,6.333333333333329,0,0,=,0,85,81,>,4,44.0,47.666666666666664,<,-3.6666666666666643,35,34,>,1,59,59,=,0,119,113,>,6
0,11,42.333333333333336,23.666666666666668,>,18.666666666666668,0,0,=,0,81,48,>,33,47.666666666666664,44.333333333333336,>,3.3333333333333286,34,33,>,1,59,56,>,3,113,169,<,-56
69,11,23.666666666666668,42.333333333333336,<,-18.666666666666668,0,0,=,0,48,81,<,-33,44.333333333333336,47.666666666666664,<,-3.3333333333333286,33,34,<,-1,56,59,<,-3,169,113,>,56
0,11,42.333333333333336,23.0,>,19.333333333333336,0,0,=,0,81,39,>,42,47.666666666666664,44.666666666666664,>,3.0,34,37,<,-3,59,53,>,6,113,87,>,26
53,11,23.0,42.333333333333336,<,-19.333333333333336,0,0,=,0,39,81,<,-42,44.666666666666664,47.666666666666664,<,-3.0,37,34,>,3,53,59,<,-6,87,113,<,-26
0,11,42.333333333333336,51.0,<,-8.666666666666664,0,0,=,0,81,83,<,-2,47.666666666666664,40.666666666666664,>,7.0,34,36,<,-2,59,50,>,9,113,166,<,-53
113,11,51.0,42.333333333333336,>,8.666666666666664,0,0,=,0,83,81,>,2,40.666666666666664,47.666666666666664,<,-7.0,36,34,>,2,50,59,<,-9,166,113,>,53
0,11,42.333333333333336,14.333333333333334,>,28.0,0,0,=,0,81,27,>,54,47.666666666666664,47.0,>,0.6666666666666643,34,46,<,-12,59,48,>,11,113,138,<,-25
0,11,14.333333333333334,42.333333333333336,<,-28.0,0,0,=,0,27,81,<,-54,47.0,47.666666666666664,<,-0.6666666666666643,46,34,>,12,48,59,<,-11,138,113,>,25
0,11,42.333333333333336,36.0,>,6.333333333333336,0,0,=,0,81,76,>,5,47.666666666666664,50.666666666666664,<,-3.0,34,43,<,-9,59,56,>,3,113,176,<,-63
61,11,36.0,42.333333333333336,<,-6.333333333333336,0,0,=,0,76,81,<,-5,50.666666666666664,47.666666666666664,>,3.0,43,34,>,9,56,59,<,-3,176,113,>,63
0,11,42.333333333333336,54.333333333333336,<,-12.0,0,0,=,0,81,83,<,-2,47.666666666666664,41.0,>,6.666666666666664,34,32,>,2,59,49,>,10,113,115,<,-2
128,11,54.333333333333336,42.333333333333336,>,12.0,0,0,=,0,83,81,>,2,41.0,47.666666666666664,<,-6.666666666666664,32,34,<,-2,49,59,<,-10,115,113,>,2
0,11,42.333333333333336,54.0,<,-11.666666666666664,0,0,=,0,81,90,<,-9,47.666666666666664,48.666666666666664,<,-1.0,34,44,<,-10,59,54,>,5,113,205,<,-92
100,11,54.0,42.333333333333336,>,11.666666666666664,0,0,=,0,90,81,>,9,48.666666666666664,47.666666666666664,>,1.0,44,34,>,10,54,59,<,-5,205,113,>,92
0,11,42.333333333333336,20.666666666666668,>,21.666666666666668,0,0,=,0,81,41,>,40,47.666666666666664,54.333333333333336,<,-6.666666666666671,34,53,<,-19,59,56,>,3,113,207,<,-94
93,11,20.666666666666668,42.333333333333336,<,-21.666666666666668,0,0,=,0,41,81,<,-40,54.333333333333336,47.666666666666664,>,6.666666666666671,53,34,>,19,56,59,<,-3,207,113,>,94
0,10,36.333333333333336,39.666666666666664,<,-3.3333333333333286,16,17,<,-1,66,55,>,11,47.0,37.666666666666664,>,9.333333333333336,46,33,>,13,48,45,>,3,138,125,>,13
0,10,39.666666666666664,36.333333333333336,>,3.3333333333333286,17,16,>,1,55,66,<,-11,37.666666666666664,47.0,<,-9.333333333333336,33,46,<,-13,45,48,<,-3,125,138,<,-13
0,10,36.333333333333336,29.0,>,7.333333333333336,16,18,<,-2,66,39,>,27,47.0,44.666666666666664,>,2.3333333333333357,46,37,>,9,48,53,<,-5,138,87,>,51
0,10,29.0,36.333333333333336,<,-7.333333333333336,18,16,>,2,39,66,<,-27,44.666666666666664,47.0,<,-2.3333333333333357,37,46,<,-9,53,48,>,5,87,138,<,-51
0,10,36.333333333333336,65.33333333333333,<,-28.999999999999993,16,32,<,-16,66,88,<,-22,47.0,50.666666666666664,<,-3.6666666666666643,46,43,>,3,48,56,<,-8,138,176,<,-38
61,10,65.33333333333333,36.333333333333336,>,28.999999999999993,32,16,>,16,88,66,>,22,50.666666666666664,47.0,>,3.6666666666666643,43,46,<,-3,56,48,>,8,176,138,>,38
0,10,36.333333333333336,28.333333333333332,>,8.000000000000004,16,14,>,2,66,48,>,18,47.0,44.333333333333336,>,2.6666666666666643,46,33,>,13,48,56,<,-8,138,169,<,-31
69,10,28.333333333333332,36.333333333333336,<,-8.000000000000004,14,16,<,-2,48,66,<,-18,44.333333333333336,47.0,<,-2.6666666666666643,33,46,<,-13,56,48,>,8,169,138,>,31
0,10,36.333333333333336,60.0,<,-23.666666666666664,16,34,<,-18,66,85,<,-19,47.0,44.0,>,3.0,46,35,>,11,48,59,<,-11,138,119,>,19
65,10,60.0,36.333333333333336,>,23.666666666666664,34,16,>,18,85,66,>,19,44.0,47.0,<,-3.0,35,46,<,-11,59,48,>,11,119,138,<,-19
0,10,36.333333333333336,49.333333333333336,<,-13.0,16,21,<,-5,66,86,<,-20,47.0,54.333333333333336,<,-7.333333333333336,46,53,<,-7,48,56,<,-8,138,207,<,-69
93,10,49.333333333333336,36.333333333333336,>,13.0,21,16,>,5,86,66,>,20,54.333333333333336,47.0,>,7.333333333333336,53,46,>,7,56,48,>,8,207,138,>,69
0,10,36.333333333333336,65.33333333333333,<,-28.999999999999993,16,34,<,-18,66,90,<,-24,47.0,48.666666666666664,<,-1.6666666666666643,46,44,>,2,48,54,<,-6,138,205,<,-67
129,10,65.33333333333333,36.333333333333336,>,28.999999999999993,34,16,>,18,90,66,>,24,48.666666666666664,47.0,>,1.6666666666666643,44,46,<,-2,54,48,>,6,205,138,>,67
0,10,36.333333333333336,58.333333333333336,<,-22.0,16,22,<,-6,66,83,<,-17,47.0,40.666666666666664,>,6.333333333333336,46,36,>,10,48,50,<,-2,138,166,<,-28
99,10,58.333333333333336,36.333333333333336,>,22.0,22,16,>,6,83,66,>,17,40.666666666666664,47.0,<,-6.333333333333336,36,46,<,-10,50,48,>,2,166,138,>,28
0,10,36.333333333333336,61.0,<,-24.666666666666664,16,20,<,-4,66,83,<,-17,47.0,41.0,>,6.0,46,32,>,14,48,49,<,-1,138,115,>,23
106,10,61.0,36.333333333333336,>,24.666666666666664,20,16,>,4,83,66,>,17,41.0,47.0,<,-6.0,32,46,<,-14,49,48,>,1,115,138,<,-23
0,9,34.666666666666664,51.0,<,-16.333333333333336,18,17,>,1,47,81,<,-34,44.666666666666664,37.666666666666664,>,7.0,37,33,>,4,53,45,>,8,87,125,<,-38
0,9,51.0,34.666666666666664,>,16.333333333333336,17,18,<,-1,81,47,>,34,37.666666666666664,44.666666666666664,<,-7.0,33,37,<,-4,45,53,<,-8,125,87,>,38
0,9,34.666666666666664,82.0,<,-47.333333333333336,18,76,<,-58,47,88,<,-41,44.666666666666664,50.666666666666664,<,-6.0,37,43,<,-6,53,56,<,-3,87,176,<,-89
113,9,82.0,34.666666666666664,>,47.333333333333336,76,18,>,58,88,47,>,41,50.666666666666664,44.666666666666664,>,6.0,43,37,>,6,56,53,>,3,176,87,>,89
0,9,34.666666666666664,50.333333333333336,<,-15.666666666666671,18,32,<,-14,47,85,<,-38,44.666666666666664,44.0,>,0.6666666666666643,37,35,>,2,53,59,<,-6,87,119,<,-32
74,9,50.333333333333336,34.666666666666664,>,15.666666666666671,32,18,>,14,85,47,>,38,44.0,44.666666666666664,<,-0.6666666666666643,35,37,<,-2,59,53,>,6,119,87,>,32
0,9,34.666666666666664,49.666666666666664,<,-15.0,18,14,>,4,47,87,<,-40,44.666666666666664,44.333333333333336,>,0.3333333333333286,37,33,>,4,53,56,<,-3,87,169,<,-82
72,9,49.666666666666664,34.666666666666664,>,15.0,14,18,<,-4,87,47,>,40,44.333333333333336,44.666666666666664,<,-0.3333333333333286,33,37,<,-4,56,53,>,3,169,87,>,82
0,9,34.666666666666664,64.33333333333333,<,-29.666666666666664,18,21,<,-3,47,86,<,-39,44.666666666666664,54.333333333333336,<,-9.666666666666671,37,53,<,-16,53,56,<,-3,87,207,<,-120
126,9,64.33333333333333,34.666666666666664,>,29.666666666666664,21,18,>,3,86,47,>,39,54.333333333333336,44.666666666666664,>,9.666666666666671,53,37,>,16,56,53,>,3,207,87,>,120
0,9,34.666666666666664,41.0,<,-6.333333333333336,18,18,=,0,47,83,<,-36,44.666666666666664,40.666666666666664,>,4.0,37,36,>,1,53,50,>,3,87,166,<,-79
0,9,41.0,34.666666666666664,>,6.333333333333336,18,18,=,0,83,47,>,36,40.666666666666664,44.666666666666664,<,-4.0,36,37,<,-1,50,53,<,-3,166,87,>,79
0,9,34.666666666666664,61.333333333333336,<,-26.66666666666667,18,20,<,-2,47,83,<,-36,44.666666666666664,41.0,>,3.6666666666666643,37,32,>,5,53,49,>,4,87,115,<,-28
154,9,61.333333333333336,34.666666666666664,>,26.66666666666667,20,18,>,2,83,47,>,36,41.0,44.666666666666664,<,-3.6666666666666643,32,37,<,-5,49,53,<,-4,115,87,>,28
0,9,34.666666666666664,48.0,<,-13.333333333333336,18,34,<,-16,47,72,<,-25,44.666666666666664,48.666666666666664,<,-4.0,37,44,<,-7,53,54,<,-1,87,205,<,-118
52,9,48.0,34.666666666666664,>,13.333333333333336,34,18,>,16,72,47,>,25,48.666666666666664,44.666666666666664,>,4.0,44,37,>,7,54,53,>,1,205,87,>,118
0,8,55.333333333333336,62.333333333333336,<,-7.0,18,17,>,1,83,89,<,-6,40.666666666666664,37.666666666666664,>,3.0,36,33,>,3,50,45,>,5,166,125,>,41
0,8,62.333333333333336,55.333333333333336,>,7.0,17,18,<,-1,89,83,>,6,37.666666666666664,40.666666666666664,<,-3.0,33,36,<,-3,45,50,<,-5,125,166,<,-41
0,8,55.333333333333336,48.333333333333336,>,7.0,18,35,<,-17,83,72,>,11,40.666666666666664,48.666666666666664,<,-8.0,36,44,<,-8,50,54,<,-4,166,205,<,-39
32,8,48.333333333333336,55.333333333333336,<,-7.0,35,18,>,17,72,83,<,-11,48.666666666666664,40.666666666666664,>,8.0,44,36,>,8,54,50,>,4,205,166,>,39
0,8,55.333333333333336,68.0,<,-12.666666666666664,18,48,<,-30,83,87,<,-4,40.666666666666664,44.333333333333336,<,-3.6666666666666714,36,33,>,3,50,56,<,-6,166,169,<,-3
131,8,68.0,55.333333333333336,>,12.666666666666664,48,18,>,30,87,83,>,4,44.333333333333336,40.666666666666664,>,3.6666666666666714,33,36,<,-3,56,50,>,6,169,166,>,3
0,8,55.333333333333336,48.666666666666664,>,6.666666666666671,18,29,<,-11,83,85,<,-2,40.666666666666664,44.0,<,-3.3333333333333357,36,35,>,1,50,59,<,-9,166,119,>,47
0,8,48.666666666666664,55.333333333333336,<,-6.666666666666671,29,18,>,11,85,83,>,2,44.0,40.666666666666664,>,3.3333333333333357,35,36,<,-1,59,50,>,9,119,166,<,-47
0,8,55.333333333333336,74.66666666666667,<,-19.333333333333336,18,66,<,-48,83,82,>,1,40.666666666666664,50.666666666666664,<,-10.0,36,43,<,-7,50,56,<,-6,166,176,<,-10
113,8,74.66666666666667,55.333333333333336,>,19.333333333333336,66,18,>,48,82,83,<,-1,50.666666666666664,40.666666666666664,>,10.0,43,36,>,7,56,50,>,6,176,166,>,10
0,8,55.333333333333336,57.333333333333336,<,-2.0,18,21,<,-3,83,86,<,-3,40.666666666666664,54.333333333333336,<,-13.666666666666671,36,53,<,-17,50,56,<,-6,166,207,<,-41
99,8,57.333333333333336,55.333333333333336,>,2.0,21,18,>,3,86,83,>,3,54.333333333333336,40.666666666666664,>,13.666666666666671,53,36,>,17,56,50,>,6,207,166,>,41
0,8,55.333333333333336,64.33333333333333,<,-8.999999999999993,18,29,<,-11,83,83,=,0,40.666666666666664,41.0,<,-0.3333333333333357,36,32,>,4,50,49,>,1,166,115,>,51
88,8,64.33333333333333,55.333333333333336,>,8.999999999999993,29,18,>,11,83,83,=,0,41.0,40.666666666666664,>,0.3333333333333357,32,36,<,-4,49,50,<,-1,115,166,<,-51
0,7,57.0,56.0,>,1.0,29,17,>,12,85,89,<,-4,44.0,37.666666666666664,>,6.333333333333336,35,33,>,2,59,45,>,14,119,125,<,-6
0,7,56.0,57.0,<,-1.0,17,29,<,-12,89,85,>,4,37.666666666666664,44.0,<,-6.333333333333336,33,35,<,-2,45,59,<,-14,125,119,>,6
0,7,57.0,59.333333333333336,<,-2.3333333333333357,29,35,<,-6,85,72,>,13,44.0,48.666666666666664,<,-4.666666666666664,35,44,<,-9,59,54,>,5,119,205,<,-86
32,7,59.333333333333336,57.0,>,2.3333333333333357,35,29,>,6,72,85,<,-13,48.666666666666664,44.0,>,4.666666666666664,44,35,>,9,54,59,<,-5,205,119,>,86
0,7,57.0,64.33333333333333,<,-7.333333333333329,29,29,=,0,85,83,>,2,44.0,41.0,>,3.0,35,32,>,3,59,49,>,10,119,115,>,4
88,7,64.33333333333333,57.0,>,7.333333333333329,29,29,=,0,83,85,<,-2,41.0,44.0,<,-3.0,32,35,<,-3,49,59,<,-10,115,119,<,-4
0,7,57.0,39.333333333333336,>,17.666666666666664,29,21,>,8,85,65,>,20,44.0,54.333333333333336,<,-10.333333333333336,35,53,<,-18,59,56,>,3,119,207,<,-88
0,7,39.333333333333336,57.0,<,-17.666666666666664,21,29,<,-8,65,85,<,-20,54.333333333333336,44.0,>,10.333333333333336,53,35,>,18,56,59,<,-3,207,119,>,88
0,7,57.0,63.333333333333336,<,-6.333333333333336,29,48,<,-19,85,76,>,9,44.0,50.666666666666664,<,-6.666666666666664,35,43,<,-8,59,56,>,3,119,176,<,-57
29,7,63.333333333333336,57.0,>,6.333333333333336,48,29,>,19,76,85,<,-9,50.666666666666664,44.0,>,6.666666666666664,43,35,>,8,56,59,<,-3,176,119,>,57
0,7,57.0,66.33333333333333,<,-9.333333333333329,29,48,<,-19,85,82,>,3,44.0,44.333333333333336,<,-0.3333333333333357,35,33,>,2,59,56,>,3,119,169,<,-50
67,7,66.33333333333333,57.0,>,9.333333333333329,48,29,>,19,82,85,<,-3,44.333333333333336,44.0,>,0.3333333333333357,33,35,<,-2,56,59,<,-3,169,119,>,50
0,6,30.0,40.0,<,-10.0,21,17,>,4,37,62,<,-25,54.333333333333336,37.666666666666664,>,16.66666666666667,53,33,>,20,56,45,>,11,207,125,>,82
0,6,40.0,30.0,>,10.0,17,21,<,-4,62,37,>,25,37.666666666666664,54.333333333333336,<,-16.66666666666667,33,53,<,-20,45,56,<,-11,125,207,<,-82
0,6,30.0,58.666666666666664,<,-28.666666666666664,21,48,<,-27,37,76,<,-39,54.333333333333336,50.666666666666664,>,3.6666666666666714,53,43,>,10,56,56,=,0,207,176,>,31
29,6,58.666666666666664,30.0,>,28.666666666666664,48,21,>,27,76,37,>,39,50.666666666666664,54.333333333333336,<,-3.6666666666666714,43,53,<,-10,56,56,=,0,176,207,<,-31
0,6,30.0,62.0,<,-32.0,21,43,<,-22,37,72,<,-35,54.333333333333336,48.666666666666664,>,5.666666666666671,53,44,>,9,56,54,>,2,207,205,>,2
0,6,62.0,30.0,>,32.0,43,21,>,22,72,37,>,35,48.666666666666664,54.333333333333336,<,-5.666666666666671,44,53,<,-9,54,56,<,-2,205,207,<,-2
0,6,30.0,57.0,<,-27.0,21,41,<,-20,37,82,<,-45,54.333333333333336,44.333333333333336,>,10.0,53,33,>,20,56,56,=,0,207,169,>,38
46,6,57.0,30.0,>,27.0,41,21,>,20,82,37,>,45,44.333333333333336,54.333333333333336,<,-10.0,33,53,<,-20,56,56,=,0,169,207,<,-38
0,6,30.0,66.0,<,-36.0,21,34,<,-13,37,83,<,-46,54.333333333333336,41.0,>,13.333333333333336,53,32,>,21,56,49,>,7,207,115,>,92
94,6,66.0,30.0,>,36.0,34,21,>,13,83,37,>,46,41.0,54.333333333333336,<,-13.333333333333336,32,53,<,-21,49,56,<,-7,115,207,<,-92
0,5,48.0,36.0,>,12.0,29,17,>,12,72,50,>,22,48.666666666666664,37.666666666666664,>,11.0,44,33,>,11,54,45,>,9,205,125,>,80
0,5,36.0,48.0,<,-12.0,17,29,<,-12,50,72,<,-22,37.666666666666664,48.666666666666664,<,-11.0,33,44,<,-11,45,54,<,-9,125,205,<,-80
0,5,48.0,68.66666666666667,<,-20.66666666666667,29,52,<,-23,72,78,<,-6,48.666666666666664,50.666666666666664,<,-2.0,44,43,>,1,54,56,<,-2,205,176,>,29
40,5,68.66666666666667,48.0,>,20.66666666666667,52,29,>,23,78,72,>,6,50.666666666666664,48.666666666666664,>,2.0,43,44,<,-1,56,54,>,2,176,205,<,-29
0,5,48.0,33.0,>,15.0,29,10,>,19,72,48,>,24,48.666666666666664,44.333333333333336,>,4.333333333333329,44,33,>,11,54,56,<,-2,205,169,>,36
0,5,33.0,48.0,<,-15.0,10,29,<,-19,48,72,<,-24,44.333333333333336,48.666666666666664,<,-4.333333333333329,33,44,<,-11,56,54,>,2,169,205,<,-36
0,5,48.0,57.0,<,-9.0,29,34,<,-5,72,83,<,-11,48.666666666666664,41.0,>,7.666666666666664,44,32,>,12,54,49,>,5,205,115,>,90
94,5,57.0,48.0,>,9.0,34,29,>,5,83,72,>,11,41.0,48.666666666666664,<,-7.666666666666664,32,44,<,-12,49,54,<,-5,115,205,<,-90
0,4,38.333333333333336,37.666666666666664,>,0.6666666666666714,10,17,<,-7,57,50,>,7,44.333333333333336,37.666666666666664,>,6.666666666666671,33,33,=,0,56,45,>,11,169,125,>,44
0,4,37.666666666666664,38.333333333333336,<,-0.6666666666666714,17,10,>,7,50,57,<,-7,37.666666666666664,44.333333333333336,<,-6.666666666666671,33,33,=,0,45,56,<,-11,125,169,<,-44
0,4,38.333333333333336,60.333333333333336,<,-22.0,10,27,<,-17,57,78,<,-21,44.333333333333336,50.666666666666664,<,-6.333333333333329,33,43,<,-10,56,56,=,0,169,176,<,-7
46,4,60.333333333333336,38.333333333333336,>,22.0,27,10,>,17,78,57,>,21,50.666666666666664,44.333333333333336,>,6.333333333333329,43,33,>,10,56,56,=,0,176,169,>,7
0,4,38.333333333333336,64.0,<,-25.666666666666664,10,54,<,-44,57,83,<,-26,44.333333333333336,41.0,>,3.3333333333333357,33,32,>,1,56,49,>,7,169,115,>,54
121,4,64.0,38.333333333333336,>,25.666666666666664,54,10,>,44,83,57,>,26,41.0,44.333333333333336,<,-3.3333333333333357,32,33,<,-1,49,56,<,-7,115,169,<,-54
0,3,34.666666666666664,46.666666666666664,<,-12.0,17,27,<,-10,46,76,<,-30,37.666666666666664,50.666666666666664,<,-13.0,33,43,<,-10,45,56,<,-11,125,176,<,-51
98,3,46.666666666666664,34.666666666666664,>,12.0,27,17,>,10,76,46,>,30,50.666666666666664,37.666666666666664,>,13.0,43,33,>,10,56,45,>,11,176,125,>,51
0,3,34.666666666666664,68.66666666666667,<,-34.00000000000001,17,55,<,-38,46,83,<,-37,37.666666666666664,41.0,<,-3.3333333333333357,33,32,>,1,45,49,<,-4,125,115,>,10
164,3,68.66666666666667,34.666666666666664,>,34.00000000000001,55,17,>,38,83,46,>,37,41.0,37.666666666666664,>,3.3333333333333357,32,33,<,-1,49,45,>,4,115,125,<,-10
0,2,49.0,35.333333333333336,>,13.666666666666664,24,27,<,-3,68,42,>,26,41.0,50.666666666666664,<,-9.666666666666664,32,43,<,-11,49,56,<,-7,115,176,<,-61
98,2,35.333333333333336,49.0,<,-13.666666666666664,27,24,>,3,42,68,<,-26,50.666666666666664,41.0,>,9.666666666666664,43,32,>,11,56,49,>,7,176,115,>,61
0,18,0.0,0.0,=,0.0,0,0,=,0,0,0,=,0,39.333333333333336,46.0,<,-6.666666666666664,30,31,<,-1,49,56,<,-7,253,166,>,87
12,18,0.0,0.0,=,0.0,0,0,=,0,0,0,=,0,46.0,39.333333333333336,>,6.666666666666664,31,30,>,1,56,49,>,7,166,253,<,-87
0,18,0.0,0.0,=,0.0,0,0,=,0,0,0,=,0,39.333333333333336,44.666666666666664,<,-5.333333333333329,30,38,<,-8,49,53,<,-4,253,165,>,88
31,18,0.0,0.0,=,0.0,0,0,=,0,0,0,=,0,44.666666666666664,39.333333333333336,>,5.333333333333329,38,30,>,8,53,49,>,4,165,253,<,-88
0,18,0.0,0.0,=,0.0,0,0,=,0,0,0,=,0,39.333333333333336,38.666666666666664,>,0.6666666666666714,30,34,<,-4,49,42,>,7,253,143,>,110
17,18,0.0,0.0,=,0.0,0,0,=,0,0,0,=,0,38.666666666666664,39.333333333333336,<,-0.6666666666666714,34,30,>,4,42,49,<,-7,143,253,<,-110
0,18,0.0,0.0,=,0.0,0,0,=,0,0,0,=,0,39.333333333333336,50.666666666666664,<,-11.333333333333329,30,41,<,-11,49,58,<,-9,253,169,>,84
38,18,0.0,0.0,=,0.0,0,0,=,0,0,0,=,0,50.666666666666664,39.333333333333336,>,11.333333333333329,41,30,>,11,58,49,>,9,169,253,<,-84
0,18,0.0,0.0,=,0.0,0,0,=,0,0,0,=,0,39.333333333333336,40.0,<,-0.6666666666666643,30,31,<,-1,49,47,>,2,253,274,<,-21
72,18,0.0,0.0,=,0.0,0,0,=,0,0,0,=,0,40.0,39.333333333333336,>,0.6666666666666643,31,30,>,1,47,49,<,-2,274,253,>,21
0,18,0.0,0.0,=,0.0,0,0,=,0,0,0,=,0,39.333333333333336,39.0,>,0.3333333333333357,30,31,<,-1,49,46,>,3,253,233,>,20
82,18,0.0,0.0,=,0.0,0,0,=,0,0,0,=,0,39.0,39.333333333333336,<,-0.3333333333333357,31,30,>,1,46,49,<,-3,233,253,<,-20
0,18,0.0,0.0,=,0.0,0,0,=,0,0,0,=,0,39.333333333333336,39.333333333333336,=,0.0,30,32,<,-2,49,53,<,-4,253,151,>,102
15,18,0.0,0.0,=,0.0,0,0,=,0,0,0,=,0,39.333333333333336,39.333333333333336,=,0.0,32,30,>,2,53,49,>,4,151,253,<,-102
0,18,0.0,0.0,=,0.0,0,0,=,0,0,0,=,0,39.333333333333336,47.333333333333336,<,-8.0,30,40,<,-10,49,54,<,-5,253,168,>,85
54,18,0.0,0.0,=,0.0,0,0,=,0,0,0,=,0,47.333333333333336,39.333333333333336,>,8.0,40,30,>,10,54,49,>,5,168,253,<,-85
0,18,0.0,0.0,=,0.0,0,0,=,0,0,0,=,0,39.333333333333336,43.0,<,-3.6666666666666643,30,34,<,-4,49,55,<,-6,253,134,>,119
27,18,0.0,0.0,=,0.0,0,0,=,0,0,0,=,0,43.0,39.333333333333336,>,3.6666666666666643,34,30,>,4,55,49,>,6,134,253,<,-119
0,18,0.0,0.0,=,0.0,0,0,=,0,0,0,=,0,39.333333333333336,44.0,<,-4.666666666666664,30,32,<,-2,49,54,<,-5,253,248,>,5
99,18,0.0,0.0,=,0.0,0,0,=,0,0,0,=,0,44.0,39.333333333333336,>,4.666666666666664,32,30,>,2,54,49,>,5,248,253,<,-5
0,18,0.0,0.0,=,0.0,0,0,=,0,0,0,=,0,39.333333333333336,44.666666666666664,<,-5.333333333333329,30,39,<,-9,49,54,<,-5,253,110,>,143
17,18,0.0,0.0,=,0.0,0,0,=,0,0,0,=,0,44.666666666666664,39.333333333333336,>,5.333333333333329,39,30,>,9,54,49,>,5,110,253,<,-143
0,18,0.0,0.0,=,0.0,0,0,=,0,0,0,=,0,39.333333333333336,49.333333333333336,<,-10.0,30,43,<,-13,49,56,<,-7,253,271,<,-18
112,18,0.0,0.0,=,0.0,0,0,=,0,0,0,=,0,49.333333333333336,39.333333333333336,>,10.0,43,30,>,13,56,49,>,7,271,253,>,18
0,18,0.0,0.0,=,0.0,0,0,=,0,0,0,=,0,39.333333333333336,47.0,<,-7.666666666666664,30,42,<,-12,49,56,<,-7,253,142,>,111
18,18,0.0,0.0,=,0.0,0,0,=,0,0,0,=,0,47.0,39.333333333333336,>,7.666666666666664,42,30,>,12,56,49,>,7,142,253,<,-111
0,18,0.0,0.0,=,0.0,0,0,=,0,0,0,=,0,39.333333333333336,36.333333333333336,>,3.0,30,30,=,0,49,47,>,2,253,149,>,104
51,18,0.0,0.0,=,0.0,0,0,=,0,0,0,=,0,36.333333333333336,39.333333333333336,<,-3.0,30,30,=,0,47,49,<,-2,149,253,<,-104
0,18,0.0,0.0,=,0.0,0,0,=,0,0,0,=,0,39.333333333333336,40.333333333333336,<,-1.0,30,33,<,-3,49,54,<,-5,253,168,>,85
15,18,0.0,0.0,=,0.0,0,0,=,0,0,0,=,0,40.333333333333336,39.333333333333336,>,1.0,33,30,>,3,54,49,>,5,168,253,<,-85
0,18,0.0,0.0,=,0.0,0,0,=,0,0,0,=,0,39.333333333333336,48.333333333333336,<,-9.0,30,39,<,-9,49,53,<,-4,253,184,>,69
12,18,0.0,0.0,=,0.0,0,0,=,0,0,0,=,0,48.333333333333336,39.333333333333336,>,9.0,39,30,>,9,53,49,>,4,184,253,<,-69
0,18,0.0,0.0,=,0.0,0,0,=,0,0,0,=,0,39.333333333333336,51.333333333333336,<,-12.0,30,46,<,-16,49,54,<,-5,253,142,>,111
59,18,0.0,0.0,=,0.0,0,0,=,0,0,0,=,0,51.333333333333336,39.333333333333336,>,12.0,46,30,>,16,54,49,>,5,142,253,<,-111
0,17,3.3333333333333335,9.333333333333334,<,-6.0,0,0,=,0,10,28,<,-18,40.333333333333336,46.0,<,-5.666666666666664,33,31,>,2,54,56,<,-2,168,166,>,2
154,17,9.333333333333334,3.3333333333333335,>,6.0,0,0,=,0,28,10,>,18,46.0,40.333333333333336,>,5.666666666666664,31,33,<,-2,56,54,>,2,166,168,<,-2
0,17,3.3333333333333335,9.333333333333334,<,-6.0,0,0,=,0,10,28,<,-18,40.333333333333336,48.333333333333336,<,-8.0,33,39,<,-6,54,53,>,1,168,184,<,-16
76,17,9.333333333333334,3.3333333333333335,>,6.0,0,0,=,0,28,10,>,18,48.333333333333336,40.333333333333336,>,8.0,39,33,>,6,53,54,<,-1,184,168,>,16
0,17,3.3333333333333335,9.0,<,-5.666666666666666,0,0,=,0,10,27,<,-17,40.333333333333336,39.333333333333336,>,1.0,33,32,>,1,54,53,>,1,168,151,>,17
41,17,9.0,3.3333333333333335,>,5.666666666666666,0,0,=,0,27,10,>,17,39.333333333333336,40.333333333333336,<,-1.0,32,33,<,-1,53,54,<,-1,151,168,<,-17
0,17,3.3333333333333335,9.666666666666666,<,-6.333333333333332,0,0,=,0,10,29,<,-19,40.333333333333336,38.666666666666664,>,1.6666666666666714,33,34,<,-1,54,42,>,12,168,143,>,25
44,17,9.666666666666666,3.3333333333333335,>,6.333333333333332,0,0,=,0,29,10,>,19,38.666666666666664,40.333333333333336,<,-1.6666666666666714,34,33,>,1,42,54,<,-12,143,168,<,-25
0,17,3.3333333333333335,16.333333333333332,<,-12.999999999999998,0,0,=,0,10,49,<,-39,40.333333333333336,44.666666666666664,<,-4.333333333333329,33,39,<,-6,54,54,=,0,168,110,>,58
0,17,16.333333333333332,3.3333333333333335,>,12.999999999999998,0,0,=,0,49,10,>,39,44.666666666666664,40.333333333333336,>,4.333333333333329,39,33,>,6,54,54,=,0,110,168,<,-58
0,17,3.3333333333333335,27.0,<,-23.666666666666668,0,0,=,0,10,81,<,-71,40.333333333333336,47.0,<,-6.666666666666664,33,42,<,-9,54,56,<,-2,168,142,>,26
0,17,27.0,3.3333333333333335,>,23.666666666666668,0,0,=,0,81,10,>,71,47.0,40.333333333333336,>,6.666666666666664,42,33,>,9,56,54,>,2,142,168,<,-26
0,17,3.3333333333333335,25.0,<,-21.666666666666668,0,0,=,0,10,75,<,-65,40.333333333333336,43.0,<,-2.6666666666666643,33,34,<,-1,54,55,<,-1,168,134,>,34
83,17,25.0,3.3333333333333335,>,21.666666666666668,0,0,=,0,75,10,>,65,43.0,40.333333333333336,>,2.6666666666666643,34,33,>,1,55,54,>,1,134,168,<,-34
0,17,3.3333333333333335,21.333333333333332,<,-18.0,0,0,=,0,10,64,<,-54,40.333333333333336,44.666666666666664,<,-4.333333333333329,33,38,<,-5,54,53,>,1,168,165,>,3
81,17,21.333333333333332,3.3333333333333335,>,18.0,0,0,=,0,64,10,>,54,44.666666666666664,40.333333333333336,>,4.333333333333329,38,33,>,5,53,54,<,-1,165,168,<,-3
0,17,3.3333333333333335,11.666666666666666,<,-8.333333333333332,0,0,=,0,10,35,<,-25,40.333333333333336,50.666666666666664,<,-10.333333333333329,33,41,<,-8,54,58,<,-4,168,169,<,-1
43,17,11.666666666666666,3.3333333333333335,>,8.333333333333332,0,0,=,0,35,10,>,25,50.666666666666664,40.333333333333336,>,10.333333333333329,41,33,>,8,58,54,>,4,169,168,>,1
0,17,3.3333333333333335,17.666666666666668,<,-14.333333333333334,0,0,=,0,10,53,<,-43,40.333333333333336,36.333333333333336,>,4.0,33,30,>,3,54,47,>,7,168,149,>,19
92,17,17.666666666666668,3.3333333333333335,>,14.333333333333334,0,0,=,0,53,10,>,43,36.333333333333336,40.333333333333336,<,-4.0,30,33,<,-3,47,54,<,-7,149,168,<,-19
0,17,3.3333333333333335,4.666666666666667,<,-1.3333333333333335,0,0,=,0,10,14,<,-4,40.333333333333336,47.333333333333336,<,-7.0,33,40,<,-7,54,54,=,0,168,168,=,0
54,17,4.666666666666667,3.3333333333333335,>,1.3333333333333335,0,0,=,0,14,10,>,4,47.333333333333336,40.333333333333336,>,7.0,40,33,>,7,54,54,=,0,168,168,=,0
0,17,3.3333333333333335,24.666666666666668,<,-21.333333333333336,0,0,=,0,10,74,<,-64,40.333333333333336,51.333333333333336,<,-11.0,33,46,<,-13,54,54,=,0,168,142,>,26
103,17,24.666666666666668,3.3333333333333335,>,21.333333333333336,0,0,=,0,74,10,>,64,51.333333333333336,40.333333333333336,>,11.0,46,33,>,13,54,54,=,0,142,168,<,-26
0,17,3.3333333333333335,14.333333333333334,<,-11.0,0,0,=,0,10,43,<,-33,40.333333333333336,40.0,>,0.3333333333333357,33,31,>,2,54,47,>,7,168,274,<,-106
136,17,14.333333333333334,3.3333333333333335,>,11.0,0,0,=,0,43,10,>,33,40.0,40.333333333333336,<,-0.3333333333333357,31,33,<,-2,47,54,<,-7,274,168,>,106
0,17,3.3333333333333335,28.333333333333332,<,-25.0,0,0,=,0,10,85,<,-75,40.333333333333336,39.0,>,1.3333333333333357,33,31,>,2,54,46,>,8,168,233,<,-65
105,17,28.333333333333332,3.3333333333333335,>,25.0,0,0,=,0,85,10,>,75,39.0,40.333333333333336,<,-1.3333333333333357,31,33,<,-2,46,54,<,-8,233,168,>,65
0,17,3.3333333333333335,20.0,<,-16.666666666666668,0,0,=,0,10,60,<,-50,40.333333333333336,44.0,<,-3.6666666666666643,33,32,>,1,54,54,=,0,168,248,<,-80
160,17,20.0,3.3333333333333335,>,16.666666666666668,0,0,=,0,60,10,>,50,44.0,40.333333333333336,>,3.6666666666666643,32,33,<,-1,54,54,=,0,248,168,>,80
0,17,3.3333333333333335,6.0,<,-2.6666666666666665,0,0,=,0,10,18,<,-8,40.333333333333336,49.333333333333336,<,-9.0,33,43,<,-10,54,56,<,-2,168,271,<,-103
119,17,6.0,3.3333333333333335,>,2.6666666666666665,0,0,=,0,18,10,>,8,49.333333333333336,40.333333333333336,>,9.0,43,33,>,10,56,54,>,2,271,168,>,103
0,16,18.666666666666668,22.0,<,-3.333333333333332,0,0,=,0,56,66,<,-10,44.666666666666664,47.0,<,-2.3333333333333357,39,42,<,-3,54,56,<,-2,110,142,<,-32
0,16,22.0,18.666666666666668,>,3.333333333333332,0,0,=,0,66,56,>,10,47.0,44.666666666666664,>,2.3333333333333357,42,39,>,3,56,54,>,2,142,110,>,32
0,16,18.666666666666668,18.0,>,0.6666666666666679,0,0,=,0,56,54,>,2,44.666666666666664,39.333333333333336,>,5.333333333333329,39,32,>,7,54,53,>,1,110,151,<,-41
41,16,18.0,18.666666666666668,<,-0.6666666666666679,0,0,=,0,54,56,<,-2,39.333333333333336,44.666666666666664,<,-5.333333333333329,32,39,<,-7,53,54,<,-1,151,110,>,41
0,16,18.666666666666668,9.333333333333334,>,9.333333333333334,0,0,=,0,56,28,>,28,44.666666666666664,50.666666666666664,<,-6.0,39,41,<,-2,54,58,<,-4,110,169,<,-59
43,16,9.333333333333334,18.666666666666668,<,-9.333333333333334,0,0,=,0,28,56,<,-28,50.666666666666664,44.666666666666664,>,6.0,41,39,>,2,58,54,>,4,169,110,>,59
0,16,18.666666666666668,17.333333333333332,>,1.3333333333333357,0,0,=,0,56,52,>,4,44.666666666666664,38.666666666666664,>,6.0,39,34,>,5,54,42,>,12,110,143,<,-33
44,16,17.333333333333332,18.666666666666668,<,-1.3333333333333357,0,0,=,0,52,56,<,-4,38.666666666666664,44.666666666666664,<,-6.0,34,39,<,-5,42,54,<,-12,143,110,>,33
0,16,18.666666666666668,26.666666666666668,<,-8.0,0,0,=,0,56,80,<,-24,44.666666666666664,47.333333333333336,<,-2.6666666666666714,39,40,<,-1,54,54,=,0,110,168,<,-58
54,16,26.666666666666668,18.666666666666668,>,8.0,0,0,=,0,80,56,>,24,47.333333333333336,44.666666666666664,>,2.6666666666666714,40,39,>,1,54,54,=,0,168,110,>,58
0,16,18.666666666666668,25.333333333333332,<,-6.666666666666664,0,0,=,0,56,76,<,-20,44.666666666666664,48.333333333333336,<,-3.6666666666666714,39,39,=,0,54,53,>,1,110,184,<,-74
47,16,25.333333333333332,18.666666666666668,>,6.666666666666664,0,0,=,0,76,56,>,20,48.333333333333336,44.666666666666664,>,3.6666666666666714,39,39,=,0,53,54,<,-1,184,110,>,74
0,16,18.666666666666668,4.0,>,14.666666666666668,0,0,=,0,56,12,>,44,44.666666666666664,44.666666666666664,=,0.0,39,38,>,1,54,53,>,1,110,165,<,-55
0,16,4.0,18.666666666666668,<,-14.666666666666668,0,0,=,0,12,56,<,-44,44.666666666666664,44.666666666666664,=,0.0,38,39,<,-1,53,54,<,-1,165,110,>,55
0,16,18.666666666666668,15.0,>,3.666666666666668,0,0,=,0,56,45,>,11,44.666666666666664,43.0,>,1.6666666666666643,39,34,>,5,54,55,<,-1,110,134,<,-24
83,16,15.0,18.666666666666668,<,-3.666666666666668,0,0,=,0,45,56,<,-11,43.0,44.666666666666664,<,-1.6666666666666643,34,39,<,-5,55,54,>,1,134,110,>,24
0,16,18.666666666666668,10.333333333333334,>,8.333333333333334,0,0,=,0,56,31,>,25,44.666666666666664,36.333333333333336,>,8.333333333333329,39,30,>,9,54,47,>,7,110,149,<,-39
120,16,10.333333333333334,18.666666666666668,<,-8.333333333333334,0,0,=,0,31,56,<,-25,36.333333333333336,44.666666666666664,<,-8.333333333333329,30,39,<,-9,47,54,<,-7,149,110,>,39
0,16,18.666666666666668,14.333333333333334,>,4.333333333333334,0,0,=,0,56,43,>,13,44.666666666666664,51.333333333333336,<,-6.666666666666671,39,46,<,-7,54,54,=,0,110,142,<,-32
88,16,14.333333333333334,18.666666666666668,<,-4.333333333333334,0,0,=,0,43,56,<,-13,51.333333333333336,44.666666666666664,>,6.666666666666671,46,39,>,7,54,54,=,0,142,110,>,32
0,16,18.666666666666668,6.0,>,12.666666666666668,0,0,=,0,56,18,>,38,44.666666666666664,39.0,>,5.666666666666664,39,31,>,8,54,46,>,8,110,233,<,-123
105,16,6.0,18.666666666666668,<,-12.666666666666668,0,0,=,0,18,56,<,-38,39.0,44.666666666666664,<,-5.666666666666664,31,39,<,-8,46,54,<,-8,233,110,>,123
0,16,18.666666666666668,25.333333333333332,<,-6.666666666666664,0,0,=,0,56,76,<,-20,44.666666666666664,49.333333333333336,<,-4.666666666666671,39,43,<,-4,54,56,<,-2,110,271,<,-161
119,16,25.333333333333332,18.666666666666668,>,6.666666666666664,0,0,=,0,76,56,>,20,49.333333333333336,44.666666666666664,>,4.666666666666671,43,39,>,4,56,54,>,2,271,110,>,161
0,16,18.666666666666668,24.666666666666668,<,-6.0,0,0,=,0,56,74,<,-18,44.666666666666664,40.0,>,4.666666666666664,39,31,>,8,54,47,>,7,110,274,<,-164
136,16,24.666666666666668,18.666666666666668,>,6.0,0,0,=,0,74,56,>,18,40.0,44.666666666666664,<,-4.666666666666664,31,39,<,-8,47,54,<,-7,274,110,>,164
0,16,18.666666666666668,8.0,>,10.666666666666668,0,0,=,0,56,24,>,32,44.666666666666664,46.0,<,-1.3333333333333357,39,31,>,8,54,56,<,-2,110,166,<,-56
123,16,8.0,18.666666666666668,<,-10.666666666666668,0,0,=,0,24,56,<,-32,46.0,44.666666666666664,>,1.3333333333333357,31,39,<,-8,56,54,>,2,166,110,>,56
0,16,18.666666666666668,15.666666666666666,>,3.0000000000000018,0,0,=,0,56,47,>,9,44.666666666666664,44.0,>,0.6666666666666643,39,32,>,7,54,54,=,0,110,248,<,-138
160,16,15.666666666666666,18.666666666666668,<,-3.0000000000000018,0,0,=,0,47,56,<,-9,44.0,44.666666666666664,<,-0.6666666666666643,32,39,<,-7,54,54,=,0,248,110,>,138
0,15,32.333333333333336,43.333333333333336,<,-11.0,0,0,=,0,85,66,>,19,44.666666666666664,47.0,<,-2.3333333333333357,38,42,<,-4,53,56,<,-3,165,142,>,23
0,15,43.333333333333336,32.333333333333336,>,11.0,0,0,=,0,66,85,<,-19,47.0,44.666666666666664,>,2.3333333333333357,42,38,>,4,56,53,>,3,142,165,<,-23
0,15,32.333333333333336,26.333333333333332,>,6.0000000000000036,0,0,=,0,85,54,>,31,44.666666666666664,39.333333333333336,>,5.333333333333329,38,32,>,6,53,53,=,0,165,151,>,14
44,15,26.333333333333332,32.333333333333336,<,-6.0000000000000036,0,0,=,0,54,85,<,-31,39.333333333333336,44.666666666666664,<,-5.333333333333329,32,38,<,-6,53,53,=,0,151,165,<,-14
0,15,32.333333333333336,19.666666666666668,>,12.666666666666668,0,0,=,0,85,31,>,54,44.666666666666664,50.666666666666664,<,-6.0,38,41,<,-3,53,58,<,-5,165,169,<,-4
66,15,19.666666666666668,32.333333333333336,<,-12.666666666666668,0,0,=,0,31,85,<,-54,50.666666666666664,44.666666666666664,>,6.0,41,38,>,3,58,53,>,5,169,165,>,4
0,15,32.333333333333336,36.0,<,-3.6666666666666643,0,0,=,0,85,56,>,29,44.666666666666664,38.666666666666664,>,6.0,38,34,>,4,53,42,>,11,165,143,>,22
44,15,36.0,32.333333333333336,>,3.6666666666666643,0,0,=,0,56,85,<,-29,38.666666666666664,44.666666666666664,<,-6.0,34,38,<,-4,42,53,<,-11,143,165,<,-22
0,15,32.333333333333336,34.666666666666664,<,-2.3333333333333286,0,0,=,0,85,76,>,9,44.666666666666664,48.333333333333336,<,-3.6666666666666714,38,39,<,-1,53,53,=,0,165,184,<,-19
55,15,34.666666666666664,32.333333333333336,>,2.3333333333333286,0,0,=,0,76,85,<,-9,48.333333333333336,44.666666666666664,>,3.6666666666666714,39,38,>,1,53,53,=,0,184,165,>,19
0,15,32.333333333333336,35.0,<,-2.6666666666666643,0,0,=,0,85,80,>,5,44.666666666666664,47.333333333333336,<,-2.6666666666666714,38,40,<,-2,53,54,<,-1,165,168,<,-3
112,15,35.0,32.333333333333336,>,2.6666666666666643,0,0,=,0,80,85,<,-5,47.333333333333336,44.666666666666664,>,2.6666666666666714,40,38,>,2,54,53,>,1,168,165,>,3
0,15,32.333333333333336,33.333333333333336,<,-1.0,0,0,=,0,85,55,>,30,44.666666666666664,43.0,>,1.6666666666666643,38,34,>,4,53,55,<,-2,165,134,>,31
121,15,33.333333333333336,32.333333333333336,>,1.0,0,0,=,0,55,85,<,-30,43.0,44.666666666666664,<,-1.6666666666666643,34,38,<,-4,55,53,>,2,134,165,<,-31
0,15,32.333333333333336,20.0,>,12.333333333333336,0,0,=,0,85,43,>,42,44.666666666666664,51.333333333333336,<,-6.666666666666671,38,46,<,-8,53,54,<,-1,165,142,>,23
0,15,20.0,32.333333333333336,<,-12.333333333333336,0,0,=,0,43,85,<,-42,51.333333333333336,44.666666666666664,>,6.666666666666671,46,38,>,8,54,53,>,1,142,165,<,-23
0,15,32.333333333333336,31.666666666666668,>,0.6666666666666679,0,0,=,0,85,77,>,8,44.666666666666664,39.0,>,5.666666666666664,38,31,>,7,53,46,>,7,165,233,<,-68
133,15,31.666666666666668,32.333333333333336,<,-0.6666666666666679,0,0,=,0,77,85,<,-8,39.0,44.666666666666664,<,-5.666666666666664,31,38,<,-7,46,53,<,-7,233,165,>,68
0,15,32.333333333333336,54.666666666666664,<,-22.33333333333333,0,0,=,0,85,88,<,-3,44.666666666666664,49.333333333333336,<,-4.666666666666671,38,43,<,-5,53,56,<,-3,165,271,<,-106
119,15,54.666666666666664,32.333333333333336,>,22.33333333333333,0,0,=,0,88,85,>,3,49.333333333333336,44.666666666666664,>,4.666666666666671,43,38,>,5,56,53,>,3,271,165,>,106
0,15,32.333333333333336,30.333333333333332,>,2.0000000000000036,0,0,=,0,85,60,>,25,44.666666666666664,36.333333333333336,>,8.333333333333329,38,30,>,8,53,47,>,6,165,149,>,16
122,15,30.333333333333332,32.333333333333336,<,-2.0000000000000036,0,0,=,0,60,85,<,-25,36.333333333333336,44.666666666666664,<,-8.333333333333329,30,38,<,-8,47,53,<,-6,149,165,<,-16
0,15,32.333333333333336,34.666666666666664,<,-2.3333333333333286,0,0,=,0,85,80,>,5,44.666666666666664,46.0,<,-1.3333333333333357,38,31,>,7,53,56,<,-3,165,166,<,-1
123,15,34.666666666666664,32.333333333333336,>,2.3333333333333286,0,0,=,0,80,85,<,-5,46.0,44.666666666666664,>,1.3333333333333357,31,38,<,-7,56,53,>,3,166,165,>,1
0,15,32.333333333333336,39.666666666666664,<,-7.333333333333329,0,0,=,0,85,74,>,11,44.666666666666664,40.0,>,4.666666666666664,38,31,>,7,53,47,>,6,165,274,<,-109
224,15,39.666666666666664,32.333333333333336,>,7.333333333333329,0,0,=,0,74,85,<,-11,40.0,44.666666666666664,<,-4.666666666666664,31,38,<,-7,47,53,<,-6,274,165,>,109
0,15,32.333333333333336,31.333333333333332,>,1.0000000000000036,0,0,=,0,85,47,>,38,44.666666666666664,44.0,>,0.6666666666666643,38,32,>,6,53,54,<,-1,165,248,<,-83
183,15,31.333333333333332,32.333333333333336,<,-1.0000000000000036,0,0,=,0,47,85,<,-38,44.0,44.666666666666664,<,-0.6666666666666643,32,38,<,-6,54,53,>,1,248,165,>,83
0,14,26.666666666666668,13.666666666666666,>,13.000000000000002,0,0,=,0,64,24,>,40,47.0,51.333333333333336,<,-4.333333333333336,42,46,<,-4,56,54,>,2,142,142,=,0
0,14,13.666666666666666,26.666666666666668,<,-13.000000000000002,0,0,=,0,24,64,<,-40,51.333333333333336,47.0,>,4.333333333333336,46,42,>,4,54,56,<,-2,142,142,=,0
0,14,26.666666666666668,37.333333333333336,<,-10.666666666666668,0,0,=,0,64,56,>,8,47.0,38.666666666666664,>,8.333333333333336,42,34,>,8,56,42,>,14,142,143,<,-1
44,14,37.333333333333336,26.666666666666668,>,10.666666666666668,0,0,=,0,56,64,<,-8,38.666666666666664,47.0,<,-8.333333333333336,34,42,<,-8,42,56,<,-14,143,142,>,1
0,14,26.666666666666668,22.333333333333332,>,4.333333333333336,0,0,=,0,64,42,>,22,47.0,39.333333333333336,>,7.666666666666664,42,32,>,10,56,53,>,3,142,151,<,-9
44,14,22.333333333333332,26.666666666666668,<,-4.333333333333336,0,0,=,0,42,64,<,-22,39.333333333333336,47.0,<,-7.666666666666664,32,42,<,-10,53,56,<,-3,151,142,>,9
0,14,26.666666666666668,38.333333333333336,<,-11.666666666666668,0,0,=,0,64,87,<,-23,47.0,48.333333333333336,<,-1.3333333333333357,42,39,>,3,56,53,>,3,142,184,<,-42
55,14,38.333333333333336,26.666666666666668,>,11.666666666666668,0,0,=,0,87,64,>,23,48.333333333333336,47.0,>,1.3333333333333357,39,42,<,-3,53,56,<,-3,184,142,>,42
0,14,26.666666666666668,28.0,<,-1.3333333333333321,0,0,=,0,64,53,>,11,47.0,50.666666666666664,<,-3.6666666666666643,42,41,>,1,56,58,<,-2,142,169,<,-27
66,14,28.0,26.666666666666668,>,1.3333333333333321,0,0,=,0,53,64,<,-11,50.666666666666664,47.0,>,3.6666666666666643,41,42,<,-1,58,56,>,2,169,142,>,27
0,14,26.666666666666668,21.333333333333332,>,5.333333333333336,0,0,=,0,64,39,>,25,47.0,47.333333333333336,<,-0.3333333333333357,42,40,>,2,56,54,>,2,142,168,<,-26
80,14,21.333333333333332,26.666666666666668,<,-5.333333333333336,0,0,=,0,39,64,<,-25,47.333333333333336,47.0,>,0.3333333333333357,40,42,<,-2,54,56,<,-2,168,142,>,26
0,14,26.666666666666668,57.333333333333336,<,-30.666666666666668,0,0,=,0,64,88,<,-24,47.0,49.333333333333336,<,-2.3333333333333357,42,43,<,-1,56,56,=,0,142,271,<,-129
119,14,57.333333333333336,26.666666666666668,>,30.666666666666668,0,0,=,0,88,64,>,24,49.333333333333336,47.0,>,2.3333333333333357,43,42,>,1,56,56,=,0,271,142,>,129
0,14,26.666666666666668,35.666666666666664,<,-8.999999999999996,0,0,=,0,64,55,>,9,47.0,43.0,>,4.0,42,34,>,8,56,55,>,1,142,134,>,8
121,14,35.666666666666664,26.666666666666668,>,8.999999999999996,0,0,=,0,55,64,<,-9,43.0,47.0,<,-4.0,34,42,<,-8,55,56,<,-1,134,142,<,-8
0,14,26.666666666666668,35.666666666666664,<,-8.999999999999996,0,0,=,0,64,60,>,4,47.0,36.333333333333336,>,10.666666666666664,42,30,>,12,56,47,>,9,142,149,<,-7
122,14,35.666666666666664,26.666666666666668,>,8.999999999999996,0,0,=,0,60,64,<,-4,36.333333333333336,47.0,<,-10.666666666666664,30,42,<,-12,47,56,<,-9,149,142,>,7
0,14,26.666666666666668,33.333333333333336,<,-6.666666666666668,0,0,=,0,64,80,<,-16,47.0,46.0,>,1.0,42,31,>,11,56,56,=,0,142,166,<,-24
0,14,33.333333333333336,26.666666666666668,>,6.666666666666668,0,0,=,0,80,64,>,16,46.0,47.0,<,-1.0,31,42,<,-11,56,56,=,0,166,142,>,24
0,14,26.666666666666668,51.666666666666664,<,-24.999999999999996,0,0,=,0,64,78,<,-14,47.0,39.0,>,8.0,42,31,>,11,56,46,>,10,142,233,<,-91
133,14,51.666666666666664,26.666666666666668,>,24.999999999999996,0,0,=,0,78,64,>,14,39.0,47.0,<,-8.0,31,42,<,-11,46,56,<,-10,233,142,>,91
0,14,26.666666666666668,23.666666666666668,>,3.0,0,0,=,0,64,47,>,17,47.0,44.0,>,3.0,42,32,>,10,56,54,>,2,142,248,<,-106
118,14,23.666666666666668,26.666666666666668,<,-3.0,0,0,=,0,47,64,<,-17,44.0,47.0,<,-3.0,32,42,<,-10,54,56,<,-2,248,142,>,106
0,14,26.666666666666668,42.0,<,-15.333333333333332,0,0,=,0,64,81,<,-17,47.0,40.0,>,7.0,42,31,>,11,56,47,>,9,142,274,<,-132
224,14,42.0,26.666666666666668,>,15.333333333333332,0,0,=,0,81,64,>,17,40.0,47.0,<,-7.0,31,42,<,-11,47,56,<,-9,274,142,>,132
0,13,56.666666666666664,21.333333333333332,>,35.33333333333333,20,17,>,3,80,24,>,56,46.0,51.333333333333336,<,-5.333333333333336,31,46,<,-15,56,54,>,2,166,142,>,24
0,13,21.333333333333332,56.666666666666664,<,-35.33333333333333,17,20,<,-3,24,80,<,-56,51.333333333333336,46.0,>,5.333333333333336,46,31,>,15,54,56,<,-2,142,166,<,-24
0,13,56.666666666666664,57.333333333333336,<,-0.6666666666666714,20,56,<,-36,80,60,>,20,46.0,38.666666666666664,>,7.333333333333336,31,34,<,-3,56,42,>,14,166,143,>,23
134,13,57.333333333333336,56.666666666666664,>,0.6666666666666714,56,20,>,36,60,80,<,-20,38.666666666666664,46.0,<,-7.333333333333336,34,31,>,3,42,56,<,-14,143,166,<,-23
0,13,56.666666666666664,26.666666666666668,>,29.999999999999996,20,13,>,7,80,42,>,38,46.0,39.333333333333336,>,6.666666666666664,31,32,<,-1,56,53,>,3,166,151,>,15
0,13,26.666666666666668,56.666666666666664,<,-29.999999999999996,13,20,<,-7,42,80,<,-38,39.333333333333336,46.0,<,-6.666666666666664,32,31,>,1,53,56,<,-3,151,166,<,-15
0,13,56.666666666666664,43.666666666666664,>,13.0,20,16,>,4,80,87,<,-7,46.0,48.333333333333336,<,-2.3333333333333357,31,39,<,-8,56,53,>,3,166,184,<,-18
55,13,43.666666666666664,56.666666666666664,<,-13.0,16,20,<,-4,87,80,>,7,48.333333333333336,46.0,>,2.3333333333333357,39,31,>,8,53,56,<,-3,184,166,>,18
0,13,56.666666666666664,36.0,>,20.666666666666664,20,24,<,-4,80,53,>,27,46.0,50.666666666666664,<,-4.666666666666664,31,41,<,-10,56,58,<,-2,166,169,<,-3
66,13,36.0,56.666666666666664,<,-20.666666666666664,24,20,>,4,53,80,<,-27,50.666666666666664,46.0,>,4.666666666666664,41,31,>,10,58,56,>,2,169,166,>,3
0,13,56.666666666666664,36.333333333333336,>,20.33333333333333,20,25,<,-5,80,45,>,35,46.0,47.333333333333336,<,-1.3333333333333357,31,40,<,-9,56,54,>,2,166,168,<,-2
80,13,36.333333333333336,56.666666666666664,<,-20.33333333333333,25,20,>,5,45,80,<,-35,47.333333333333336,46.0,>,1.3333333333333357,40,31,>,9,54,56,<,-2,168,166,>,2
0,13,56.666666666666664,29.666666666666668,>,26.999999999999996,20,18,>,2,80,47,>,33,46.0,44.0,>,2.0,31,32,<,-1,56,54,>,2,166,248,<,-82
136,13,29.666666666666668,56.666666666666664,<,-26.999999999999996,18,20,<,-2,47,80,<,-33,44.0,46.0,<,-2.0,32,31,>,1,54,56,<,-2,248,166,>,82
0,13,56.666666666666664,67.66666666666667,<,-11.000000000000007,20,31,<,-11,80,88,<,-8,46.0,49.333333333333336,<,-3.3333333333333357,31,43,<,-12,56,56,=,0,166,271,<,-105
205,13,67.66666666666667,56.666666666666664,>,11.000000000000007,31,20,>,11,88,80,>,8,49.333333333333336,46.0,>,3.3333333333333357,43,31,>,12,56,56,=,0,271,166,>,105
0,13,56.666666666666664,54.333333333333336,>,2.3333333333333286,20,52,<,-32,80,56,>,24,46.0,43.0,>,3.0,31,34,<,-3,56,55,>,1,166,134,>,32
149,13,54.333333333333336,56.666666666666664,<,-2.3333333333333286,52,20,>,32,56,80,<,-24,43.0,46.0,<,-3.0,34,31,>,3,55,56,<,-1,134,166,<,-32
0,13,56.666666666666664,63.0,<,-6.333333333333336,20,47,<,-27,80,82,<,-2,46.0,36.333333333333336,>,9.666666666666664,31,30,>,1,56,47,>,9,166,149,>,17
177,13,63.0,56.666666666666664,>,6.333333333333336,47,20,>,27,82,80,>,2,36.333333333333336,46.0,<,-9.666666666666664,30,31,<,-1,47,56,<,-9,149,166,<,-17
0,13,56.666666666666664,56.0,>,0.6666666666666643,20,13,>,7,80,78,>,2,46.0,39.0,>,7.0,31,31,=,0,56,46,>,10,166,233,<,-67
79,13,56.0,56.666666666666664,<,-0.6666666666666643,13,20,<,-7,78,80,<,-2,39.0,46.0,<,-7.0,31,31,=,0,46,56,<,-10,233,166,>,67
0,13,56.666666666666664,71.66666666666667,<,-15.000000000000007,20,45,<,-25,80,89,<,-9,46.0,40.0,>,6.0,31,31,=,0,56,47,>,9,166,274,<,-108
224,13,71.66666666666667,56.666666666666664,>,15.000000000000007,45,20,>,25,89,80,>,9,40.0,46.0,<,-6.0,31,31,=,0,47,56,<,-9,274,166,>,108
0,12,25.333333333333332,18.666666666666668,>,6.666666666666664,13,16,<,-3,38,23,>,15,39.333333333333336,51.333333333333336,<,-12.0,32,46,<,-14,53,54,<,-1,151,142,>,9
0,12,18.666666666666668,25.333333333333332,<,-6.666666666666664,16,13,>,3,23,38,<,-15,51.333333333333336,39.333333333333336,>,12.0,46,32,>,14,54,53,>,1,142,151,<,-9
0,12,25.333333333333332,26.333333333333332,<,-1.0,13,16,<,-3,38,35,>,3,39.333333333333336,48.333333333333336,<,-9.0,32,39,<,-7,53,53,=,0,151,184,<,-33
30,12,26.333333333333332,25.333333333333332,>,1.0,16,13,>,3,35,38,<,-3,48.333333333333336,39.333333333333336,>,9.0,39,32,>,7,53,53,=,0,184,151,>,33
0,12,25.333333333333332,35.666666666666664,<,-10.333333333333332,13,24,<,-11,38,52,<,-14,39.333333333333336,50.666666666666664,<,-11.333333333333329,32,41,<,-9,53,58,<,-5,151,169,<,-18
66,12,35.666666666666664,25.333333333333332,>,10.333333333333332,24,13,>,11,52,38,>,14,50.666666666666664,39.333333333333336,>,11.333333333333329,41,32,>,9,58,53,>,5,169,151,>,18
0,12,25.333333333333332,41.666666666666664,<,-16.333333333333332,13,13,=,0,38,77,<,-39,39.333333333333336,39.0,>,0.3333333333333357,32,31,>,1,53,46,>,7,151,233,<,-82
79,12,41.666666666666664,25.333333333333332,>,16.333333333333332,13,13,=,0,77,38,>,39,39.0,39.333333333333336,<,-0.3333333333333357,31,32,<,-1,46,53,<,-7,233,151,>,82
0,12,25.333333333333332,32.0,<,-6.666666666666668,13,25,<,-12,38,45,<,-7,39.333333333333336,47.333333333333336,<,-8.0,32,40,<,-8,53,54,<,-1,151,168,<,-17
42,12,32.0,25.333333333333332,>,6.666666666666668,25,13,>,12,45,38,>,7,47.333333333333336,39.333333333333336,>,8.0,40,32,>,8,54,53,>,1,168,151,>,17
0,12,25.333333333333332,67.0,<,-41.66666666666667,13,56,<,-43,38,85,<,-47,39.333333333333336,38.666666666666664,>,0.6666666666666714,32,34,<,-2,53,42,>,11,151,143,>,8
114,12,67.0,25.333333333333332,>,41.66666666666667,56,13,>,43,85,38,>,47,38.666666666666664,39.333333333333336,<,-0.6666666666666714,34,32,>,2,42,53,<,-11,143,151,<,-8
0,12,25.333333333333332,28.666666666666668,<,-3.3333333333333357,13,18,<,-5,38,47,<,-9,39.333333333333336,44.0,<,-4.666666666666664,32,32,=,0,53,54,<,-1,151,248,<,-97
0,12,28.666666666666668,25.333333333333332,>,3.3333333333333357,18,13,>,5,47,38,>,9,44.0,39.333333333333336,>,4.666666666666664,32,32,=,0,54,53,>,1,248,151,>,97
0,12,25.333333333333332,45.0,<,-19.666666666666668,13,24,<,-11,38,56,<,-18,39.333333333333336,43.0,<,-3.6666666666666643,32,34,<,-2,53,55,<,-2,151,134,>,17
73,12,45.0,25.333333333333332,>,19.666666666666668,24,13,>,11,56,38,>,18,43.0,39.333333333333336,>,3.6666666666666643,34,32,>,2,55,53,>,2,134,151,<,-17
0,12,25.333333333333332,56.0,<,-30.666666666666668,13,26,<,-13,38,82,<,-44,39.333333333333336,36.333333333333336,>,3.0,32,30,>,2,53,47,>,6,151,149,>,2
54,12,56.0,25.333333333333332,>,30.666666666666668,26,13,>,13,82,38,>,44,36.333333333333336,39.333333333333336,<,-3.0,30,32,<,-2,47,53,<,-6,149,151,<,-2
0,12,25.333333333333332,59.333333333333336,<,-34.0,13,31,<,-18,38,88,<,-50,39.333333333333336,49.333333333333336,<,-10.0,32,43,<,-11,53,56,<,-3,151,271,<,-120
117,12,59.333333333333336,25.333333333333332,>,34.0,31,13,>,18,88,38,>,50,49.333333333333336,39.333333333333336,>,10.0,43,32,>,11,56,53,>,3,271,151,>,120
0,12,25.333333333333332,73.33333333333333,<,-48.0,13,45,<,-32,38,89,<,-51,39.333333333333336,40.0,<,-0.6666666666666643,32,31,>,1,53,47,>,6,151,274,<,-123
126,12,73.33333333333333,25.333333333333332,>,48.0,45,13,>,32,89,38,>,51,40.0,39.333333333333336,>,0.6666666666666643,31,32,<,-1,47,53,<,-6,274,151,>,123
0,11,52.666666666666664,28.333333333333332,>,24.333333333333332,21,16,>,5,90,52,>,38,44.0,51.333333333333336,<,-7.333333333333336,32,46,<,-14,54,54,=,0,248,142,>,106
0,11,28.333333333333332,52.666666666666664,<,-24.333333333333332,16,21,<,-5,52,90,<,-38,51.333333333333336,44.0,>,7.333333333333336,46,32,>,14,54,54,=,0,142,248,<,-106
0,11,52.666666666666664,27.0,>,25.666666666666664,21,18,>,3,90,35,>,55,44.0,48.333333333333336,<,-4.333333333333336,32,39,<,-7,54,53,>,1,248,184,>,64
30,11,27.0,52.666666666666664,<,-25.666666666666664,18,21,<,-3,35,90,<,-55,48.333333333333336,44.0,>,4.333333333333336,39,32,>,7,53,54,<,-1,184,248,<,-64
0,11,52.666666666666664,23.333333333333332,>,29.333333333333332,21,19,>,2,90,26,>,64,44.0,47.333333333333336,<,-3.3333333333333357,32,40,<,-8,54,54,=,0,248,168,>,80
42,11,23.333333333333332,52.666666666666664,<,-29.333333333333332,19,21,<,-2,26,90,<,-64,47.333333333333336,44.0,>,3.3333333333333357,40,32,>,8,54,54,=,0,168,248,<,-80
0,11,52.666666666666664,41.0,>,11.666666666666664,21,26,<,-5,90,60,>,30,44.0,36.333333333333336,>,7.666666666666664,32,30,>,2,54,47,>,7,248,149,>,99
54,11,41.0,52.666666666666664,<,-11.666666666666664,26,21,>,5,60,90,<,-30,36.333333333333336,44.0,<,-7.666666666666664,30,32,<,-2,47,54,<,-7,149,248,<,-99
0,11,52.666666666666664,50.333333333333336,>,2.3333333333333286,21,31,<,-10,90,68,>,22,44.0,50.666666666666664,<,-6.666666666666664,32,41,<,-9,54,58,<,-4,248,169,>,79
66,11,50.333333333333336,52.666666666666664,<,-2.3333333333333286,31,21,>,10,68,90,<,-22,50.666666666666664,44.0,>,6.666666666666664,41,32,>,9,58,54,>,4,169,248,<,-79
0,11,52.666666666666664,30.0,>,22.666666666666664,21,11,>,10,90,55,>,35,44.0,43.0,>,1.0,32,34,<,-2,54,55,<,-1,248,134,>,114
0,11,30.0,52.666666666666664,<,-22.666666666666664,11,21,<,-10,55,90,<,-35,43.0,44.0,<,-1.0,34,32,>,2,55,54,>,1,134,248,<,-114
0,11,52.666666666666664,48.666666666666664,>,4.0,21,34,<,-13,90,77,>,13,44.0,39.0,>,5.0,32,31,>,1,54,46,>,8,248,233,>,15
92,11,48.666666666666664,52.666666666666664,<,-4.0,34,21,>,13,77,90,<,-13,39.0,44.0,<,-5.0,31,32,<,-1,46,54,<,-8,233,248,<,-15
0,11,52.666666666666664,70.33333333333333,<,-17.666666666666664,21,56,<,-35,90,85,>,5,44.0,38.666666666666664,>,5.333333333333336,32,34,<,-2,54,42,>,12,248,143,>,105
114,11,70.33333333333333,52.666666666666664,>,17.666666666666664,56,21,>,35,85,90,<,-5,38.666666666666664,44.0,<,-5.333333333333336,34,32,>,2,42,54,<,-12,143,248,<,-105
0,11,52.666666666666664,68.66666666666667,<,-16.000000000000007,21,59,<,-38,90,88,>,2,44.0,49.333333333333336,<,-5.333333333333336,32,43,<,-11,54,56,<,-2,248,271,<,-23
117,11,68.66666666666667,52.666666666666664,>,16.000000000000007,59,21,>,38,88,90,<,-2,49.333333333333336,44.0,>,5.333333333333336,43,32,>,11,56,54,>,2,271,248,>,23
0,11,52.666666666666664,55.333333333333336,<,-2.6666666666666714,21,35,<,-14,90,86,>,4,44.0,40.0,>,4.0,32,31,>,1,54,47,>,7,248,274,<,-26
126,11,55.333333333333336,52.666666666666664,>,2.6666666666666714,35,21,>,14,86,90,<,-4,40.0,44.0,<,-4.0,31,32,<,-1,47,54,<,-7,274,248,>,26
0,10,26.333333333333332,36.666666666666664,<,-10.333333333333332,11,17,<,-6,55,52,>,3,43.0,51.333333333333336,<,-8.333333333333336,34,46,<,-12,55,54,>,1,134,142,<,-8
0,10,36.666666666666664,26.333333333333332,>,10.333333333333332,17,11,>,6,52,55,<,-3,51.333333333333336,43.0,>,8.333333333333336,46,34,>,12,54,55,<,-1,142,134,>,8
0,10,26.333333333333332,34.333333333333336,<,-8.000000000000004,11,18,<,-7,55,57,<,-2,43.0,48.333333333333336,<,-5.333333333333336,34,39,<,-5,55,53,>,2,134,184,<,-50
63,10,34.333333333333336,26.333333333333332,>,8.000000000000004,18,11,>,7,57,55,>,2,48.333333333333336,43.0,>,5.333333333333336,39,34,>,5,53,55,<,-2,184,134,>,50
0,10,26.333333333333332,40.0,<,-13.666666666666668,11,19,<,-8,55,76,<,-21,43.0,47.333333333333336,<,-4.333333333333336,34,40,<,-6,55,54,>,1,134,168,<,-34
101,10,40.0,26.333333333333332,>,13.666666666666668,19,11,>,8,76,55,>,21,47.333333333333336,43.0,>,4.333333333333336,40,34,>,6,54,55,<,-1,168,134,>,34
0,10,26.333333333333332,58.666666666666664,<,-32.33333333333333,11,37,<,-26,55,79,<,-24,43.0,36.333333333333336,>,6.666666666666664,34,30,>,4,55,47,>,8,134,149,<,-15
64,10,58.666666666666664,26.333333333333332,>,32.33333333333333,37,11,>,26,79,55,>,24,36.333333333333336,43.0,<,-6.666666666666664,30,34,<,-4,47,55,<,-8,149,134,>,15
0,10,26.333333333333332,41.0,<,-14.666666666666668,11,24,<,-13,55,68,<,-13,43.0,50.666666666666664,<,-7.666666666666664,34,41,<,-7,55,58,<,-3,134,169,<,-35
58,10,41.0,26.333333333333332,>,14.666666666666668,24,11,>,13,68,55,>,13,50.666666666666664,43.0,>,7.666666666666664,41,34,>,7,58,55,>,3,169,134,>,35
0,10,26.333333333333332,56.333333333333336,<,-30.000000000000004,11,34,<,-23,55,77,<,-22,43.0,39.0,>,4.0,34,31,>,3,55,46,>,9,134,233,<,-99
87,10,56.333333333333336,26.333333333333332,>,30.000000000000004,34,11,>,23,77,55,>,22,39.0,43.0,<,-4.0,31,34,<,-3,46,55,<,-9,233,134,>,99
0,10,26.333333333333332,66.0,<,-39.66666666666667,11,56,<,-45,55,72,<,-17,43.0,38.666666666666664,>,4.333333333333336,34,34,=,0,55,42,>,13,134,143,<,-9
30,10,66.0,26.333333333333332,>,39.66666666666667,56,11,>,45,72,55,>,17,38.666666666666664,43.0,<,-4.333333333333336,34,34,=,0,42,55,<,-13,143,134,>,9
0,10,26.333333333333332,71.66666666666667,<,-45.33333333333334,11,59,<,-48,55,88,<,-33,43.0,49.333333333333336,<,-6.333333333333336,34,43,<,-9,55,56,<,-1,134,271,<,-137
61,10,71.66666666666667,26.333333333333332,>,45.33333333333334,59,11,>,48,88,55,>,33,49.333333333333336,43.0,>,6.333333333333336,43,34,>,9,56,55,>,1,271,134,>,137
0,10,26.333333333333332,35.0,<,-8.666666666666668,11,25,<,-14,55,45,>,10,43.0,40.0,>,3.0,34,31,>,3,55,47,>,8,134,274,<,-140
0,10,35.0,26.333333333333332,>,8.666666666666668,25,11,>,14,45,55,<,-10,40.0,43.0,<,-3.0,31,34,<,-3,47,55,<,-8,274,134,>,140
0,9,45.0,31.666666666666668,>,13.333333333333332,25,17,>,8,65,41,>,24,40.0,51.333333333333336,<,-11.333333333333336,31,46,<,-15,47,54,<,-7,274,142,>,132
0,9,31.666666666666668,45.0,<,-13.333333333333332,17,25,<,-8,41,65,<,-24,51.333333333333336,40.0,>,11.333333333333336,46,31,>,15,54,47,>,7,142,274,<,-132
0,9,45.0,55.0,<,-10.0,25,37,<,-12,65,72,<,-7,40.0,38.666666666666664,>,1.3333333333333357,31,34,<,-3,47,42,>,5,274,143,>,131
30,9,55.0,45.0,>,10.0,37,25,>,12,72,65,>,7,38.666666666666664,40.0,<,-1.3333333333333357,34,31,>,3,42,47,<,-5,143,274,<,-131
0,9,45.0,33.0,>,12.0,25,24,>,1,65,44,>,21,40.0,50.666666666666664,<,-10.666666666666664,31,41,<,-10,47,58,<,-11,274,169,>,105
58,9,33.0,45.0,<,-12.0,24,25,<,-1,44,65,<,-21,50.666666666666664,40.0,>,10.666666666666664,41,31,>,10,58,47,>,11,169,274,<,-105
0,9,45.0,64.66666666666667,<,-19.66666666666667,25,38,<,-13,65,88,<,-23,40.0,49.333333333333336,<,-9.333333333333336,31,43,<,-12,47,56,<,-9,274,271,>,3
61,9,64.66666666666667,45.0,>,19.66666666666667,38,25,>,13,88,65,>,23,49.333333333333336,40.0,>,9.333333333333336,43,31,>,12,56,47,>,9,271,274,<,-3
0,9,45.0,31.666666666666668,>,13.333333333333332,25,10,>,15,65,57,>,8,40.0,48.333333333333336,<,-8.333333333333336,31,39,<,-8,47,53,<,-6,274,184,>,90
63,9,31.666666666666668,45.0,<,-13.333333333333332,10,25,<,-15,57,65,<,-8,48.333333333333336,40.0,>,8.333333333333336,39,31,>,8,53,47,>,6,184,274,<,-90
0,9,45.0,50.666666666666664,<,-5.666666666666664,25,13,>,12,65,79,<,-14,40.0,36.333333333333336,>,3.6666666666666643,31,30,>,1,47,47,=,0,274,149,>,125
0,9,50.666666666666664,45.0,>,5.666666666666664,13,25,<,-12,79,65,>,14,36.333333333333336,40.0,<,-3.6666666666666643,30,31,<,-1,47,47,=,0,149,274,<,-125
0,9,45.0,56.666666666666664,<,-11.666666666666664,25,35,<,-10,65,77,<,-12,40.0,39.0,>,1.0,31,31,=,0,47,46,>,1,274,233,>,41
71,9,56.666666666666664,45.0,>,11.666666666666664,35,25,>,10,77,65,>,12,39.0,40.0,<,-1.0,31,31,=,0,46,47,<,-1,233,274,<,-41
0,9,45.0,54.0,<,-9.0,25,25,=,0,65,76,<,-11,40.0,47.333333333333336,<,-7.333333333333336,31,40,<,-9,47,54,<,-7,274,168,>,106
129,9,54.0,45.0,>,9.0,25,25,=,0,76,65,>,11,47.333333333333336,40.0,>,7.333333333333336,40,31,>,9,54,47,>,7,168,274,<,-106
0,8,45.333333333333336,43.0,>,2.3333333333333357,13,17,<,-4,63,75,<,-12,36.333333333333336,51.333333333333336,<,-15.0,30,46,<,-16,47,54,<,-7,149,142,>,7
0,8,43.0,45.333333333333336,<,-2.3333333333333357,17,13,>,4,75,63,>,12,51.333333333333336,36.333333333333336,>,15.0,46,30,>,16,54,47,>,7,142,149,<,-7
0,8,45.333333333333336,50.666666666666664,<,-5.333333333333329,13,37,<,-24,63,59,>,4,36.333333333333336,38.666666666666664,<,-2.3333333333333286,30,34,<,-4,47,42,>,5,149,143,>,6
89,8,50.666666666666664,45.333333333333336,>,5.333333333333329,37,13,>,24,59,63,<,-4,38.666666666666664,36.333333333333336,>,2.3333333333333286,34,30,>,4,42,47,<,-5,143,149,<,-6
0,8,45.333333333333336,53.666666666666664,<,-8.333333333333329,13,31,<,-18,63,86,<,-23,36.333333333333336,50.666666666666664,<,-14.333333333333329,30,41,<,-11,47,58,<,-11,149,169,<,-20
100,8,53.666666666666664,45.333333333333336,>,8.333333333333329,31,13,>,18,86,63,>,23,50.666666666666664,36.333333333333336,>,14.333333333333329,41,30,>,11,58,47,>,11,169,149,>,20
0,8,45.333333333333336,63.666666666666664,<,-18.33333333333333,13,38,<,-25,63,88,<,-25,36.333333333333336,49.333333333333336,<,-13.0,30,43,<,-13,47,56,<,-9,149,271,<,-122
102,8,63.666666666666664,45.333333333333336,>,18.33333333333333,38,13,>,25,88,63,>,25,49.333333333333336,36.333333333333336,>,13.0,43,30,>,13,56,47,>,9,271,149,>,122
0,8,45.333333333333336,21.666666666666668,>,23.666666666666668,13,10,>,3,63,28,>,35,36.333333333333336,48.333333333333336,<,-12.0,30,39,<,-9,47,53,<,-6,149,184,<,-35
44,8,21.666666666666668,45.333333333333336,<,-23.666666666666668,10,13,<,-3,28,63,<,-35,48.333333333333336,36.333333333333336,>,12.0,39,30,>,9,53,47,>,6,184,149,>,35
0,8,45.333333333333336,59.666666666666664,<,-14.333333333333329,13,35,<,-22,63,77,<,-14,36.333333333333336,39.0,<,-2.6666666666666643,30,31,<,-1,47,46,>,1,149,233,<,-84
71,8,59.666666666666664,45.333333333333336,>,14.333333333333329,35,13,>,22,77,63,>,14,39.0,36.333333333333336,>,2.6666666666666643,31,30,>,1,46,47,<,-1,233,149,>,84
0,8,45.333333333333336,35.0,>,10.333333333333336,13,19,<,-6,63,61,>,2,36.333333333333336,47.333333333333336,<,-11.0,30,40,<,-10,47,54,<,-7,149,168,<,-19
96,8,35.0,45.333333333333336,<,-10.333333333333336,19,13,>,6,61,63,<,-2,47.333333333333336,36.333333333333336,>,11.0,40,30,>,10,54,47,>,7,168,149,>,19
0,7,51.666666666666664,28.666666666666668,>,22.999999999999996,17,27,<,-10,75,31,>,44,51.333333333333336,48.333333333333336,>,3.0,46,39,>,7,54,53,>,1,142,184,<,-42
44,7,28.666666666666668,51.666666666666664,<,-22.999999999999996,27,17,>,10,31,75,<,-44,48.333333333333336,51.333333333333336,<,-3.0,39,46,<,-7,53,54,<,-1,184,142,>,42
0,7,51.666666666666664,57.333333333333336,<,-5.666666666666671,17,28,<,-11,75,77,<,-2,51.333333333333336,39.0,>,12.333333333333336,46,31,>,15,54,46,>,8,142,233,<,-91
0,7,57.333333333333336,51.666666666666664,>,5.666666666666671,28,17,>,11,77,75,>,2,39.0,51.333333333333336,<,-12.333333333333336,31,46,<,-15,46,54,<,-8,233,142,>,91
0,7,51.666666666666664,60.333333333333336,<,-8.666666666666671,17,56,<,-39,75,66,>,9,51.333333333333336,38.666666666666664,>,12.666666666666671,46,34,>,12,54,42,>,12,142,143,<,-1
89,7,60.333333333333336,51.666666666666664,>,8.666666666666671,56,17,>,39,66,75,<,-9,38.666666666666664,51.333333333333336,<,-12.666666666666671,34,46,<,-12,42,54,<,-12,143,142,>,1
0,7,51.666666666666664,37.333333333333336,>,14.333333333333329,17,19,<,-2,75,68,>,7,51.333333333333336,47.333333333333336,>,4.0,46,40,>,6,54,54,=,0,142,168,<,-26
96,7,37.333333333333336,51.666666666666664,<,-14.333333333333329,19,17,>,2,68,75,<,-7,47.333333333333336,51.333333333333336,<,-4.0,40,46,<,-6,54,54,=,0,168,142,>,26
0,7,51.666666666666664,48.0,>,3.6666666666666643,17,27,<,-10,75,86,<,-11,51.333333333333336,50.666666666666664,>,0.6666666666666714,46,41,>,5,54,58,<,-4,142,169,<,-27
100,7,48.0,51.666666666666664,<,-3.6666666666666643,27,17,>,10,86,75,>,11,50.666666666666664,51.333333333333336,<,-0.6666666666666714,41,46,<,-5,58,54,>,4,169,142,>,27
0,7,51.666666666666664,69.0,<,-17.333333333333336,17,54,<,-37,75,88,<,-13,51.333333333333336,49.333333333333336,>,2.0,46,43,>,3,54,56,<,-2,142,271,<,-129
102,7,69.0,51.666666666666664,>,17.333333333333336,54,17,>,37,88,75,>,13,49.333333333333336,51.333333333333336,<,-2.0,43,46,<,-3,56,54,>,2,271,142,>,129
0,6,45.0,48.666666666666664,<,-3.6666666666666643,28,27,>,1,67,88,<,-21,39.0,48.333333333333336,<,-9.333333333333336,31,39,<,-8,46,53,<,-7,233,184,>,49
44,6,48.666666666666664,45.0,>,3.6666666666666643,27,28,<,-1,88,67,>,21,48.333333333333336,39.0,>,9.333333333333336,39,31,>,8,53,46,>,7,184,233,<,-49
0,6,45.0,51.666666666666664,<,-6.666666666666664,28,30,<,-2,67,66,>,1,39.0,38.666666666666664,>,0.3333333333333357,31,34,<,-3,46,42,>,4,233,143,>,90
70,6,51.666666666666664,45.0,>,6.666666666666664,30,28,>,2,66,67,<,-1,38.666666666666664,39.0,<,-0.3333333333333357,34,31,>,3,42,46,<,-4,143,233,<,-90
0,6,45.0,40.333333333333336,>,4.666666666666664,28,19,>,9,67,68,<,-1,39.0,47.333333333333336,<,-8.333333333333336,31,40,<,-9,46,54,<,-8,233,168,>,65
96,6,40.333333333333336,45.0,<,-4.666666666666664,19,28,<,-9,68,67,>,1,47.333333333333336,39.0,>,8.333333333333336,40,31,>,9,54,46,>,8,168,233,<,-65
0,6,45.0,43.666666666666664,>,1.3333333333333357,28,18,>,10,67,86,<,-19,39.0,50.666666666666664,<,-11.666666666666664,31,41,<,-10,46,58,<,-12,233,169,>,64
0,6,43.666666666666664,45.0,<,-1.3333333333333357,18,28,<,-10,86,67,>,19,50.666666666666664,39.0,>,11.666666666666664,41,31,>,10,58,46,>,12,169,233,<,-64
0,6,45.0,63.666666666666664,<,-18.666666666666664,28,54,<,-26,67,72,<,-5,39.0,49.333333333333336,<,-10.333333333333336,31,43,<,-12,46,56,<,-10,233,271,<,-38
102,6,63.666666666666664,45.0,>,18.666666666666664,54,28,>,26,72,67,>,5,49.333333333333336,39.0,>,10.333333333333336,43,31,>,12,56,46,>,10,271,233,>,38
0,5,53.333333333333336,57.666666666666664,<,-4.333333333333329,18,27,<,-9,86,88,<,-2,50.666666666666664,48.333333333333336,>,2.3333333333333286,41,39,>,2,58,53,>,5,169,184,<,-15
44,5,57.666666666666664,53.333333333333336,>,4.333333333333329,27,18,>,9,88,86,>,2,48.333333333333336,50.666666666666664,<,-2.3333333333333286,39,41,<,-2,53,58,<,-5,184,169,>,15
0,5,53.333333333333336,46.666666666666664,>,6.666666666666671,18,30,<,-12,86,59,>,27,50.666666666666664,38.666666666666664,>,12.0,41,34,>,7,58,42,>,16,169,143,>,26
70,5,46.666666666666664,53.333333333333336,<,-6.666666666666671,30,18,>,12,59,86,<,-27,38.666666666666664,50.666666666666664,<,-12.0,34,41,<,-7,42,58,<,-16,143,169,<,-26
0,5,53.333333333333336,45.666666666666664,>,7.666666666666671,18,19,<,-1,86,84,>,2,50.666666666666664,47.333333333333336,>,3.3333333333333286,41,40,>,1,58,54,>,4,169,168,>,1
96,5,45.666666666666664,53.333333333333336,<,-7.666666666666671,19,18,>,1,84,86,<,-2,47.333333333333336,50.666666666666664,<,-3.3333333333333286,40,41,<,-1,54,58,<,-4,168,169,<,-1
0,5,53.333333333333336,56.333333333333336,<,-3.0,18,32,<,-14,86,72,>,14,50.666666666666664,49.333333333333336,>,1.3333333333333286,41,43,<,-2,58,56,>,2,169,271,<,-102
0,5,56.333333333333336,53.333333333333336,>,3.0,32,18,>,14,72,86,<,-14,49.333333333333336,50.666666666666664,<,-1.3333333333333286,43,41,>,2,56,58,<,-2,271,169,>,102
0,4,49.0,52.0,<,-3.0,32,27,>,5,65,71,<,-6,49.333333333333336,48.333333333333336,>,1.0,43,39,>,4,56,53,>,3,271,184,>,87
44,4,52.0,49.0,>,3.0,27,32,<,-5,71,65,>,6,48.333333333333336,49.333333333333336,<,-1.0,39,43,<,-4,53,56,<,-3,184,271,<,-87
0,4,49.0,54.666666666666664,<,-5.666666666666664,32,51,<,-19,65,59,>,6,49.333333333333336,38.666666666666664,>,10.666666666666671,43,34,>,9,56,42,>,14,271,143,>,128
81,4,54.666666666666664,49.0,>,5.666666666666664,51,32,>,19,59,65,<,-6,38.666666666666664,49.333333333333336,<,-10.666666666666671,34,43,<,-9,42,56,<,-14,143,271,<,-128
0,4,49.0,38.0,>,11.0,32,11,>,21,65,84,<,-19,49.333333333333336,47.333333333333336,>,2.0,43,40,>,3,56,54,>,2,271,168,>,103
0,4,38.0,49.0,<,-11.0,11,32,<,-21,84,65,>,19,47.333333333333336,49.333333333333336,<,-2.0,40,43,<,-3,54,56,<,-2,168,271,<,-103
0,3,26.0,45.0,<,-19.0,11,27,<,-16,48,71,<,-23,47.333333333333336,48.333333333333336,<,-1.0,40,39,>,1,54,53,>,1,168,184,<,-16
44,3,45.0,26.0,>,19.0,27,11,>,16,71,48,>,23,48.333333333333336,47.333333333333336,>,1.0,39,40,<,-1,53,54,<,-1,184,168,>,16
0,3,26.0,46.0,<,-20.0,11,25,<,-14,48,59,<,-11,47.333333333333336,38.666666666666664,>,8.666666666666671,40,34,>,6,54,42,>,12,168,143,>,25
80,3,46.0,26.0,>,20.0,25,11,>,14,59,48,>,11,38.666666666666664,47.333333333333336,<,-8.666666666666671,34,40,<,-6,42,54,<,-12,143,168,<,-25
0,2,34.0,39.0,<,-5.0,18,27,<,-9,59,53,>,6,38.666666666666664,48.333333333333336,<,-9.666666666666671,34,39,<,-5,42,53,<,-11,143,184,<,-41
44,2,39.0,34.0,>,5.0,27,18,>,9,53,59,<,-6,48.333333333333336,38.666666666666664,>,9.666666666666671,39,34,>,5,53,42,>,11,184,143,>,41
0,14,0.0,0.0,=,0.0,0,0,=,0,0,0,=,0,42.666666666666664,45.666666666666664,<,-3.0,33,34,<,-1,49,55,<,-6,127,143,<,-16
22,14,0.0,0.0,=,0.0,0,0,=,0,0,0,=,0,45.666666666666664,42.666666666666664,>,3.0,34,33,>,1,55,49,>,6,143,127,>,16
0,14,0.0,0.0,=,0.0,0,0,=,0,0,0,=,0,42.666666666666664,36.333333333333336,>,6.333333333333329,33,34,<,-1,49,39,>,10,127,211,<,-84
72,14,0.0,0.0,=,0.0,0,0,=,0,0,0,=,0,36.333333333333336,42.666666666666664,<,-6.333333333333329,34,33,>,1,39,49,<,-10,211,127,>,84
0,14,0.0,0.0,=,0.0,0,0,=,0,0,0,=,0,42.666666666666664,37.666666666666664,>,5.0,33,30,>,3,49,51,<,-2,127,103,>,24
11,14,0.0,0.0,=,0.0,0,0,=,0,0,0,=,0,37.666666666666664,42.666666666666664,<,-5.0,30,33,<,-3,51,49,>,2,103,127,<,-24
0,14,0.0,0.0,=,0.0,0,0,=,0,0,0,=,0,42.666666666666664,47.666666666666664,<,-5.0,33,43,<,-10,49,51,<,-2,127,188,<,-61
83,14,0.0,0.0,=,0.0,0,0,=,0,0,0,=,0,47.666666666666664,42.666666666666664,>,5.0,43,33,>,10,51,49,>,2,188,127,>,61
0,14,0.0,0.0,=,0.0,0,0,=,0,0,0,=,0,42.666666666666664,54.0,<,-11.333333333333336,33,52,<,-19,49,56,<,-7,127,150,<,-23
55,14,0.0,0.0,=,0.0,0,0,=,0,0,0,=,0,54.0,42.666666666666664,>,11.333333333333336,52,33,>,19,56,49,>,7,150,127,>,23
0,14,0.0,0.0,=,0.0,0,0,=,0,0,0,=,0,42.666666666666664,52.666666666666664,<,-10.0,33,48,<,-15,49,58,<,-9,127,151,<,-24
32,14,0.0,0.0,=,0.0,0,0,=,0,0,0,=,0,52.666666666666664,42.666666666666664,>,10.0,48,33,>,15,58,49,>,9,151,127,>,24
0,14,0.0,0.0,=,0.0,0,0,=,0,0,0,=,0,42.666666666666664,45.666666666666664,<,-3.0,33,38,<,-5,49,51,<,-2,127,126,>,1
22,14,0.0,0.0,=,0.0,0,0,=,0,0,0,=,0,45.666666666666664,42.666666666666664,>,3.0,38,33,>,5,51,49,>,2,126,127,<,-1
0,14,0.0,0.0,=,0.0,0,0,=,0,0,0,=,0,42.666666666666664,47.0,<,-4.333333333333336,33,44,<,-11,49,49,=,0,127,122,>,5
75,14,0.0,0.0,=,0.0,0,0,=,0,0,0,=,0,47.0,42.666666666666664,>,4.333333333333336,44,33,>,11,49,49,=,0,122,127,<,-5
0,14,0.0,0.0,=,0.0,0,0,=,0,0,0,=,0,42.666666666666664,35.333333333333336,>,7.333333333333329,33,30,>,3,49,42,>,7,127,109,>,18
0,14,0.0,0.0,=,0.0,0,0,=,0,0,0,=,0,35.333333333333336,42.666666666666664,<,-7.333333333333329,30,33,<,-3,42,49,<,-7,109,127,<,-18
0,14,0.0,0.0,=,0.0,0,0,=,0,0,0,=,0,42.666666666666664,52.666666666666664,<,-10.0,33,40,<,-7,49,59,<,-10,127,81,>,46
0,14,0.0,0.0,=,0.0,0,0,=,0,0,0,=,0,52.666666666666664,42.666666666666664,>,10.0,40,33,>,7,59,49,>,10,81,127,<,-46
0,14,0.0,0.0,=,0.0,0,0,=,0,0,0,=,0,42.666666666666664,52.333333333333336,<,-9.666666666666671,33,39,<,-6,49,59,<,-10,127,153,<,-26
51,14,0.0,0.0,=,0.0,0,0,=,0,0,0,=,0,52.333333333333336,42.666666666666664,>,9.666666666666671,39,33,>,6,59,49,>,10,153,127,>,26
0,14,0.0,0.0,=,0.0,0,0,=,0,0,0,=,0,42.666666666666664,48.0,<,-5.333333333333336,33,40,<,-7,49,55,<,-6,127,126,>,1
23,14,0.0,0.0,=,0.0,0,0,=,0,0,0,=,0,48.0,42.666666666666664,>,5.333333333333336,40,33,>,7,55,49,>,6,126,127,<,-1
0,14,0.0,0.0,=,0.0,0,0,=,0,0,0,=,0,42.666666666666664,41.666666666666664,>,1.0,33,30,>,3,49,51,<,-2,127,122,>,5
22,14,0.0,0.0,=,0.0,0,0,=,0,0,0,=,0,41.666666666666664,42.666666666666664,<,-1.0,30,33,<,-3,51,49,>,2,122,127,<,-5
0,13,10.333333333333334,8.0,>,2.333333333333334,0,0,=,0,31,24,>,7,35.333333333333336,52.666666666666664,<,-17.33333333333333,30,40,<,-10,42,59,<,-17,109,81,>,28
0,13,8.0,10.333333333333334,<,-2.333333333333334,0,0,=,0,24,31,<,-7,52.666666666666664,35.333333333333336,>,17.33333333333333,40,30,>,10,59,42,>,17,81,109,<,-28
0,13,10.333333333333334,9.333333333333334,>,1.0,0,0,=,0,31,28,>,3,35.333333333333336,37.666666666666664,<,-2.3333333333333286,30,30,=,0,42,51,<,-9,109,103,>,6
0,13,9.333333333333334,10.333333333333334,<,-1.0,0,0,=,0,28,31,<,-3,37.666666666666664,35.333333333333336,>,2.3333333333333286,30,30,=,0,51,42,>,9,103,109,<,-6
0,13,10.333333333333334,18.0,<,-7.666666666666666,0,0,=,0,31,54,<,-23,35.333333333333336,45.666666666666664,<,-10.333333333333329,30,34,<,-4,42,55,<,-13,109,143,<,-34
33,13,18.0,10.333333333333334,>,7.666666666666666,0,0,=,0,54,31,>,23,45.666666666666664,35.333333333333336,>,10.333333333333329,34,30,>,4,55,42,>,13,143,109,>,34
0,13,10.333333333333334,8.0,>,2.333333333333334,0,0,=,0,31,24,>,7,35.333333333333336,45.666666666666664,<,-10.333333333333329,30,38,<,-8,42,51,<,-9,109,126,<,-17
15,13,8.0,10.333333333333334,<,-2.333333333333334,0,0,=,0,24,31,<,-7,45.666666666666664,35.333333333333336,>,10.333333333333329,38,30,>,8,51,42,>,9,126,109,>,17
0,13,10.333333333333334,25.666666666666668,<,-15.333333333333334,0,0,=,0,31,77,<,-46,35.333333333333336,41.666666666666664,<,-6.333333333333329,30,30,=,0,42,51,<,-9,109,122,<,-13
58,13,25.666666666666668,10.333333333333334,>,15.333333333333334,0,0,=,0,77,31,>,46,41.666666666666664,35.333333333333336,>,6.333333333333329,30,30,=,0,51,42,>,9,122,109,>,13
0,13,10.333333333333334,23.0,<,-12.666666666666666,0,0,=,0,31,69,<,-38,35.333333333333336,48.0,<,-12.666666666666664,30,40,<,-10,42,55,<,-13,109,126,<,-17
46,13,23.0,10.333333333333334,>,12.666666666666666,0,0,=,0,69,31,>,38,48.0,35.333333333333336,>,12.666666666666664,40,30,>,10,55,42,>,13,126,109,>,17
0,13,10.333333333333334,12.0,<,-1.666666666666666,0,0,=,0,31,36,<,-5,35.333333333333336,52.666666666666664,<,-17.33333333333333,30,48,<,-18,42,58,<,-16,109,151,<,-42
65,13,12.0,10.333333333333334,>,1.666666666666666,0,0,=,0,36,31,>,5,52.666666666666664,35.333333333333336,>,17.33333333333333,48,30,>,18,58,42,>,16,151,109,>,42
0,13,10.333333333333334,14.333333333333334,<,-4.0,0,0,=,0,31,43,<,-12,35.333333333333336,52.333333333333336,<,-17.0,30,39,<,-9,42,59,<,-17,109,153,<,-44
56,13,14.333333333333334,10.333333333333334,>,4.0,0,0,=,0,43,31,>,12,52.333333333333336,35.333333333333336,>,17.0,39,30,>,9,59,42,>,17,153,109,>,44
0,13,10.333333333333334,9.666666666666666,>,0.6666666666666679,0,0,=,0,31,29,>,2,35.333333333333336,54.0,<,-18.666666666666664,30,52,<,-22,42,56,<,-14,109,150,<,-41
59,13,9.666666666666666,10.333333333333334,<,-0.6666666666666679,0,0,=,0,29,31,<,-2,54.0,35.333333333333336,>,18.666666666666664,52,30,>,22,56,42,>,14,150,109,>,41
0,13,10.333333333333334,27.0,<,-16.666666666666664,0,0,=,0,31,81,<,-50,35.333333333333336,36.333333333333336,<,-1.0,30,34,<,-4,42,39,>,3,109,211,<,-102
107,13,27.0,10.333333333333334,>,16.666666666666664,0,0,=,0,81,31,>,50,36.333333333333336,35.333333333333336,>,1.0,34,30,>,4,39,42,<,-3,211,109,>,102
0,13,10.333333333333334,11.0,<,-0.6666666666666661,0,0,=,0,31,33,<,-2,35.333333333333336,47.0,<,-11.666666666666664,30,44,<,-14,42,49,<,-7,109,122,<,-13
88,13,11.0,10.333333333333334,>,0.6666666666666661,0,0,=,0,33,31,>,2,47.0,35.333333333333336,>,11.666666666666664,44,30,>,14,49,42,>,7,122,109,>,13
0,13,10.333333333333334,20.666666666666668,<,-10.333333333333334,0,0,=,0,31,62,<,-31,35.333333333333336,47.666666666666664,<,-12.333333333333329,30,43,<,-13,42,51,<,-9,109,188,<,-79
115,13,20.666666666666668,10.333333333333334,>,10.333333333333334,0,0,=,0,62,31,>,31,47.666666666666664,35.333333333333336,>,12.333333333333329,43,30,>,13,51,42,>,9,188,109,>,79
0,12,25.0,14.333333333333334,>,10.666666666666666,0,0,=,0,47,24,>,23,37.666666666666664,52.666666666666664,<,-15.0,30,40,<,-10,51,59,<,-8,103,81,>,22
0,12,14.333333333333334,25.0,<,-10.666666666666666,0,0,=,0,24,47,<,-23,52.666666666666664,37.666666666666664,>,15.0,40,30,>,10,59,51,>,8,81,103,<,-22
0,12,25.0,27.333333333333332,<,-2.333333333333332,0,0,=,0,47,58,<,-11,37.666666666666664,45.666666666666664,<,-8.0,30,38,<,-8,51,51,=,0,103,126,<,-23
27,12,27.333333333333332,25.0,>,2.333333333333332,0,0,=,0,58,47,>,11,45.666666666666664,37.666666666666664,>,8.0,38,30,>,8,51,51,=,0,126,103,>,23
0,12,25.0,31.333333333333332,<,-6.333333333333332,0,0,=,0,47,54,<,-7,37.666666666666664,45.666666666666664,<,-8.0,30,34,<,-4,51,55,<,-4,103,143,<,-40
46,12,31.333333333333332,25.0,>,6.333333333333332,0,0,=,0,54,47,>,7,45.666666666666664,37.666666666666664,>,8.0,34,30,>,4,55,51,>,4,143,103,>,40
0,12,25.0,29.333333333333332,<,-4.333333333333332,0,0,=,0,47,69,<,-22,37.666666666666664,48.0,<,-10.333333333333336,30,40,<,-10,51,55,<,-4,103,126,<,-23
81,12,29.333333333333332,25.0,>,4.333333333333332,0,0,=,0,69,47,>,22,48.0,37.666666666666664,>,10.333333333333336,40,30,>,10,55,51,>,4,126,103,>,23
0,12,25.0,33.0,<,-8.0,0,0,=,0,47,56,<,-9,37.666666666666664,52.333333333333336,<,-14.666666666666671,30,39,<,-9,51,59,<,-8,103,153,<,-50
66,12,33.0,25.0,>,8.0,0,0,=,0,56,47,>,9,52.333333333333336,37.666666666666664,>,14.666666666666671,39,30,>,9,59,51,>,8,153,103,>,50
0,12,25.0,44.333333333333336,<,-19.333333333333336,0,0,=,0,47,77,<,-30,37.666666666666664,41.666666666666664,<,-4.0,30,30,=,0,51,51,=,0,103,122,<,-19
62,12,44.333333333333336,25.0,>,19.333333333333336,0,0,=,0,77,47,>,30,41.666666666666664,37.666666666666664,>,4.0,30,30,=,0,51,51,=,0,122,103,>,19
0,12,25.0,19.666666666666668,>,5.333333333333332,0,0,=,0,47,30,>,17,37.666666666666664,54.0,<,-16.333333333333336,30,52,<,-22,51,56,<,-5,103,150,<,-47
59,12,19.666666666666668,25.0,<,-5.333333333333332,0,0,=,0,30,47,<,-17,54.0,37.666666666666664,>,16.333333333333336,52,30,>,22,56,51,>,5,150,103,>,47
0,12,25.0,34.0,<,-9.0,0,0,=,0,47,66,<,-19,37.666666666666664,52.666666666666664,<,-15.0,30,48,<,-18,51,58,<,-7,103,151,<,-48
80,12,34.0,25.0,>,9.0,0,0,=,0,66,47,>,19,52.666666666666664,37.666666666666664,>,15.0,48,30,>,18,58,51,>,7,151,103,>,48
0,12,25.0,15.333333333333334,>,9.666666666666666,0,0,=,0,47,33,>,14,37.666666666666664,47.0,<,-9.333333333333336,30,44,<,-14,51,49,>,2,103,122,<,-19
0,12,15.333333333333334,25.0,<,-9.666666666666666,0,0,=,0,33,47,<,-14,47.0,37.666666666666664,>,9.333333333333336,44,30,>,14,49,51,<,-2,122,103,>,19
0,12,25.0,37.666666666666664,<,-12.666666666666664,0,0,=,0,47,81,<,-34,37.666666666666664,36.333333333333336,>,1.3333333333333286,30,34,<,-4,51,39,>,12,103,211,<,-108
139,12,37.666666666666664,25.0,>,12.666666666666664,0,0,=,0,81,47,>,34,36.333333333333336,37.666666666666664,<,-1.3333333333333286,34,30,>,4,39,51,<,-12,211,103,>,108
0,12,25.0,34.666666666666664,<,-9.666666666666664,0,0,=,0,47,62,<,-15,37.666666666666664,47.666666666666664,<,-10.0,30,43,<,-13,51,51,=,0,103,188,<,-85
138,12,34.666666666666664,25.0,>,9.666666666666664,0,0,=,0,62,47,>,15,47.666666666666664,37.666666666666664,>,10.0,43,30,>,13,51,51,=,0,188,103,>,85
0,11,23.0,14.0,>,9.0,0,0,=,0,56,23,>,33,47.0,52.666666666666664,<,-5.666666666666664,44,40,>,4,49,59,<,-10,122,81,>,41
0,11,14.0,23.0,<,-9.0,0,0,=,0,23,56,<,-33,52.666666666666664,47.0,>,5.666666666666664,40,44,<,-4,59,49,>,10,81,122,<,-41
0,11,23.0,41.0,<,-18.0,0,0,=,0,56,65,<,-9,47.0,45.666666666666664,>,1.3333333333333357,44,38,>,6,49,51,<,-2,122,126,<,-4
59,11,41.0,23.0,>,18.0,0,0,=,0,65,56,>,9,45.666666666666664,47.0,<,-1.3333333333333357,38,44,<,-6,51,49,>,2,126,122,>,4
0,11,23.0,42.666666666666664,<,-19.666666666666664,0,0,=,0,56,88,<,-32,47.0,45.666666666666664,>,1.3333333333333357,44,34,>,10,49,55,<,-6,122,143,<,-21
46,11,42.666666666666664,23.0,>,19.666666666666664,0,0,=,0,88,56,>,32,45.666666666666664,47.0,<,-1.3333333333333357,34,44,<,-10,55,49,>,6,143,122,>,21
0,11,23.0,23.0,=,0.0,0,0,=,0,56,39,>,17,47.0,54.0,<,-7.0,44,52,<,-8,49,56,<,-7,122,150,<,-28
50,11,23.0,23.0,=,0.0,0,0,=,0,39,56,<,-17,54.0,47.0,>,7.0,52,44,>,8,56,49,>,7,150,122,>,28
0,11,23.0,48.666666666666664,<,-25.666666666666664,0,0,=,0,56,90,<,-34,47.0,41.666666666666664,>,5.333333333333336,44,30,>,14,49,51,<,-2,122,122,=,0
62,11,48.666666666666664,23.0,>,25.666666666666664,0,0,=,0,90,56,>,34,41.666666666666664,47.0,<,-5.333333333333336,30,44,<,-14,51,49,>,2,122,122,=,0
0,11,23.0,40.666666666666664,<,-17.666666666666664,0,0,=,0,56,66,<,-10,47.0,52.333333333333336,<,-5.333333333333336,44,39,>,5,49,59,<,-10,122,153,<,-31
112,11,40.666666666666664,23.0,>,17.666666666666664,0,0,=,0,66,56,>,10,52.333333333333336,47.0,>,5.333333333333336,39,44,<,-5,59,49,>,10,153,122,>,31
0,11,23.0,39.333333333333336,<,-16.333333333333336,0,0,=,0,56,66,<,-10,47.0,52.666666666666664,<,-5.666666666666664,44,48,<,-4,49,58,<,-9,122,151,<,-29
80,11,39.333333333333336,23.0,>,16.333333333333336,0,0,=,0,66,56,>,10,52.666666666666664,47.0,>,5.666666666666664,48,44,>,4,58,49,>,9,151,122,>,29
0,11,23.0,15.333333333333334,>,7.666666666666666,0,0,=,0,56,27,>,29,47.0,48.0,<,-1.0,44,40,>,4,49,55,<,-6,122,126,<,-4
0,11,15.333333333333334,23.0,<,-7.666666666666666,0,0,=,0,27,56,<,-29,48.0,47.0,>,1.0,40,44,<,-4,55,49,>,6,126,122,>,4
0,11,23.0,25.666666666666668,<,-2.666666666666668,0,0,=,0,56,42,>,14,47.0,47.666666666666664,<,-0.6666666666666643,44,43,>,1,49,51,<,-2,122,188,<,-66
75,11,25.666666666666668,23.0,>,2.666666666666668,0,0,=,0,42,56,<,-14,47.666666666666664,47.0,>,0.6666666666666643,43,44,<,-1,51,49,>,2,188,122,>,66
0,11,23.0,22.333333333333332,>,0.6666666666666679,0,0,=,0,56,35,>,21,47.0,36.333333333333336,>,10.666666666666664,44,34,>,10,49,39,>,10,122,211,<,-89
102,11,22.333333333333332,23.0,<,-0.6666666666666679,0,0,=,0,35,56,<,-21,36.333333333333336,47.0,<,-10.666666666666664,34,44,<,-10,39,49,<,-10,211,122,>,89
0,10,29.333333333333332,27.0,>,2.333333333333332,0,0,=,0,65,54,>,11,52.666666666666664,48.0,>,4.666666666666664,40,40,=,0,59,55,>,4,81,126,<,-45
0,10,27.0,29.333333333333332,<,-2.333333333333332,0,0,=,0,54,65,<,-11,48.0,52.666666666666664,<,-4.666666666666664,40,40,=,0,55,59,<,-4,126,81,>,45
0,10,29.333333333333332,32.666666666666664,<,-3.333333333333332,0,0,=,0,65,88,<,-23,52.666666666666664,45.666666666666664,>,7.0,40,34,>,6,59,55,>,4,81,143,<,-62
46,10,32.666666666666664,29.333333333333332,>,3.333333333333332,0,0,=,0,88,65,>,23,45.666666666666664,52.666666666666664,<,-7.0,34,40,<,-6,55,59,<,-4,143,81,>,62
0,10,29.333333333333332,39.0,<,-9.666666666666668,0,0,=,0,65,78,<,-13,52.666666666666664,54.0,<,-1.3333333333333357,40,52,<,-12,59,56,>,3,81,150,<,-69
50,10,39.0,29.333333333333332,>,9.666666666666668,0,0,=,0,78,65,>,13,54.0,52.666666666666664,>,1.3333333333333357,52,40,>,12,56,59,<,-3,150,81,>,69
0,10,29.333333333333332,30.666666666666668,<,-1.3333333333333357,0,0,=,0,65,65,=,0,52.666666666666664,45.666666666666664,>,7.0,40,38,>,2,59,51,>,8,81,126,<,-45
40,10,30.666666666666668,29.333333333333332,>,1.3333333333333357,0,0,=,0,65,65,=,0,45.666666666666664,52.666666666666664,<,-7.0,38,40,<,-2,51,59,<,-8,126,81,>,45
0,10,29.333333333333332,35.666666666666664,<,-6.333333333333332,0,0,=,0,65,90,<,-25,52.666666666666664,41.666666666666664,>,11.0,40,30,>,10,59,51,>,8,81,122,<,-41
60,10,35.666666666666664,29.333333333333332,>,6.333333333333332,0,0,=,0,90,65,>,25,41.666666666666664,52.666666666666664,<,-11.0,30,40,<,-10,51,59,<,-8,122,81,>,41
0,10,29.333333333333332,15.666666666666666,>,13.666666666666666,0,0,=,0,65,35,>,30,52.666666666666664,47.666666666666664,>,5.0,40,43,<,-3,59,51,>,8,81,188,<,-107
0,10,15.666666666666666,29.333333333333332,<,-13.666666666666666,0,0,=,0,35,65,<,-30,47.666666666666664,52.666666666666664,<,-5.0,43,40,>,3,51,59,<,-8,188,81,>,107
0,10,29.333333333333332,29.666666666666668,<,-0.3333333333333357,0,0,=,0,65,52,>,13,52.666666666666664,52.666666666666664,=,0.0,40,48,<,-8,59,58,>,1,81,151,<,-70
80,10,29.666666666666668,29.333333333333332,>,0.3333333333333357,0,0,=,0,52,65,<,-13,52.666666666666664,52.666666666666664,=,0.0,48,40,>,8,58,59,<,-1,151,81,>,70
0,10,29.333333333333332,37.333333333333336,<,-8.000000000000004,0,0,=,0,65,77,<,-12,52.666666666666664,36.333333333333336,>,16.33333333333333,40,34,>,6,59,39,>,20,81,211,<,-130
102,10,37.333333333333336,29.333333333333332,>,8.000000000000004,0,0,=,0,77,65,>,12,36.333333333333336,52.666666666666664,<,-16.33333333333333,34,40,<,-6,39,59,<,-20,211,81,>,130
0,10,29.333333333333332,37.666666666666664,<,-8.333333333333332,0,0,=,0,65,66,<,-1,52.666666666666664,52.333333333333336,>,0.3333333333333286,40,39,>,1,59,59,=,0,81,153,<,-72
76,10,37.666666666666664,29.333333333333332,>,8.333333333333332,0,0,=,0,66,65,>,1,52.333333333333336,52.666666666666664,<,-0.3333333333333286,39,40,<,-1,59,59,=,0,153,81,>,72
0,9,34.333333333333336,37.333333333333336,<,-3.0,12,27,<,-15,56,54,>,2,47.666666666666664,48.0,<,-0.3333333333333357,43,40,>,3,51,55,<,-4,188,126,>,62
0,9,37.333333333333336,34.333333333333336,>,3.0,27,12,>,15,54,56,<,-2,48.0,47.666666666666664,>,0.3333333333333357,40,43,<,-3,55,51,>,4,126,188,<,-62
0,9,34.333333333333336,49.666666666666664,<,-15.333333333333329,12,27,<,-15,56,65,<,-9,47.666666666666664,45.666666666666664,>,2.0,43,38,>,5,51,51,=,0,188,126,>,62
40,9,49.666666666666664,34.333333333333336,>,15.333333333333329,27,12,>,15,65,56,>,9,45.666666666666664,47.666666666666664,<,-2.0,38,43,<,-5,51,51,=,0,126,188,<,-62
0,9,34.333333333333336,37.666666666666664,<,-3.3333333333333286,12,10,>,2,56,88,<,-32,47.666666666666664,45.666666666666664,>,2.0,43,34,>,9,51,55,<,-4,188,143,>,45
0,9,37.666666666666664,34.333333333333336,>,3.3333333333333286,10,12,<,-2,88,56,>,32,45.666666666666664,47.666666666666664,<,-2.0,34,43,<,-9,55,51,>,4,143,188,<,-45
0,9,34.333333333333336,61.333333333333336,<,-27.0,12,39,<,-27,56,78,<,-22,47.666666666666664,54.0,<,-6.333333333333336,43,52,<,-9,51,56,<,-5,188,150,>,38
50,9,61.333333333333336,34.333333333333336,>,27.0,39,12,>,27,78,56,>,22,54.0,47.666666666666664,>,6.333333333333336,52,43,>,9,56,51,>,5,150,188,<,-38
0,9,34.333333333333336,60.0,<,-25.666666666666664,12,17,<,-5,56,90,<,-34,47.666666666666664,41.666666666666664,>,6.0,43,30,>,13,51,51,=,0,188,122,>,66
60,9,60.0,34.333333333333336,>,25.666666666666664,17,12,>,5,90,56,>,34,41.666666666666664,47.666666666666664,<,-6.0,30,43,<,-13,51,51,=,0,122,188,<,-66
0,9,34.333333333333336,55.666666666666664,<,-21.33333333333333,12,47,<,-35,56,66,<,-10,47.666666666666664,52.333333333333336,<,-4.666666666666671,43,39,>,4,51,59,<,-8,188,153,>,35
76,9,55.666666666666664,34.333333333333336,>,21.33333333333333,47,12,>,35,66,56,>,10,52.333333333333336,47.666666666666664,>,4.666666666666671,39,43,<,-4,59,51,>,8,153,188,<,-35
0,9,34.333333333333336,42.666666666666664,<,-8.333333333333329,12,37,<,-25,56,52,>,4,47.666666666666664,52.666666666666664,<,-5.0,43,48,<,-5,51,58,<,-7,188,151,>,37
91,9,42.666666666666664,34.333333333333336,>,8.333333333333329,37,12,>,25,52,56,<,-4,52.666666666666664,47.666666666666664,>,5.0,48,43,>,5,58,51,>,7,151,188,<,-37
0,9,34.333333333333336,44.333333333333336,<,-10.0,12,21,<,-9,56,77,<,-21,47.666666666666664,36.333333333333336,>,11.333333333333329,43,34,>,9,51,39,>,12,188,211,<,-23
75,9,44.333333333333336,34.333333333333336,>,10.0,21,12,>,9,77,56,>,21,36.333333333333336,47.666666666666664,<,-11.333333333333329,34,43,<,-9,39,51,<,-12,211,188,>,23
0,8,58.666666666666664,30.333333333333332,>,28.333333333333332,15,27,<,-12,88,33,>,55,45.666666666666664,48.0,<,-2.3333333333333357,34,40,<,-6,55,55,=,0,143,126,>,17
0,8,30.333333333333332,58.666666666666664,<,-28.333333333333332,27,15,>,12,33,88,<,-55,48.0,45.666666666666664,>,2.3333333333333357,40,34,>,6,55,55,=,0,126,143,<,-17
0,8,58.666666666666664,56.666666666666664,>,2.0,15,48,<,-33,88,65,>,23,45.666666666666664,45.666666666666664,=,0.0,34,38,<,-4,55,51,>,4,143,126,>,17
70,8,56.666666666666664,58.666666666666664,<,-2.0,48,15,>,33,65,88,<,-23,45.666666666666664,45.666666666666664,=,0.0,38,34,>,4,51,55,<,-4,126,143,<,-17
0,8,58.666666666666664,61.333333333333336,<,-2.6666666666666714,15,39,<,-24,88,78,>,10,45.666666666666664,54.0,<,-8.333333333333336,34,52,<,-18,55,56,<,-1,143,150,<,-7
50,8,61.333333333333336,58.666666666666664,>,2.6666666666666714,39,15,>,24,78,88,<,-10,54.0,45.666666666666664,>,8.333333333333336,52,34,>,18,56,55,>,1,150,143,>,7
0,8,58.666666666666664,82.0,<,-23.333333333333336,15,73,<,-58,88,90,<,-2,45.666666666666664,41.666666666666664,>,4.0,34,30,>,4,55,51,>,4,143,122,>,21
150,8,82.0,58.666666666666664,>,23.333333333333336,73,15,>,58,90,88,>,2,41.666666666666664,45.666666666666664,<,-4.0,30,34,<,-4,51,55,<,-4,122,143,<,-21
0,8,58.666666666666664,22.666666666666668,>,36.0,15,12,>,3,88,35,>,53,45.666666666666664,36.333333333333336,>,9.333333333333329,34,34,=,0,55,39,>,16,143,211,<,-68
0,8,22.666666666666668,58.666666666666664,<,-36.0,12,15,<,-3,35,88,<,-53,36.333333333333336,45.666666666666664,<,-9.333333333333329,34,34,=,0,39,55,<,-16,211,143,>,68
0,8,58.666666666666664,55.0,>,3.6666666666666643,15,45,<,-30,88,66,>,22,45.666666666666664,52.333333333333336,<,-6.666666666666671,34,39,<,-5,55,59,<,-4,143,153,<,-10
67,8,55.0,58.666666666666664,<,-3.6666666666666643,45,15,>,30,66,88,<,-22,52.333333333333336,45.666666666666664,>,6.666666666666671,39,34,>,5,59,55,>,4,153,143,>,10
0,8,58.666666666666664,56.666666666666664,>,2.0,15,39,<,-24,88,79,>,9,45.666666666666664,52.666666666666664,<,-7.0,34,48,<,-14,55,58,<,-3,143,151,<,-8
91,8,56.666666666666664,58.666666666666664,<,-2.0,39,15,>,24,79,88,<,-9,52.666666666666664,45.666666666666664,>,7.0,48,34,>,14,58,55,>,3,151,143,>,8
0,7,23.333333333333332,46.0,<,-22.666666666666668,12,27,<,-15,35,78,<,-43,36.333333333333336,48.0,<,-11.666666666666664,34,40,<,-6,39,55,<,-16,211,126,>,85
0,7,46.0,23.333333333333332,>,22.666666666666668,27,12,>,15,78,35,>,43,48.0,36.333333333333336,>,11.666666666666664,40,34,>,6,55,39,>,16,126,211,<,-85
0,7,23.333333333333332,68.0,<,-44.66666666666667,12,39,<,-27,35,87,<,-52,36.333333333333336,54.0,<,-17.666666666666664,34,52,<,-18,39,56,<,-17,211,150,>,61
50,7,68.0,23.333333333333332,>,44.66666666666667,39,12,>,27,87,35,>,52,54.0,36.333333333333336,>,17.666666666666664,52,34,>,18,56,39,>,17,150,211,<,-61
0,7,23.333333333333332,60.0,<,-36.66666666666667,12,45,<,-33,35,69,<,-34,36.333333333333336,52.333333333333336,<,-16.0,34,39,<,-5,39,59,<,-20,211,153,>,58
67,7,60.0,23.333333333333332,>,36.66666666666667,45,12,>,33,69,35,>,34,52.333333333333336,36.333333333333336,>,16.0,39,34,>,5,59,39,>,20,153,211,<,-58
0,7,23.333333333333332,60.0,<,-36.66666666666667,12,48,<,-36,35,67,<,-32,36.333333333333336,45.666666666666664,<,-9.333333333333329,34,38,<,-4,39,51,<,-12,211,126,>,85
70,7,60.0,23.333333333333332,>,36.66666666666667,48,12,>,36,67,35,>,32,45.666666666666664,36.333333333333336,>,9.333333333333329,38,34,>,4,51,39,>,12,126,211,<,-85
0,7,23.333333333333332,50.666666666666664,<,-27.333333333333332,12,21,<,-9,35,79,<,-44,36.333333333333336,52.666666666666664,<,-16.33333333333333,34,48,<,-14,39,58,<,-19,211,151,>,60
0,7,50.666666666666664,23.333333333333332,>,27.333333333333332,21,12,>,9,79,35,>,44,52.666666666666664,36.333333333333336,>,16.33333333333333,48,34,>,14,58,39,>,19,151,211,<,-60
0,7,23.333333333333332,73.33333333333333,<,-50.0,12,47,<,-35,35,90,<,-55,36.333333333333336,41.666666666666664,<,-5.333333333333329,34,30,>,4,39,51,<,-12,211,122,>,89
69,7,73.33333333333333,23.333333333333332,>,50.0,47,12,>,35,90,35,>,55,41.666666666666664,36.333333333333336,>,5.333333333333329,30,34,<,-4,51,39,>,12,122,211,<,-89
0,6,28.0,38.333333333333336,<,-10.333333333333336,11,10,>,1,52,78,<,-26,52.666666666666664,48.0,>,4.666666666666664,48,40,>,8,58,55,>,3,151,126,>,25
0,6,38.333333333333336,28.0,>,10.333333333333336,10,11,<,-1,78,52,>,26,48.0,52.666666666666664,<,-4.666666666666664,40,48,<,-8,55,58,<,-3,126,151,<,-25
0,6,28.0,70.0,<,-42.0,11,39,<,-28,52,87,<,-35,52.666666666666664,54.0,<,-1.3333333333333357,48,52,<,-4,58,56,>,2,151,150,>,1
50,6,70.0,28.0,>,42.0,39,11,>,28,87,52,>,35,54.0,52.666666666666664,>,1.3333333333333357,52,48,>,4,56,58,<,-2,150,151,<,-1
0,6,28.0,65.66666666666667,<,-37.66666666666667,11,62,<,-51,52,69,<,-17,52.666666666666664,52.333333333333336,>,0.3333333333333286,48,39,>,9,58,59,<,-1,151,153,<,-2
43,6,65.66666666666667,28.0,>,37.66666666666667,62,11,>,51,69,52,>,17,52.333333333333336,52.666666666666664,<,-0.3333333333333286,39,48,<,-9,59,58,>,1,153,151,>,2
0,6,28.0,70.66666666666667,<,-42.66666666666667,11,47,<,-36,52,90,<,-38,52.666666666666664,41.666666666666664,>,11.0,48,30,>,18,58,51,>,7,151,122,>,29
69,6,70.66666666666667,28.0,>,42.66666666666667,47,11,>,36,90,52,>,38,41.666666666666664,52.666666666666664,<,-11.0,30,48,<,-18,51,58,<,-7,122,151,<,-29
0,6,28.0,53.666666666666664,<,-25.666666666666664,11,29,<,-18,52,67,<,-15,52.666666666666664,45.666666666666664,>,7.0,48,38,>,10,58,51,>,7,151,126,>,25
0,6,53.666666666666664,28.0,>,25.666666666666664,29,11,>,18,67,52,>,15,45.666666666666664,52.666666666666664,<,-7.0,38,48,<,-10,51,58,<,-7,126,151,<,-25
0,5,34.666666666666664,41.333333333333336,<,-6.666666666666671,10,10,=,0,65,87,<,-22,45.666666666666664,48.0,<,-2.3333333333333357,38,40,<,-2,51,55,<,-4,126,126,=,0
0,5,41.333333333333336,34.666666666666664,>,6.666666666666671,10,10,=,0,87,65,>,22,48.0,45.666666666666664,>,2.3333333333333357,40,38,>,2,55,51,>,4,126,126,=,0
0,5,34.666666666666664,56.0,<,-21.333333333333336,10,40,<,-30,65,66,<,-1,45.666666666666664,52.333333333333336,<,-6.666666666666671,38,39,<,-1,51,59,<,-8,126,153,<,-27
43,5,56.0,34.666666666666664,>,21.333333333333336,40,10,>,30,66,65,>,1,52.333333333333336,45.666666666666664,>,6.666666666666671,39,38,>,1,59,51,>,8,153,126,>,27
0,5,34.666666666666664,52.333333333333336,<,-17.66666666666667,10,34,<,-24,65,84,<,-19,45.666666666666664,54.0,<,-8.333333333333336,38,52,<,-14,51,56,<,-5,126,150,<,-24
50,5,52.333333333333336,34.666666666666664,>,17.66666666666667,34,10,>,24,84,65,>,19,54.0,45.666666666666664,>,8.333333333333336,52,38,>,14,56,51,>,5,150,126,>,24
0,5,34.666666666666664,59.0,<,-24.333333333333336,10,12,<,-2,65,90,<,-25,45.666666666666664,41.666666666666664,>,4.0,38,30,>,8,51,51,=,0,126,122,>,4
0,5,59.0,34.666666666666664,>,24.333333333333336,12,10,>,2,90,65,>,25,41.666666666666664,45.666666666666664,<,-4.0,30,38,<,-8,51,51,=,0,122,126,<,-4
0,4,55.333333333333336,52.0,>,3.3333333333333357,27,12,>,15,87,90,<,-3,48.0,41.666666666666664,>,6.333333333333336,40,30,>,10,55,51,>,4,126,122,>,4
0,4,52.0,55.333333333333336,<,-3.3333333333333357,12,27,<,-15,90,87,>,3,41.666666666666664,48.0,<,-6.333333333333336,30,40,<,-10,51,55,<,-4,122,126,<,-4
0,4,55.333333333333336,53.0,>,2.3333333333333357,27,40,<,-13,87,66,>,21,48.0,52.333333333333336,<,-4.333333333333336,40,39,>,1,55,59,<,-4,126,153,<,-27
87,4,53.0,55.333333333333336,<,-2.3333333333333357,40,27,>,13,66,87,<,-21,52.333333333333336,48.0,>,4.333333333333336,39,40,<,-1,59,55,>,4,153,126,>,27
0,4,55.333333333333336,40.666666666666664,>,14.666666666666671,27,34,<,-7,87,49,>,38,48.0,54.0,<,-6.0,40,52,<,-12,55,56,<,-1,126,150,<,-24
83,4,40.666666666666664,55.333333333333336,<,-14.666666666666671,34,27,>,7,49,87,<,-38,54.0,48.0,>,6.0,52,40,>,12,56,55,>,1,150,126,>,24
0,3,31.0,31.666666666666668,<,-0.6666666666666679,12,12,=,0,54,49,>,5,41.666666666666664,54.0,<,-12.333333333333336,30,52,<,-22,51,56,<,-5,122,150,<,-28
0,3,31.666666666666668,31.0,>,0.6666666666666679,12,12,=,0,49,54,<,-5,54.0,41.666666666666664,>,12.333333333333336,52,30,>,22,56,51,>,5,150,122,>,28
0,3,31.0,42.333333333333336,<,-11.333333333333336,12,34,<,-22,54,53,>,1,41.666666666666664,52.333333333333336,<,-10.666666666666671,30,39,<,-9,51,59,<,-8,122,153,<,-31
17,3,42.333333333333336,31.0,>,11.333333333333336,34,12,>,22,53,54,<,-1,52.333333333333336,41.666666666666664,>,10.666666666666671,39,30,>,9,59,51,>,8,153,122,>,31
0,2,25.666666666666668,34.666666666666664,<,-8.999999999999996,12,17,<,-5,49,53,<,-4,54.0,52.333333333333336,>,1.6666666666666643,52,39,>,13,56,59,<,-3,150,153,<,-3
0,2,34.666666666666664,25.666666666666668,>,8.999999999999996,17,12,>,5,53,49,>,4,52.333333333333336,54.0,<,-1.6666666666666643,39,52,<,-13,59,56,>,3,153,150,>,3
0,10,0.0,0.0,=,0.0,0,0,=,0,0,0,=,0,47.333333333333336,41.0,>,6.333333333333336,40,35,>,5,53,44,>,9,88,145,<,-57
26,10,0.0,0.0,=,0.0,0,0,=,0,0,0,=,0,41.0,47.333333333333336,<,-6.333333333333336,35,40,<,-5,44,53,<,-9,145,88,>,57
0,10,0.0,0.0,=,0.0,0,0,=,0,0,0,=,0,47.333333333333336,49.333333333333336,<,-2.0,40,41,<,-1,53,57,<,-4,88,69,>,19
0,10,0.0,0.0,=,0.0,0,0,=,0,0,0,=,0,49.333333333333336,47.333333333333336,>,2.0,41,40,>,1,57,53,>,4,69,88,<,-19
0,10,0.0,0.0,=,0.0,0,0,=,0,0,0,=,0,47.333333333333336,48.666666666666664,<,-1.3333333333333286,40,39,>,1,53,57,<,-4,88,99,<,-11
15,10,0.0,0.0,=,0.0,0,0,=,0,0,0,=,0,48.666666666666664,47.333333333333336,>,1.3333333333333286,39,40,<,-1,57,53,>,4,99,88,>,11
0,10,0.0,0.0,=,0.0,0,0,=,0,0,0,=,0,47.333333333333336,43.333333333333336,>,4.0,40,31,>,9,53,59,<,-6,88,136,<,-48
0,10,0.0,0.0,=,0.0,0,0,=,0,0,0,=,0,43.333333333333336,47.333333333333336,<,-4.0,31,40,<,-9,59,53,>,6,136,88,>,48
0,10,0.0,0.0,=,0.0,0,0,=,0,0,0,=,0,47.333333333333336,49.666666666666664,<,-2.3333333333333286,40,41,<,-1,53,55,<,-2,88,121,<,-33
8,10,0.0,0.0,=,0.0,0,0,=,0,0,0,=,0,49.666666666666664,47.333333333333336,>,2.3333333333333286,41,40,>,1,55,53,>,2,121,88,>,33
0,10,0.0,0.0,=,0.0,0,0,=,0,0,0,=,0,47.333333333333336,43.666666666666664,>,3.6666666666666714,40,30,>,10,53,59,<,-6,88,137,<,-49
58,10,0.0,0.0,=,0.0,0,0,=,0,0,0,=,0,43.666666666666664,47.333333333333336,<,-3.6666666666666714,30,40,<,-10,59,53,>,6,137,88,>,49
0,10,0.0,0.0,=,0.0,0,0,=,0,0,0,=,0,47.333333333333336,51.0,<,-3.6666666666666643,40,43,<,-3,53,56,<,-3,88,129,<,-41
57,10,0.0,0.0,=,0.0,0,0,=,0,0,0,=,0,51.0,47.333333333333336,>,3.6666666666666643,43,40,>,3,56,53,>,3,129,88,>,41
0,10,0.0,0.0,=,0.0,0,0,=,0,0,0,=,0,47.333333333333336,40.0,>,7.333333333333336,40,37,>,3,53,44,>,9,88,136,<,-48
46,10,0.0,0.0,=,0.0,0,0,=,0,0,0,=,0,40.0,47.333333333333336,<,-7.333333333333336,37,40,<,-3,44,53,<,-9,136,88,>,48
0,10,0.0,0.0,=,0.0,0,0,=,0,0,0,=,0,47.333333333333336,47.0,>,0.3333333333333357,40,44,<,-4,53,50,>,3,88,99,<,-11
37,10,0.0,0.0,=,0.0,0,0,=,0,0,0,=,0,47.0,47.333333333333336,<,-0.3333333333333357,44,40,>,4,50,53,<,-3,99,88,>,11
0,9,25.0,24.666666666666668,>,0.33333333333333215,0,0,=,0,75,74,>,1,49.333333333333336,43.333333333333336,>,6.0,41,31,>,10,57,59,<,-2,69,136,<,-67
0,9,24.666666666666668,25.0,<,-0.33333333333333215,0,0,=,0,74,75,<,-1,43.333333333333336,49.333333333333336,<,-6.0,31,41,<,-10,59,57,>,2,136,69,>,67
0,9,25.0,7.0,>,18.0,0,0,=,0,75,21,>,54,49.333333333333336,49.666666666666664,<,-0.3333333333333286,41,41,=,0,57,55,>,2,69,121,<,-52
8,9,7.0,25.0,<,-18.0,0,0,=,0,21,75,<,-54,49.666666666666664,49.333333333333336,>,0.3333333333333286,41,41,=,0,55,57,<,-2,121,69,>,52
0,9,25.0,4.333333333333333,>,20.666666666666668,0,0,=,0,75,13,>,62,49.333333333333336,48.666666666666664,>,0.6666666666666714,41,39,>,2,57,57,=,0,69,99,<,-30
0,9,4.333333333333333,25.0,<,-20.666666666666668,0,0,=,0,13,75,<,-62,48.666666666666664,49.333333333333336,<,-0.6666666666666714,39,41,<,-2,57,57,=,0,99,69,>,30
0,9,25.0,12.0,>,13.0,0,0,=,0,75,36,>,39,49.333333333333336,41.0,>,8.333333333333336,41,35,>,6,57,44,>,13,69,145,<,-76
26,9,12.0,25.0,<,-13.0,0,0,=,0,36,75,<,-39,41.0,49.333333333333336,<,-8.333333333333336,35,41,<,-6,44,57,<,-13,145,69,>,76
0,9,25.0,8.0,>,17.0,0,0,=,0,75,24,>,51,49.333333333333336,47.0,>,2.3333333333333357,41,44,<,-3,57,50,>,7,69,99,<,-30
37,9,8.0,25.0,<,-17.0,0,0,=,0,24,75,<,-51,47.0,49.333333333333336,<,-2.3333333333333357,44,41,>,3,50,57,<,-7,99,69,>,30
0,9,25.0,26.0,<,-1.0,0,0,=,0,75,78,<,-3,49.333333333333336,40.0,>,9.333333333333336,41,37,>,4,57,44,>,13,69,136,<,-67
46,9,26.0,25.0,>,1.0,0,0,=,0,78,75,>,3,40.0,49.333333333333336,<,-9.333333333333336,37,41,<,-4,44,57,<,-13,136,69,>,67
0,9,25.0,4.0,>,21.0,0,0,=,0,75,12,>,63,49.333333333333336,51.0,<,-1.6666666666666643,41,43,<,-2,57,56,>,1,69,129,<,-60
57,9,4.0,25.0,<,-21.0,0,0,=,0,12,75,<,-63,51.0,49.333333333333336,>,1.6666666666666643,43,41,>,2,56,57,<,-1,129,69,>,60
0,9,25.0,29.666666666666668,<,-4.666666666666668,0,0,=,0,75,89,<,-14,49.333333333333336,43.666666666666664,>,5.666666666666671,41,30,>,11,57,59,<,-2,69,137,<,-68
58,9,29.666666666666668,25.0,>,4.666666666666668,0,0,=,0,89,75,>,14,43.666666666666664,49.333333333333336,<,-5.666666666666671,30,41,<,-11,59,57,>,2,137,69,>,68
0,8,15.0,28.333333333333332,<,-13.333333333333332,0,0,=,0,32,74,<,-42,48.666666666666664,43.333333333333336,>,5.333333333333329,39,31,>,8,57,59,<,-2,99,136,<,-37
0,8,28.333333333333332,15.0,>,13.333333333333332,0,0,=,0,74,32,>,42,43.333333333333336,48.666666666666664,<,-5.333333333333329,31,39,<,-8,59,57,>,2,136,99,>,37
0,8,15.0,19.333333333333332,<,-4.333333333333332,0,0,=,0,32,37,<,-5,48.666666666666664,49.666666666666664,<,-1.0,39,41,<,-2,57,55,>,2,99,121,<,-22
8,8,19.333333333333332,15.0,>,4.333333333333332,0,0,=,0,37,32,>,5,49.666666666666664,48.666666666666664,>,1.0,41,39,>,2,55,57,<,-2,121,99,>,22
0,8,15.0,21.666666666666668,<,-6.666666666666668,0,0,=,0,32,36,<,-4,48.666666666666664,41.0,>,7.666666666666664,39,35,>,4,57,44,>,13,99,145,<,-46
26,8,21.666666666666668,15.0,>,6.666666666666668,0,0,=,0,36,32,>,4,41.0,48.666666666666664,<,-7.666666666666664,35,39,<,-4,44,57,<,-13,145,99,>,46
0,8,15.0,11.666666666666666,>,3.333333333333334,0,0,=,0,32,24,>,8,48.666666666666664,47.0,>,1.6666666666666643,39,44,<,-5,57,50,>,7,99,99,=,0
24,8,11.666666666666666,15.0,<,-3.333333333333334,0,0,=,0,24,32,<,-8,47.0,48.666666666666664,<,-1.6666666666666643,44,39,>,5,50,57,<,-7,99,99,=,0
0,8,15.0,31.0,<,-16.0,0,0,=,0,32,78,<,-46,48.666666666666664,40.0,>,8.666666666666664,39,37,>,2,57,44,>,13,99,136,<,-37
0,8,31.0,15.0,>,16.0,0,0,=,0,78,32,>,46,40.0,48.666666666666664,<,-8.666666666666664,37,39,<,-2,44,57,<,-13,136,99,>,37
0,8,15.0,32.333333333333336,<,-17.333333333333336,0,0,=,0,32,85,<,-53,48.666666666666664,51.0,<,-2.3333333333333357,39,43,<,-4,57,56,>,1,99,129,<,-30
64,8,32.333333333333336,15.0,>,17.333333333333336,0,0,=,0,85,32,>,53,51.0,48.666666666666664,>,2.3333333333333357,43,39,>,4,56,57,<,-1,129,99,>,30
0,8,15.0,39.666666666666664,<,-24.666666666666664,0,0,=,0,32,89,<,-57,48.666666666666664,43.666666666666664,>,5.0,39,30,>,9,57,59,<,-2,99,137,<,-38
16,8,39.666666666666664,15.0,>,24.666666666666664,0,0,=,0,89,32,>,57,43.666666666666664,48.666666666666664,<,-5.0,30,39,<,-9,59,57,>,2,137,99,>,38
0,7,14.0,20.0,<,-6.0,0,0,=,0,31,45,<,-14,43.333333333333336,40.0,>,3.3333333333333357,31,37,<,-6,59,44,>,15,136,136,=,0
0,7,20.0,14.0,>,6.0,0,0,=,0,45,31,>,14,40.0,43.333333333333336,<,-3.3333333333333357,37,31,>,6,44,59,<,-15,136,136,=,0
0,7,14.0,42.333333333333336,<,-28.333333333333336,0,0,=,0,31,90,<,-59,43.333333333333336,49.666666666666664,<,-6.333333333333329,31,41,<,-10,59,55,>,4,136,121,>,15
8,7,42.333333333333336,14.0,>,28.333333333333336,0,0,=,0,90,31,>,59,49.666666666666664,43.333333333333336,>,6.333333333333329,41,31,>,10,55,59,<,-4,121,136,<,-15
0,7,14.0,21.666666666666668,<,-7.666666666666668,0,0,=,0,31,35,<,-4,43.333333333333336,43.666666666666664,<,-0.3333333333333286,31,30,>,1,59,59,=,0,136,137,<,-1
16,7,21.666666666666668,14.0,>,7.666666666666668,0,0,=,0,35,31,>,4,43.666666666666664,43.333333333333336,>,0.3333333333333286,30,31,<,-1,59,59,=,0,137,136,>,1
0,7,14.0,10.0,>,4.0,0,0,=,0,31,19,>,12,43.333333333333336,47.0,<,-3.6666666666666643,31,44,<,-13,59,50,>,9,136,99,>,37
24,7,10.0,14.0,<,-4.0,0,0,=,0,19,31,<,-12,47.0,43.333333333333336,>,3.6666666666666643,44,31,>,13,50,59,<,-9,99,136,<,-37
0,7,14.0,16.666666666666668,<,-2.666666666666668,0,0,=,0,31,29,>,2,43.333333333333336,41.0,>,2.3333333333333357,31,35,<,-4,59,44,>,15,136,145,<,-9
26,7,16.666666666666668,14.0,>,2.666666666666668,0,0,=,0,29,31,<,-2,41.0,43.333333333333336,<,-2.3333333333333357,35,31,>,4,44,59,<,-15,145,136,>,9
0,7,14.0,34.333333333333336,<,-20.333333333333336,0,0,=,0,31,85,<,-54,43.333333333333336,51.0,<,-7.666666666666664,31,43,<,-12,59,56,>,3,136,129,>,7
0,7,34.333333333333336,14.0,>,20.333333333333336,0,0,=,0,85,31,>,54,51.0,43.333333333333336,>,7.666666666666664,43,31,>,12,56,59,<,-3,129,136,<,-7
0,6,50.0,43.0,>,7.0,18,15,>,3,85,69,>,16,51.0,40.0,>,11.0,43,37,>,6,56,44,>,12,129,136,<,-7
0,6,43.0,50.0,<,-7.0,15,18,<,-3,69,85,<,-16,40.0,51.0,<,-11.0,37,43,<,-6,44,56,<,-12,136,129,>,7
0,6,50.0,65.66666666666667,<,-15.666666666666671,18,37,<,-19,85,90,<,-5,51.0,49.666666666666664,>,1.3333333333333357,43,41,>,2,56,55,>,1,129,121,>,8
36,6,65.66666666666667,50.0,>,15.666666666666671,37,18,>,19,90,85,>,5,49.666666666666664,51.0,<,-1.3333333333333357,41,43,<,-2,55,56,<,-1,121,129,<,-8
0,6,50.0,49.333333333333336,>,0.6666666666666643,18,30,<,-12,85,83,>,2,51.0,43.666666666666664,>,7.333333333333336,43,30,>,13,56,59,<,-3,129,137,<,-8
16,6,49.333333333333336,50.0,<,-0.6666666666666643,30,18,>,12,83,85,<,-2,43.666666666666664,51.0,<,-7.333333333333336,30,43,<,-13,59,56,>,3,137,129,>,8
0,6,50.0,17.0,>,33.0,18,11,>,7,85,21,>,64,51.0,47.0,>,4.0,43,44,<,-1,56,50,>,6,129,99,>,30
0,6,17.0,50.0,<,-33.0,11,18,<,-7,21,85,<,-64,47.0,51.0,<,-4.0,44,43,>,1,50,56,<,-6,99,129,<,-30
0,6,50.0,37.666666666666664,>,12.333333333333336,18,21,<,-3,85,63,>,22,51.0,41.0,>,10.0,43,35,>,8,56,44,>,12,129,145,<,-16
87,6,37.666666666666664,50.0,<,-12.333333333333336,21,18,>,3,63,85,<,-22,41.0,51.0,<,-10.0,35,43,<,-8,44,56,<,-12,145,129,>,16
0,5,55.0,29.666666666666668,>,25.333333333333332,15,11,>,4,81,57,>,24,40.0,47.0,<,-7.0,37,44,<,-7,44,50,<,-6,136,99,>,37
0,5,29.666666666666668,55.0,<,-25.333333333333332,11,15,<,-4,57,81,<,-24,47.0,40.0,>,7.0,44,37,>,7,50,44,>,6,99,136,<,-37
0,5,55.0,59.666666666666664,<,-4.666666666666664,15,30,<,-15,81,83,<,-2,40.0,43.666666666666664,<,-3.6666666666666643,37,30,>,7,44,59,<,-15,136,137,<,-1
16,5,59.666666666666664,55.0,>,4.666666666666664,30,15,>,15,83,81,>,2,43.666666666666664,40.0,>,3.6666666666666643,30,37,<,-7,59,44,>,15,137,136,>,1
0,5,55.0,56.333333333333336,<,-1.3333333333333357,15,37,<,-22,81,70,>,11,40.0,49.666666666666664,<,-9.666666666666664,37,41,<,-4,44,55,<,-11,136,121,>,15
36,5,56.333333333333336,55.0,>,1.3333333333333357,37,15,>,22,70,81,<,-11,49.666666666666664,40.0,>,9.666666666666664,41,37,>,4,55,44,>,11,121,136,<,-15
0,5,55.0,45.666666666666664,>,9.333333333333336,15,29,<,-14,81,63,>,18,40.0,41.0,<,-1.0,37,35,>,2,44,44,=,0,136,145,<,-9
91,5,45.666666666666664,55.0,<,-9.333333333333336,29,15,>,14,63,81,<,-18,41.0,40.0,>,1.0,35,37,<,-2,44,44,=,0,145,136,>,9
0,4,53.0,53.666666666666664,<,-0.6666666666666643,21,12,>,9,81,83,<,-2,47.0,43.666666666666664,>,3.3333333333333357,44,30,>,14,50,59,<,-9,99,137,<,-38
0,4,53.666666666666664,53.0,>,0.6666666666666643,12,21,<,-9,83,81,>,2,43.666666666666664,47.0,<,-3.3333333333333357,30,44,<,-14,59,50,>,9,137,99,>,38
0,4,53.0,61.0,<,-8.0,21,51,<,-30,81,70,>,11,47.0,49.666666666666664,<,-2.6666666666666643,44,41,>,3,50,55,<,-5,99,121,<,-22
42,4,61.0,53.0,>,8.0,51,21,>,30,70,81,<,-11,49.666666666666664,47.0,>,2.6666666666666643,41,44,<,-3,55,50,>,5,121,99,>,22
0,4,53.0,43.666666666666664,>,9.333333333333336,21,23,<,-2,81,63,>,18,47.0,41.0,>,6.0,44,35,>,9,50,44,>,6,99,145,<,-46
42,4,43.666666666666664,53.0,<,-9.333333333333336,23,21,>,2,63,81,<,-18,41.0,47.0,<,-6.0,35,44,<,-9,44,50,<,-6,145,99,>,46
0,3,34.0,27.666666666666668,>,6.333333333333332,12,15,<,-3,66,45,>,21,43.666666666666664,41.0,>,2.6666666666666643,30,35,<,-5,59,44,>,15,137,145,<,-8
0,3,27.666666666666668,34.0,<,-6.333333333333332,15,12,>,3,45,66,<,-21,41.0,43.666666666666664,<,-2.6666666666666643,35,30,>,5,44,59,<,-15,145,137,>,8
0,3,34.0,63.333333333333336,<,-29.333333333333336,12,51,<,-39,66,77,<,-11,43.666666666666664,49.666666666666664,<,-6.0,30,41,<,-11,59,55,>,4,137,121,>,16
42,3,63.333333333333336,34.0,>,29.333333333333336,51,12,>,39,77,66,>,11,49.666666666666664,43.666666666666664,>,6.0,41,30,>,11,55,59,<,-4,121,137,<,-16
0,2,48.0,71.0,<,-23.0,15,62,<,-47,84,77,>,7,41.0,49.666666666666664,<,-8.666666666666664,35,41,<,-6,44,55,<,-11,145,121,>,24
65,2,71.0,48.0,>,23.0,62,15,>,47,77,84,<,-7,49.666666666666664,41.0,>,8.666666666666664,41,35,>,6,55,44,>,11,121,145,<,-24
0,17,0.0,0.0,=,0.0,0,0,=,0,0,0,=,0,41.333333333333336,41.333333333333336,=,0.0,31,30,>,1,47,59,<,-12,170,134,>,36
15,17,0.0,0.0,=,0.0,0,0,=,0,0,0,=,0,41.333333333333336,41.333333333333336,=,0.0,30,31,<,-1,59,47,>,12,134,170,<,-36
0,17,0.0,0.0,=,0.0,0,0,=,0,0,0,=,0,41.333333333333336,31.666666666666668,>,9.666666666666668,31,31,=,0,47,33,>,14,170,270,<,-100
93,17,0.0,0.0,=,0.0,0,0,=,0,0,0,=,0,31.666666666666668,41.333333333333336,<,-9.666666666666668,31,31,=,0,33,47,<,-14,270,170,>,100
0,17,0.0,0.0,=,0.0,0,0,=,0,0,0,=,0,41.333333333333336,54.666666666666664,<,-13.333333333333329,31,51,<,-20,47,58,<,-11,170,176,<,-6
14,17,0.0,0.0,=,0.0,0,0,=,0,0,0,=,0,54.666666666666664,41.333333333333336,>,13.333333333333329,51,31,>,20,58,47,>,11,176,170,>,6
0,17,0.0,0.0,=,0.0,0,0,=,0,0,0,=,0,41.333333333333336,48.0,<,-6.666666666666664,31,41,<,-10,47,60,<,-13,170,175,<,-5
60,17,0.0,0.0,=,0.0,0,0,=,0,0,0,=,0,48.0,41.333333333333336,>,6.666666666666664,41,31,>,10,60,47,>,13,175,170,>,5
0,17,0.0,0.0,=,0.0,0,0,=,0,0,0,=,0,41.333333333333336,36.666666666666664,>,4.666666666666671,31,30,>,1,47,42,>,5,170,236,<,-66
27,17,0.0,0.0,=,0.0,0,0,=,0,0,0,=,0,36.666666666666664,41.333333333333336,<,-4.666666666666671,30,31,<,-1,42,47,<,-5,236,170,>,66
0,17,0.0,0.0,=,0.0,0,0,=,0,0,0,=,0,41.333333333333336,47.666666666666664,<,-6.333333333333329,31,37,<,-6,47,58,<,-11,170,210,<,-40
42,17,0.0,0.0,=,0.0,0,0,=,0,0,0,=,0,47.666666666666664,41.333333333333336,>,6.333333333333329,37,31,>,6,58,47,>,11,210,170,>,40
0,17,0.0,0.0,=,0.0,0,0,=,0,0,0,=,0,41.333333333333336,42.666666666666664,<,-1.3333333333333286,31,32,<,-1,47,60,<,-13,170,241,<,-71
67,17,0.0,0.0,=,0.0,0,0,=,0,0,0,=,0,42.666666666666664,41.333333333333336,>,1.3333333333333286,32,31,>,1,60,47,>,13,241,170,>,71
0,17,0.0,0.0,=,0.0,0,0,=,0,0,0,=,0,41.333333333333336,41.333333333333336,=,0.0,31,39,<,-8,47,45,>,2,170,186,<,-16
71,17,0.0,0.0,=,0.0,0,0,=,0,0,0,=,0,41.333333333333336,41.333333333333336,=,0.0,39,31,>,8,45,47,<,-2,186,170,>,16
0,17,0.0,0.0,=,0.0,0,0,=,0,0,0,=,0,41.333333333333336,40.666666666666664,>,0.6666666666666714,31,35,<,-4,47,47,=,0,170,206,<,-36
65,17,0.0,0.0,=,0.0,0,0,=,0,0,0,=,0,40.666666666666664,41.333333333333336,<,-0.6666666666666714,35,31,>,4,47,47,=,0,206,170,>,36
0,17,0.0,0.0,=,0.0,0,0,=,0,0,0,=,0,41.333333333333336,47.333333333333336,<,-6.0,31,41,<,-10,47,53,<,-6,170,256,<,-86
94,17,0.0,0.0,=,0.0,0,0,=,0,0,0,=,0,47.333333333333336,41.333333333333336,>,6.0,41,31,>,10,53,47,>,6,256,170,>,86
0,17,0.0,0.0,=,0.0,0,0,=,0,0,0,=,0,41.333333333333336,44.333333333333336,<,-3.0,31,35,<,-4,47,59,<,-12,170,214,<,-44
134,17,0.0,0.0,=,0.0,0,0,=,0,0,0,=,0,44.333333333333336,41.333333333333336,>,3.0,35,31,>,4,59,47,>,12,214,170,>,44
0,17,0.0,0.0,=,0.0,0,0,=,0,0,0,=,0,41.333333333333336,49.0,<,-7.666666666666664,31,38,<,-7,47,56,<,-9,170,183,<,-13
15,17,0.0,0.0,=,0.0,0,0,=,0,0,0,=,0,49.0,41.333333333333336,>,7.666666666666664,38,31,>,7,56,47,>,9,183,170,>,13
0,17,0.0,0.0,=,0.0,0,0,=,0,0,0,=,0,41.333333333333336,54.666666666666664,<,-13.333333333333329,31,53,<,-22,47,56,<,-9,170,132,>,38
0,17,0.0,0.0,=,0.0,0,0,=,0,0,0,=,0,54.666666666666664,41.333333333333336,>,13.333333333333329,53,31,>,22,56,47,>,9,132,170,<,-38
0,17,0.0,0.0,=,0.0,0,0,=,0,0,0,=,0,41.333333333333336,42.0,<,-0.6666666666666643,31,32,<,-1,47,52,<,-5,170,129,>,41
43,17,0.0,0.0,=,0.0,0,0,=,0,0,0,=,0,42.0,41.333333333333336,>,0.6666666666666643,32,31,>,1,52,47,>,5,129,170,<,-41
0,17,0.0,0.0,=,0.0,0,0,=,0,0,0,=,0,41.333333333333336,46.0,<,-4.666666666666664,31,32,<,-1,47,57,<,-10,170,94,>,76
0,17,0.0,0.0,=,0.0,0,0,=,0,0,0,=,0,46.0,41.333333333333336,>,4.666666666666664,32,31,>,1,57,47,>,10,94,170,<,-76
0,17,0.0,0.0,=,0.0,0,0,=,0,0,0,=,0,41.333333333333336,47.0,<,-5.666666666666664,31,35,<,-4,47,58,<,-11,170,122,>,48
42,17,0.0,0.0,=,0.0,0,0,=,0,0,0,=,0,47.0,41.333333333333336,>,5.666666666666664,35,31,>,4,58,47,>,11,122,170,<,-48
0,16,24.333333333333332,24.333333333333332,=,0.0,0,0,=,0,73,73,=,0,54.666666666666664,46.0,>,8.666666666666664,53,32,>,21,56,57,<,-1,132,94,>,38
0,16,24.333333333333332,24.333333333333332,=,0.0,0,0,=,0,73,73,=,0,46.0,54.666666666666664,<,-8.666666666666664,32,53,<,-21,57,56,>,1,94,132,<,-38
0,16,24.333333333333332,29.666666666666668,<,-5.333333333333336,0,0,=,0,73,89,<,-16,54.666666666666664,54.666666666666664,=,0.0,53,51,>,2,56,58,<,-2,132,176,<,-44
94,16,29.666666666666668,24.333333333333332,>,5.333333333333336,0,0,=,0,89,73,>,16,54.666666666666664,54.666666666666664,=,0.0,51,53,<,-2,58,56,>,2,176,132,>,44
0,16,24.333333333333332,13.666666666666666,>,10.666666666666666,0,0,=,0,73,41,>,32,54.666666666666664,41.333333333333336,>,13.333333333333329,53,30,>,23,56,59,<,-3,132,134,<,-2
38,16,13.666666666666666,24.333333333333332,<,-10.666666666666666,0,0,=,0,41,73,<,-32,41.333333333333336,54.666666666666664,<,-13.333333333333329,30,53,<,-23,59,56,>,3,134,132,>,2
0,16,24.333333333333332,23.0,>,1.3333333333333321,0,0,=,0,73,69,>,4,54.666666666666664,49.0,>,5.666666666666664,53,38,>,15,56,56,=,0,132,183,<,-51
15,16,23.0,24.333333333333332,<,-1.3333333333333321,0,0,=,0,69,73,<,-4,49.0,54.666666666666664,<,-5.666666666666664,38,53,<,-15,56,56,=,0,183,132,>,51
0,16,24.333333333333332,21.333333333333332,>,3.0,0,0,=,0,73,64,>,9,54.666666666666664,36.666666666666664,>,18.0,53,30,>,23,56,42,>,14,132,236,<,-104
135,16,21.333333333333332,24.333333333333332,<,-3.0,0,0,=,0,64,73,<,-9,36.666666666666664,54.666666666666664,<,-18.0,30,53,<,-23,42,56,<,-14,236,132,>,104
0,16,24.333333333333332,29.333333333333332,<,-5.0,0,0,=,0,73,88,<,-15,54.666666666666664,47.666666666666664,>,7.0,53,37,>,16,56,58,<,-2,132,210,<,-78
177,16,29.333333333333332,24.333333333333332,>,5.0,0,0,=,0,88,73,>,15,47.666666666666664,54.666666666666664,<,-7.0,37,53,<,-16,58,56,>,2,210,132,>,78
0,16,24.333333333333332,4.333333333333333,>,20.0,0,0,=,0,73,13,>,60,54.666666666666664,47.0,>,7.666666666666664,53,35,>,18,56,58,<,-2,132,122,>,10
0,16,4.333333333333333,24.333333333333332,<,-20.0,0,0,=,0,13,73,<,-60,47.0,54.666666666666664,<,-7.666666666666664,35,53,<,-18,58,56,>,2,122,132,<,-10
0,16,24.333333333333332,5.0,>,19.333333333333332,0,0,=,0,73,15,>,58,54.666666666666664,42.0,>,12.666666666666664,53,32,>,21,56,52,>,4,132,129,>,3
58,16,5.0,24.333333333333332,<,-19.333333333333332,0,0,=,0,15,73,<,-58,42.0,54.666666666666664,<,-12.666666666666664,32,53,<,-21,52,56,<,-4,129,132,<,-3
0,16,24.333333333333332,16.666666666666668,>,7.666666666666664,0,0,=,0,73,50,>,23,54.666666666666664,48.0,>,6.666666666666664,53,41,>,12,56,60,<,-4,132,175,<,-43
56,16,16.666666666666668,24.333333333333332,<,-7.666666666666664,0,0,=,0,50,73,<,-23,48.0,54.666666666666664,<,-6.666666666666664,41,53,<,-12,60,56,>,4,175,132,>,43
0,16,24.333333333333332,7.333333333333333,>,17.0,0,0,=,0,73,22,>,51,54.666666666666664,40.666666666666664,>,14.0,53,35,>,18,56,47,>,9,132,206,<,-74
86,16,7.333333333333333,24.333333333333332,<,-17.0,0,0,=,0,22,73,<,-51,40.666666666666664,54.666666666666664,<,-14.0,35,53,<,-18,47,56,<,-9,206,132,>,74
0,16,24.333333333333332,22.333333333333332,>,2.0,0,0,=,0,73,67,>,6,54.666666666666664,42.666666666666664,>,12.0,53,32,>,21,56,60,<,-4,132,241,<,-109
118,16,22.333333333333332,24.333333333333332,<,-2.0,0,0,=,0,67,73,<,-6,42.666666666666664,54.666666666666664,<,-12.0,32,53,<,-21,60,56,>,4,241,132,>,109
0,16,24.333333333333332,12.333333333333334,>,11.999999999999998,0,0,=,0,73,37,>,36,54.666666666666664,41.333333333333336,>,13.333333333333329,53,39,>,14,56,45,>,11,132,186,<,-54
103,16,12.333333333333334,24.333333333333332,<,-11.999999999999998,0,0,=,0,37,73,<,-36,41.333333333333336,54.666666666666664,<,-13.333333333333329,39,53,<,-14,45,56,<,-11,186,132,>,54
0,16,24.333333333333332,21.666666666666668,>,2.6666666666666643,0,0,=,0,73,65,>,8,54.666666666666664,31.666666666666668,>,22.999999999999996,53,31,>,22,56,33,>,23,132,270,<,-138
77,16,21.666666666666668,24.333333333333332,<,-2.6666666666666643,0,0,=,0,65,73,<,-8,31.666666666666668,54.666666666666664,<,-22.999999999999996,31,53,<,-22,33,56,<,-23,270,132,>,138
0,16,24.333333333333332,13.333333333333334,>,10.999999999999998,0,0,=,0,73,40,>,33,54.666666666666664,47.333333333333336,>,7.333333333333329,53,41,>,12,56,53,>,3,132,256,<,-124
114,16,13.333333333333334,24.333333333333332,<,-10.999999999999998,0,0,=,0,40,73,<,-33,47.333333333333336,54.666666666666664,<,-7.333333333333329,41,53,<,-12,53,56,<,-3,256,132,>,124
0,16,24.333333333333332,5.666666666666667,>,18.666666666666664,0,0,=,0,73,17,>,56,54.666666666666664,44.333333333333336,>,10.333333333333329,53,35,>,18,56,59,<,-3,132,214,<,-82
86,16,5.666666666666667,24.333333333333332,<,-18.666666666666664,0,0,=,0,17,73,<,-56,44.333333333333336,54.666666666666664,<,-10.333333333333329,35,53,<,-18,59,56,>,3,214,132,>,82
0,15,37.0,14.666666666666666,>,22.333333333333336,0,0,=,0,73,31,>,42,46.0,47.0,<,-1.0,32,35,<,-3,57,58,<,-1,94,122,<,-28
0,15,14.666666666666666,37.0,<,-22.333333333333336,0,0,=,0,31,73,<,-42,47.0,46.0,>,1.0,35,32,>,3,58,57,>,1,122,94,>,28
0,15,37.0,43.666666666666664,<,-6.666666666666664,0,0,=,0,73,69,>,4,46.0,49.0,<,-3.0,32,38,<,-6,57,56,>,1,94,183,<,-89
40,15,43.666666666666664,37.0,>,6.666666666666664,0,0,=,0,69,73,<,-4,49.0,46.0,>,3.0,38,32,>,6,56,57,<,-1,183,94,>,89
0,15,37.0,24.666666666666668,>,12.333333333333332,0,0,=,0,73,41,>,32,46.0,41.333333333333336,>,4.666666666666664,32,30,>,2,57,59,<,-2,94,134,<,-40
0,15,24.666666666666668,37.0,<,-12.333333333333332,0,0,=,0,41,73,<,-32,41.333333333333336,46.0,<,-4.666666666666664,30,32,<,-2,59,57,>,2,134,94,>,40
0,15,37.0,27.333333333333332,>,9.666666666666668,0,0,=,0,73,50,>,23,46.0,48.0,<,-2.0,32,41,<,-9,57,60,<,-3,94,175,<,-81
102,15,27.333333333333332,37.0,<,-9.666666666666668,0,0,=,0,50,73,<,-23,48.0,46.0,>,2.0,41,32,>,9,60,57,>,3,175,94,>,81
0,15,37.0,8.333333333333334,>,28.666666666666664,0,0,=,0,73,15,>,58,46.0,42.0,>,4.0,32,32,=,0,57,52,>,5,94,129,<,-35
130,15,8.333333333333334,37.0,<,-28.666666666666664,0,0,=,0,15,73,<,-58,42.0,46.0,<,-4.0,32,32,=,0,52,57,<,-5,129,94,>,35
0,15,37.0,43.333333333333336,<,-6.333333333333336,0,0,=,0,73,65,>,8,46.0,31.666666666666668,>,14.333333333333332,32,31,>,1,57,33,>,24,94,270,<,-176
77,15,43.333333333333336,37.0,>,6.333333333333336,0,0,=,0,65,73,<,-8,31.666666666666668,46.0,<,-14.333333333333332,31,32,<,-1,33,57,<,-24,270,94,>,176
0,15,37.0,14.666666666666666,>,22.333333333333336,0,0,=,0,73,22,>,51,46.0,40.666666666666664,>,5.333333333333336,32,35,<,-3,57,47,>,10,94,206,<,-112
128,15,14.666666666666666,37.0,<,-22.333333333333336,0,0,=,0,22,73,<,-51,40.666666666666664,46.0,<,-5.333333333333336,35,32,>,3,47,57,<,-10,206,94,>,112
0,15,37.0,31.333333333333332,>,5.666666666666668,0,0,=,0,73,77,<,-4,46.0,44.333333333333336,>,1.6666666666666643,32,35,<,-3,57,59,<,-2,94,214,<,-120
117,15,31.333333333333332,37.0,<,-5.666666666666668,0,0,=,0,77,73,>,4,44.333333333333336,46.0,<,-1.6666666666666643,35,32,>,3,59,57,>,2,214,94,>,120
0,15,37.0,50.666666666666664,<,-13.666666666666664,0,0,=,0,73,89,<,-16,46.0,54.666666666666664,<,-8.666666666666664,32,51,<,-19,57,58,<,-1,94,176,<,-82
169,15,50.666666666666664,37.0,>,13.666666666666664,0,0,=,0,89,73,>,16,54.666666666666664,46.0,>,8.666666666666664,51,32,>,19,58,57,>,1,176,94,>,82
0,15,37.0,27.666666666666668,>,9.333333333333332,0,0,=,0,73,46,>,27,46.0,41.333333333333336,>,4.666666666666664,32,39,<,-7,57,45,>,12,94,186,<,-92
103,15,27.666666666666668,37.0,<,-9.333333333333332,0,0,=,0,46,73,<,-27,41.333333333333336,46.0,<,-4.666666666666664,39,32,>,7,45,57,<,-12,186,94,>,92
0,15,37.0,35.666666666666664,>,1.3333333333333357,0,0,=,0,73,67,>,6,46.0,47.333333333333336,<,-1.3333333333333357,32,41,<,-9,57,53,>,4,94,256,<,-162
202,15,35.666666666666664,37.0,<,-1.3333333333333357,0,0,=,0,67,73,<,-6,47.333333333333336,46.0,>,1.3333333333333357,41,32,>,9,53,57,<,-4,256,94,>,162
0,15,37.0,52.0,<,-15.0,0,0,=,0,73,89,<,-16,46.0,42.666666666666664,>,3.3333333333333357,32,32,=,0,57,60,<,-3,94,241,<,-147
212,15,52.0,37.0,>,15.0,0,0,=,0,89,73,>,16,42.666666666666664,46.0,<,-3.3333333333333357,32,32,=,0,60,57,>,3,241,94,>,147
0,15,37.0,48.666666666666664,<,-11.666666666666664,0,0,=,0,73,82,<,-9,46.0,36.666666666666664,>,9.333333333333336,32,30,>,2,57,42,>,15,94,236,<,-142
153,15,48.666666666666664,37.0,>,11.666666666666664,0,0,=,0,82,73,>,9,36.666666666666664,46.0,<,-9.333333333333336,30,32,<,-2,42,57,<,-15,236,94,>,142
0,15,37.0,41.0,<,-4.0,0,0,=,0,73,88,<,-15,46.0,47.666666666666664,<,-1.6666666666666643,32,37,<,-5,57,58,<,-1,94,210,<,-116
262,15,41.0,37.0,>,4.0,0,0,=,0,88,73,>,15,47.666666666666664,46.0,>,1.6666666666666643,37,32,>,5,58,57,>,1,210,94,>,116
0,14,54.0,19.333333333333332,>,34.66666666666667,33,13,>,20,88,31,>,57,41.333333333333336,47.0,<,-5.666666666666664,30,35,<,-5,59,58,>,1,134,122,>,12
0,14,19.333333333333332,54.0,<,-34.66666666666667,13,33,<,-20,31,88,<,-57,47.0,41.333333333333336,>,5.666666666666664,35,30,>,5,58,59,<,-1,122,134,<,-12
0,14,54.0,63.0,<,-9.0,33,58,<,-25,88,69,>,19,41.333333333333336,49.0,<,-7.666666666666664,30,38,<,-8,59,56,>,3,134,183,<,-49
135,14,63.0,54.0,>,9.0,58,33,>,25,69,88,<,-19,49.0,41.333333333333336,>,7.666666666666664,38,30,>,8,56,59,<,-3,183,134,>,49
0,14,54.0,65.66666666666667,<,-11.666666666666671,33,65,<,-32,88,67,>,21,41.333333333333336,31.666666666666668,>,9.666666666666668,30,31,<,-1,59,33,>,26,134,270,<,-136
256,14,65.66666666666667,54.0,>,11.666666666666671,65,33,>,32,67,88,<,-21,31.666666666666668,41.333333333333336,<,-9.666666666666668,31,30,>,1,33,59,<,-26,270,134,>,136
0,14,54.0,46.0,>,8.0,33,32,>,1,88,56,>,32,41.333333333333336,48.0,<,-6.666666666666664,30,41,<,-11,59,60,<,-1,134,175,<,-41
129,14,46.0,54.0,<,-8.0,32,33,<,-1,56,88,<,-32,48.0,41.333333333333336,>,6.666666666666664,41,30,>,11,60,59,>,1,175,134,>,41
0,14,54.0,49.333333333333336,>,4.666666666666664,33,37,<,-4,88,65,>,23,41.333333333333336,41.333333333333336,=,0.0,30,39,<,-9,59,45,>,14,134,186,<,-52
169,14,49.333333333333336,54.0,<,-4.666666666666664,37,33,>,4,65,88,<,-23,41.333333333333336,41.333333333333336,=,0.0,39,30,>,9,45,59,<,-14,186,134,>,52
0,14,54.0,50.333333333333336,>,3.6666666666666643,33,17,>,16,88,77,>,11,41.333333333333336,44.333333333333336,<,-3.0,30,35,<,-5,59,59,=,0,134,214,<,-80
141,14,50.333333333333336,54.0,<,-3.6666666666666643,17,33,<,-16,77,88,<,-11,44.333333333333336,41.333333333333336,>,3.0,35,30,>,5,59,59,=,0,214,134,>,80
0,14,54.0,25.333333333333332,>,28.666666666666668,33,22,>,11,88,32,>,56,41.333333333333336,40.666666666666664,>,0.6666666666666714,30,35,<,-5,59,47,>,12,134,206,<,-72
128,14,25.333333333333332,54.0,<,-28.666666666666668,22,33,<,-11,32,88,<,-56,40.666666666666664,41.333333333333336,<,-0.6666666666666714,35,30,>,5,47,59,<,-12,206,134,>,72
0,14,54.0,12.0,>,42.0,33,10,>,23,88,15,>,73,41.333333333333336,42.0,<,-0.6666666666666643,30,32,<,-2,59,52,>,7,134,129,>,5
0,14,12.0,54.0,<,-42.0,10,33,<,-23,15,88,<,-73,42.0,41.333333333333336,>,0.6666666666666643,32,30,>,2,52,59,<,-7,129,134,<,-5
0,14,54.0,72.0,<,-18.0,33,64,<,-31,88,82,>,6,41.333333333333336,36.666666666666664,>,4.666666666666671,30,30,=,0,59,42,>,17,134,236,<,-102
244,14,72.0,54.0,>,18.0,64,33,>,31,82,88,<,-6,36.666666666666664,41.333333333333336,<,-4.666666666666671,30,30,=,0,42,59,<,-17,236,134,>,102
0,14,54.0,63.333333333333336,<,-9.333333333333336,33,38,<,-5,88,89,<,-1,41.333333333333336,54.666666666666664,<,-13.333333333333329,30,51,<,-21,59,58,>,1,134,176,<,-42
169,14,63.333333333333336,54.0,>,9.333333333333336,38,33,>,5,89,88,>,1,54.666666666666664,41.333333333333336,>,13.333333333333329,51,30,>,21,58,59,<,-1,176,134,>,42
0,14,54.0,46.0,>,8.0,33,31,>,2,88,67,>,21,41.333333333333336,47.333333333333336,<,-6.0,30,41,<,-11,59,53,>,6,134,256,<,-122
197,14,46.0,54.0,<,-8.0,31,33,<,-2,67,88,<,-21,47.333333333333336,41.333333333333336,>,6.0,41,30,>,11,53,59,<,-6,256,134,>,122
0,14,54.0,71.33333333333333,<,-17.33333333333333,33,58,<,-25,88,89,<,-1,41.333333333333336,42.666666666666664,<,-1.3333333333333286,30,32,<,-2,59,60,<,-1,134,241,<,-107
267,14,71.33333333333333,54.0,>,17.33333333333333,58,33,>,25,89,88,>,1,42.666666666666664,41.333333333333336,>,1.3333333333333286,32,30,>,2,60,59,>,1,241,134,>,107
0,14,54.0,51.333333333333336,>,2.6666666666666643,33,31,>,2,88,88,=,0,41.333333333333336,47.666666666666664,<,-6.333333333333329,30,37,<,-7,59,58,>,1,134,210,<,-76
207,14,51.333333333333336,54.0,<,-2.6666666666666643,31,33,<,-2,88,88,=,0,47.666666666666664,41.333333333333336,>,6.333333333333329,37,30,>,7,58,59,<,-1,210,134,>,76
0,13,23.666666666666668,15.666666666666666,>,8.000000000000002,11,13,<,-2,45,20,>,25,42.0,47.0,<,-5.0,32,35,<,-3,52,58,<,-6,129,122,>,7
0,13,15.666666666666666,23.666666666666668,<,-8.000000000000002,13,11,>,2,20,45,<,-25,47.0,42.0,>,5.0,35,32,>,3,58,52,>,6,122,129,<,-7
0,13,23.666666666666668,44.0,<,-20.333333333333332,11,22,<,-11,45,78,<,-33,42.0,40.666666666666664,>,1.3333333333333357,32,35,<,-3,52,47,>,5,129,206,<,-77
128,13,44.0,23.666666666666668,>,20.333333333333332,22,11,>,11,78,45,>,33,40.666666666666664,42.0,<,-1.3333333333333357,35,32,>,3,47,52,<,-5,206,129,>,77
0,13,23.666666666666668,57.666666666666664,<,-34.0,11,50,<,-39,45,67,<,-22,42.0,48.0,<,-6.0,32,41,<,-9,52,60,<,-8,129,175,<,-46
167,13,57.666666666666664,23.666666666666668,>,34.0,50,11,>,39,67,45,>,22,48.0,42.0,>,6.0,41,32,>,9,60,52,>,8,175,129,>,46
0,13,23.666666666666668,53.666666666666664,<,-29.999999999999996,11,34,<,-23,45,69,<,-24,42.0,49.0,<,-7.0,32,38,<,-6,52,56,<,-4,129,183,<,-54
102,13,53.666666666666664,23.666666666666668,>,29.999999999999996,34,11,>,23,69,45,>,24,49.0,42.0,>,7.0,38,32,>,6,56,52,>,4,183,129,>,54
0,13,23.666666666666668,36.0,<,-12.333333333333332,11,17,<,-6,45,57,<,-12,42.0,44.333333333333336,<,-2.3333333333333357,32,35,<,-3,52,59,<,-7,129,214,<,-85
141,13,36.0,23.666666666666668,>,12.333333333333332,17,11,>,6,57,45,>,12,44.333333333333336,42.0,>,2.3333333333333357,35,32,>,3,59,52,>,7,214,129,>,85
0,13,23.666666666666668,49.333333333333336,<,-25.666666666666668,11,21,<,-10,45,89,<,-44,42.0,54.666666666666664,<,-12.666666666666664,32,51,<,-19,52,58,<,-6,129,176,<,-47
0,13,49.333333333333336,23.666666666666668,>,25.666666666666668,21,11,>,10,89,45,>,44,54.666666666666664,42.0,>,12.666666666666664,51,32,>,19,58,52,>,6,176,129,>,47
0,13,23.666666666666668,62.666666666666664,<,-39.0,11,37,<,-26,45,86,<,-41,42.0,41.333333333333336,>,0.6666666666666643,32,39,<,-7,52,45,>,7,129,186,<,-57
216,13,62.666666666666664,23.666666666666668,>,39.0,37,11,>,26,86,45,>,41,41.333333333333336,42.0,<,-0.6666666666666643,39,32,>,7,45,52,<,-7,186,129,>,57
0,13,23.666666666666668,37.333333333333336,<,-13.666666666666668,11,31,<,-20,45,41,>,4,42.0,47.333333333333336,<,-5.333333333333336,32,41,<,-9,52,53,<,-1,129,256,<,-127
161,13,37.333333333333336,23.666666666666668,>,13.666666666666668,31,11,>,20,41,45,<,-4,47.333333333333336,42.0,>,5.333333333333336,41,32,>,9,53,52,>,1,256,129,>,127
0,13,23.666666666666668,68.0,<,-44.33333333333333,11,31,<,-20,45,88,<,-43,42.0,47.666666666666664,<,-5.666666666666664,32,37,<,-5,52,58,<,-6,129,210,<,-81
250,13,68.0,23.666666666666668,>,44.33333333333333,31,11,>,20,88,45,>,43,47.666666666666664,42.0,>,5.666666666666664,37,32,>,5,58,52,>,6,210,129,>,81
0,13,23.666666666666668,57.0,<,-33.33333333333333,11,37,<,-26,45,70,<,-25,42.0,36.666666666666664,>,5.333333333333336,32,30,>,2,52,42,>,10,129,236,<,-107
206,13,57.0,23.666666666666668,>,33.33333333333333,37,11,>,26,70,45,>,25,36.666666666666664,42.0,<,-5.333333333333336,30,32,<,-2,42,52,<,-10,236,129,>,107
0,13,23.666666666666668,62.0,<,-38.33333333333333,11,54,<,-43,45,67,<,-22,42.0,31.666666666666668,>,10.333333333333332,32,31,>,1,52,33,>,19,129,270,<,-141
164,13,62.0,23.666666666666668,>,38.33333333333333,54,11,>,43,67,45,>,22,31.666666666666668,42.0,<,-10.333333333333332,31,32,<,-1,33,52,<,-19,270,129,>,141
0,13,23.666666666666668,65.66666666666667,<,-42.0,11,58,<,-47,45,72,<,-27,42.0,42.666666666666664,<,-0.6666666666666643,32,32,=,0,52,60,<,-8,129,241,<,-112
248,13,65.66666666666667,23.666666666666668,>,42.0,58,11,>,47,72,45,>,27,42.666666666666664,42.0,>,0.6666666666666643,32,32,=,0,60,52,>,8,241,129,>,112
0,12,55.0,16.666666666666668,>,38.33333333333333,21,13,>,8,89,20,>,69,54.666666666666664,47.0,>,7.666666666666664,51,35,>,16,58,58,=,0,176,122,>,54
0,12,16.666666666666668,55.0,<,-38.33333333333333,13,21,<,-8,20,89,<,-69,47.0,54.666666666666664,<,-7.666666666666664,35,51,<,-16,58,58,=,0,122,176,<,-54
0,12,55.0,46.0,>,9.0,21,34,<,-13,89,69,>,20,54.666666666666664,49.0,>,5.666666666666664,51,38,>,13,58,56,>,2,176,183,<,-7
78,12,46.0,55.0,<,-9.0,34,21,>,13,69,89,<,-20,49.0,54.666666666666664,<,-5.666666666666664,38,51,<,-13,56,58,<,-2,183,176,>,7
0,12,55.0,39.666666666666664,>,15.333333333333336,21,19,>,2,89,78,>,11,54.666666666666664,40.666666666666664,>,14.0,51,35,>,16,58,47,>,11,176,206,<,-30
0,12,39.666666666666664,55.0,<,-15.333333333333336,19,21,<,-2,78,89,<,-11,40.666666666666664,54.666666666666664,<,-14.0,35,51,<,-16,47,58,<,-11,206,176,>,30
0,12,55.0,45.0,>,10.0,21,17,>,4,89,84,>,5,54.666666666666664,44.333333333333336,>,10.333333333333329,51,35,>,16,58,59,<,-1,176,214,<,-38
141,12,45.0,55.0,<,-10.0,17,21,<,-4,84,89,<,-5,44.333333333333336,54.666666666666664,<,-10.333333333333329,35,51,<,-16,59,58,>,1,214,176,>,38
0,12,55.0,54.666666666666664,>,0.3333333333333357,21,40,<,-19,89,83,>,6,54.666666666666664,47.333333333333336,>,7.333333333333329,51,41,>,10,58,53,>,5,176,256,<,-80
161,12,54.666666666666664,55.0,<,-0.3333333333333357,40,21,>,19,83,89,<,-6,47.333333333333336,54.666666666666664,<,-7.333333333333329,41,51,<,-10,53,58,<,-5,256,176,>,80
0,12,55.0,60.666666666666664,<,-5.666666666666664,21,54,<,-33,89,65,>,24,54.666666666666664,31.666666666666668,>,22.999999999999996,51,31,>,20,58,33,>,25,176,270,<,-94
164,12,60.666666666666664,55.0,>,5.666666666666664,54,21,>,33,65,89,<,-24,31.666666666666668,54.666666666666664,<,-22.999999999999996,31,51,<,-20,33,58,<,-25,270,176,>,94
0,12,55.0,45.0,>,10.0,21,18,>,3,89,67,>,22,54.666666666666664,48.0,>,6.666666666666664,51,41,>,10,58,60,<,-2,176,175,>,1
38,12,45.0,55.0,<,-10.0,18,21,<,-3,67,89,<,-22,48.0,54.666666666666664,<,-6.666666666666664,41,51,<,-10,60,58,>,2,175,176,<,-1
0,12,55.0,48.333333333333336,>,6.666666666666664,21,37,<,-16,89,64,>,25,54.666666666666664,36.666666666666664,>,18.0,51,30,>,21,58,42,>,16,176,236,<,-60
206,12,48.333333333333336,55.0,<,-6.666666666666664,37,21,>,16,64,89,<,-25,36.666666666666664,54.666666666666664,<,-18.0,30,51,<,-21,42,58,<,-16,236,176,>,60
0,12,55.0,51.0,>,4.0,21,30,<,-9,89,86,>,3,54.666666666666664,41.333333333333336,>,13.333333333333329,51,39,>,12,58,45,>,13,176,186,<,-10
52,12,51.0,55.0,<,-4.0,30,21,>,9,86,89,<,-3,41.333333333333336,54.666666666666664,<,-13.333333333333329,39,51,<,-12,45,58,<,-13,186,176,>,10
0,12,55.0,68.0,<,-13.0,21,65,<,-44,89,72,>,17,54.666666666666664,42.666666666666664,>,12.0,51,32,>,19,58,60,<,-2,176,241,<,-65
195,12,68.0,55.0,>,13.0,65,21,>,44,72,89,<,-17,42.666666666666664,54.666666666666664,<,-12.0,32,51,<,-19,60,58,>,2,241,176,>,65
0,12,55.0,64.66666666666667,<,-9.666666666666671,21,21,=,0,89,88,>,1,54.666666666666664,47.666666666666664,>,7.0,51,37,>,14,58,58,=,0,176,210,<,-34
157,12,64.66666666666667,55.0,>,9.666666666666671,21,21,=,0,88,89,<,-1,47.666666666666664,54.666666666666664,<,-7.0,37,51,<,-14,58,58,=,0,210,176,>,34
0,11,25.0,29.666666666666668,<,-4.666666666666668,19,13,>,6,34,59,<,-25,40.666666666666664,47.0,<,-6.333333333333336,35,35,=,0,47,58,<,-11,206,122,>,84
0,11,29.666666666666668,25.0,>,4.666666666666668,13,19,<,-6,59,34,>,25,47.0,40.666666666666664,>,6.333333333333336,35,35,=,0,58,47,>,11,122,206,<,-84
0,11,25.0,26.666666666666668,<,-1.6666666666666679,19,12,>,7,34,50,<,-16,40.666666666666664,48.0,<,-7.333333333333336,35,41,<,-6,47,60,<,-13,206,175,>,31
0,11,26.666666666666668,25.0,>,1.6666666666666679,12,19,<,-7,50,34,>,16,48.0,40.666666666666664,>,7.333333333333336,41,35,>,6,60,47,>,13,175,206,<,-31
0,11,25.0,49.666666666666664,<,-24.666666666666664,19,30,<,-11,34,82,<,-48,40.666666666666664,41.333333333333336,<,-0.6666666666666714,35,39,<,-4,47,45,>,2,206,186,>,20
52,11,49.666666666666664,25.0,>,24.666666666666664,30,19,>,11,82,34,>,48,41.333333333333336,40.666666666666664,>,0.6666666666666714,39,35,>,4,45,47,<,-2,186,206,<,-20
0,11,25.0,57.0,<,-32.0,19,35,<,-16,34,69,<,-35,40.666666666666664,49.0,<,-8.333333333333336,35,38,<,-3,47,56,<,-9,206,183,>,23
78,11,57.0,25.0,>,32.0,35,19,>,16,69,34,>,35,49.0,40.666666666666664,>,8.333333333333336,38,35,>,3,56,47,>,9,183,206,<,-23
0,11,25.0,42.666666666666664,<,-17.666666666666664,19,17,>,2,34,84,<,-50,40.666666666666664,44.333333333333336,<,-3.6666666666666714,35,35,=,0,47,59,<,-12,206,214,<,-8
121,11,42.666666666666664,25.0,>,17.666666666666664,17,19,<,-2,84,34,>,50,44.333333333333336,40.666666666666664,>,3.6666666666666714,35,35,=,0,59,47,>,12,214,206,>,8
0,11,25.0,50.0,<,-25.0,19,21,<,-2,34,88,<,-54,40.666666666666664,47.666666666666664,<,-7.0,35,37,<,-2,47,58,<,-11,206,210,<,-4
157,11,50.0,25.0,>,25.0,21,19,>,2,88,34,>,54,47.666666666666664,40.666666666666664,>,7.0,37,35,>,2,58,47,>,11,210,206,>,4
0,11,25.0,70.0,<,-45.0,19,40,<,-21,34,87,<,-53,40.666666666666664,47.333333333333336,<,-6.666666666666671,35,41,<,-6,47,53,<,-6,206,256,<,-50
159,11,70.0,25.0,>,45.0,40,19,>,21,87,34,>,53,47.333333333333336,40.666666666666664,>,6.666666666666671,41,35,>,6,53,47,>,6,256,206,>,50
0,11,25.0,49.666666666666664,<,-24.666666666666664,19,21,<,-2,34,65,<,-31,40.666666666666664,31.666666666666668,>,8.999999999999996,35,31,>,4,47,33,>,14,206,270,<,-64
38,11,49.666666666666664,25.0,>,24.666666666666664,21,19,>,2,65,34,>,31,31.666666666666668,40.666666666666664,<,-8.999999999999996,31,35,<,-4,33,47,<,-14,270,206,>,64
0,11,25.0,48.0,<,-23.0,19,12,>,7,34,67,<,-33,40.666666666666664,42.666666666666664,<,-2.0,35,32,>,3,47,60,<,-13,206,241,<,-35
70,11,48.0,25.0,>,23.0,12,19,<,-7,67,34,>,33,42.666666666666664,40.666666666666664,>,2.0,32,35,<,-3,60,47,>,13,241,206,>,35
0,11,25.0,53.333333333333336,<,-28.333333333333336,19,44,<,-25,34,64,<,-30,40.666666666666664,36.666666666666664,>,4.0,35,30,>,5,47,42,>,5,206,236,<,-30
174,11,53.333333333333336,25.0,>,28.333333333333336,44,19,>,25,64,34,>,30,36.666666666666664,40.666666666666664,<,-4.0,30,35,<,-5,42,47,<,-5,236,206,>,30
0,10,30.666666666666668,38.333333333333336,<,-7.666666666666668,12,13,<,-1,50,59,<,-9,48.0,47.0,>,1.0,41,35,>,6,60,58,>,2,175,122,>,53
0,10,38.333333333333336,30.666666666666668,>,7.666666666666668,13,12,>,1,59,50,>,9,47.0,48.0,<,-1.0,35,41,<,-6,58,60,<,-2,122,175,<,-53
0,10,30.666666666666668,40.333333333333336,<,-9.666666666666668,12,21,<,-9,50,65,<,-15,48.0,31.666666666666668,>,16.333333333333332,41,31,>,10,60,33,>,27,175,270,<,-95
63,10,40.333333333333336,30.666666666666668,>,9.666666666666668,21,12,>,9,65,50,>,15,31.666666666666668,48.0,<,-16.333333333333332,31,41,<,-10,33,60,<,-27,270,175,>,95
0,10,30.666666666666668,44.666666666666664,<,-13.999999999999996,12,15,<,-3,50,82,<,-32,48.0,41.333333333333336,>,6.666666666666664,41,39,>,2,60,45,>,15,175,186,<,-11
0,10,44.666666666666664,30.666666666666668,>,13.999999999999996,15,12,>,3,82,50,>,32,41.333333333333336,48.0,<,-6.666666666666664,39,41,<,-2,45,60,<,-15,186,175,>,11
0,10,30.666666666666668,30.333333333333332,>,0.3333333333333357,12,12,=,0,50,67,<,-17,48.0,42.666666666666664,>,5.333333333333336,41,32,>,9,60,60,=,0,175,241,<,-66
44,10,30.333333333333332,30.666666666666668,<,-0.3333333333333357,12,12,=,0,67,50,>,17,42.666666666666664,48.0,<,-5.333333333333336,32,41,<,-9,60,60,=,0,241,175,>,66
0,10,30.666666666666668,66.66666666666667,<,-36.0,12,64,<,-52,50,69,<,-19,48.0,49.0,<,-1.0,41,38,>,3,60,56,>,4,175,183,<,-8
117,10,66.66666666666667,30.666666666666668,>,36.0,64,12,>,52,69,50,>,19,49.0,48.0,>,1.0,38,41,<,-3,56,60,<,-4,183,175,>,8
0,10,30.666666666666668,22.0,>,8.666666666666668,12,17,<,-5,50,27,>,23,48.0,44.333333333333336,>,3.6666666666666643,41,35,>,6,60,59,>,1,175,214,<,-39
112,10,22.0,30.666666666666668,<,-8.666666666666668,17,12,>,5,27,50,<,-23,44.333333333333336,48.0,<,-3.6666666666666643,35,41,<,-6,59,60,<,-1,214,175,>,39
0,10,30.666666666666668,50.0,<,-19.333333333333332,12,21,<,-9,50,88,<,-38,48.0,47.666666666666664,>,0.3333333333333357,41,37,>,4,60,58,>,2,175,210,<,-35
176,10,50.0,30.666666666666668,>,19.333333333333332,21,12,>,9,88,50,>,38,47.666666666666664,48.0,<,-0.3333333333333357,37,41,<,-4,58,60,<,-2,210,175,>,35
0,10,30.666666666666668,48.666666666666664,<,-17.999999999999996,12,19,<,-7,50,87,<,-37,48.0,47.333333333333336,>,0.6666666666666643,41,41,=,0,60,53,>,7,175,256,<,-81
121,10,48.666666666666664,30.666666666666668,>,17.999999999999996,19,12,>,7,87,50,>,37,47.333333333333336,48.0,<,-0.6666666666666643,41,41,=,0,53,60,<,-7,256,175,>,81
0,10,30.666666666666668,61.333333333333336,<,-30.666666666666668,12,52,<,-40,50,68,<,-18,48.0,36.666666666666664,>,11.333333333333336,41,30,>,11,60,42,>,18,175,236,<,-61
174,10,61.333333333333336,30.666666666666668,>,30.666666666666668,52,12,>,40,68,50,>,18,36.666666666666664,48.0,<,-11.333333333333336,30,41,<,-11,42,60,<,-18,236,175,>,61
0,9,43.666666666666664,45.666666666666664,<,-2.0,15,13,>,2,79,81,<,-2,41.333333333333336,47.0,<,-5.666666666666664,39,35,>,4,45,58,<,-13,186,122,>,64
0,9,45.666666666666664,43.666666666666664,>,2.0,13,15,<,-2,81,79,>,2,47.0,41.333333333333336,>,5.666666666666664,35,39,<,-4,58,45,>,13,122,186,<,-64
0,9,43.666666666666664,53.333333333333336,<,-9.666666666666671,15,12,>,3,79,81,<,-2,41.333333333333336,42.666666666666664,<,-1.3333333333333286,39,32,>,7,45,60,<,-15,186,241,<,-55
44,9,53.333333333333336,43.666666666666664,>,9.666666666666671,12,15,<,-3,81,79,>,2,42.666666666666664,41.333333333333336,>,1.3333333333333286,32,39,<,-7,60,45,>,15,241,186,>,55
0,9,43.666666666666664,46.666666666666664,<,-3.0,15,35,<,-20,79,65,>,14,41.333333333333336,31.666666666666668,>,9.666666666666668,39,31,>,8,45,33,>,12,186,270,<,-84
49,9,46.666666666666664,43.666666666666664,>,3.0,35,15,>,20,65,79,<,-14,31.666666666666668,41.333333333333336,<,-9.666666666666668,31,39,<,-8,33,45,<,-12,270,186,>,84
0,9,43.666666666666664,19.0,>,24.666666666666664,15,17,<,-2,79,22,>,57,41.333333333333336,44.333333333333336,<,-3.0,39,35,>,4,45,59,<,-14,186,214,<,-28
98,9,19.0,43.666666666666664,<,-24.666666666666664,17,15,>,2,22,79,<,-57,44.333333333333336,41.333333333333336,>,3.0,35,39,<,-4,59,45,>,14,214,186,>,28
0,9,43.666666666666664,56.0,<,-12.333333333333336,15,35,<,-20,79,69,>,10,41.333333333333336,49.0,<,-7.666666666666664,39,38,>,1,45,56,<,-11,186,183,>,3
0,9,56.0,43.666666666666664,>,12.333333333333336,35,15,>,20,69,79,<,-10,49.0,41.333333333333336,>,7.666666666666664,38,39,<,-1,56,45,>,11,183,186,<,-3
0,9,43.666666666666664,29.0,>,14.666666666666664,15,19,<,-4,79,40,>,39,41.333333333333336,47.333333333333336,<,-6.0,39,41,<,-2,45,53,<,-8,186,256,<,-70
31,9,29.0,43.666666666666664,<,-14.666666666666664,19,15,>,4,40,79,<,-39,47.333333333333336,41.333333333333336,>,6.0,41,39,>,2,53,45,>,8,256,186,>,70
0,9,43.666666666666664,51.0,<,-7.333333333333336,15,21,<,-6,79,68,>,11,41.333333333333336,36.666666666666664,>,4.666666666666671,39,30,>,9,45,42,>,3,186,236,<,-50
88,9,51.0,43.666666666666664,>,7.333333333333336,21,15,>,6,68,79,<,-11,36.666666666666664,41.333333333333336,<,-4.666666666666671,30,39,<,-9,42,45,<,-3,236,186,>,50
0,9,43.666666666666664,43.0,>,0.6666666666666643,15,20,<,-5,79,88,<,-9,41.333333333333336,47.666666666666664,<,-6.333333333333329,39,37,>,2,45,58,<,-13,186,210,<,-24
159,9,43.0,43.666666666666664,<,-0.6666666666666643,20,15,>,5,88,79,>,9,47.666666666666664,41.333333333333336,>,6.333333333333329,37,39,<,-2,58,45,>,13,210,186,>,24
0,8,46.0,50.333333333333336,<,-4.333333333333336,34,13,>,21,69,81,<,-12,49.0,47.0,>,2.0,38,35,>,3,56,58,<,-2,183,122,>,61
0,8,50.333333333333336,46.0,>,4.333333333333336,13,34,<,-21,81,69,>,12,47.0,49.0,<,-2.0,35,38,<,-3,58,56,>,2,122,183,<,-61
0,8,46.0,47.333333333333336,<,-1.3333333333333357,34,28,>,6,69,74,<,-5,49.0,47.333333333333336,>,1.6666666666666643,38,41,<,-3,56,53,>,3,183,256,<,-73
31,8,47.333333333333336,46.0,>,1.3333333333333357,28,34,<,-6,74,69,>,5,47.333333333333336,49.0,<,-1.6666666666666643,41,38,>,3,53,56,<,-3,256,183,>,73
0,8,46.0,53.666666666666664,<,-7.666666666666664,34,13,>,21,69,81,<,-12,49.0,42.666666666666664,>,6.333333333333336,38,32,>,6,56,60,<,-4,183,241,<,-58
0,8,53.666666666666664,46.0,>,7.666666666666664,13,34,<,-21,81,69,>,12,42.666666666666664,49.0,<,-6.333333333333336,32,38,<,-6,60,56,>,4,241,183,>,58
0,8,46.0,59.0,<,-13.0,34,40,<,-6,69,72,<,-3,49.0,31.666666666666668,>,17.333333333333332,38,31,>,7,56,33,>,23,183,270,<,-87
49,8,59.0,46.0,>,13.0,40,34,>,6,72,69,>,3,31.666666666666668,49.0,<,-17.333333333333332,31,38,<,-7,33,56,<,-23,270,183,>,87
0,8,46.0,47.0,<,-1.0,34,21,>,13,69,64,>,5,49.0,36.666666666666664,>,12.333333333333336,38,30,>,8,56,42,>,14,183,236,<,-53
88,8,47.0,46.0,>,1.0,21,34,<,-13,64,69,<,-5,36.666666666666664,49.0,<,-12.333333333333336,30,38,<,-8,42,56,<,-14,236,183,>,53
0,8,46.0,22.333333333333332,>,23.666666666666668,34,17,>,17,69,32,>,37,49.0,44.333333333333336,>,4.666666666666664,38,35,>,3,56,59,<,-3,183,214,<,-31
98,8,22.333333333333332,46.0,<,-23.666666666666668,17,34,<,-17,32,69,<,-37,44.333333333333336,49.0,<,-4.666666666666664,35,38,<,-3,59,56,>,3,214,183,>,31
0,8,46.0,56.0,<,-10.0,34,20,>,14,69,88,<,-19,49.0,47.666666666666664,>,1.3333333333333357,38,37,>,1,56,58,<,-2,183,210,<,-27
159,8,56.0,46.0,>,10.0,20,34,<,-14,88,69,>,19,47.666666666666664,49.0,<,-1.3333333333333357,37,38,<,-1,58,56,>,2,210,183,>,27
0,7,30.333333333333332,32.666666666666664,<,-2.333333333333332,11,13,<,-2,67,57,>,10,42.666666666666664,47.0,<,-4.333333333333336,32,35,<,-3,60,58,>,2,241,122,>,119
0,7,32.666666666666664,30.333333333333332,>,2.333333333333332,13,11,>,2,57,67,<,-10,47.0,42.666666666666664,>,4.333333333333336,35,32,>,3,58,60,<,-2,122,241,<,-119
0,7,30.333333333333332,57.333333333333336,<,-27.000000000000004,11,40,<,-29,67,74,<,-7,42.666666666666664,47.333333333333336,<,-4.666666666666671,32,41,<,-9,60,53,>,7,241,256,<,-15
103,7,57.333333333333336,30.333333333333332,>,27.000000000000004,40,11,>,29,74,67,>,7,47.333333333333336,42.666666666666664,>,4.666666666666671,41,32,>,9,53,60,<,-7,256,241,>,15
0,7,30.333333333333332,64.66666666666667,<,-34.33333333333334,11,57,<,-46,67,72,<,-5,42.666666666666664,31.666666666666668,>,10.999999999999996,32,31,>,1,60,33,>,27,241,270,<,-29
123,7,64.66666666666667,30.333333333333332,>,34.33333333333334,57,11,>,46,72,67,>,5,31.666666666666668,42.666666666666664,<,-10.999999999999996,31,32,<,-1,33,60,<,-27,270,241,>,29
0,7,30.333333333333332,62.666666666666664,<,-32.33333333333333,11,56,<,-45,67,68,<,-1,42.666666666666664,36.666666666666664,>,6.0,32,30,>,2,60,42,>,18,241,236,>,5
185,7,62.666666666666664,30.333333333333332,>,32.33333333333333,56,11,>,45,68,67,>,1,36.666666666666664,42.666666666666664,<,-6.0,30,32,<,-2,42,60,<,-18,236,241,<,-5
0,7,30.333333333333332,28.0,>,2.333333333333332,11,17,<,-6,67,35,>,32,42.666666666666664,44.333333333333336,<,-1.6666666666666714,32,35,<,-3,60,59,>,1,241,214,>,27
150,7,28.0,30.333333333333332,<,-2.333333333333332,17,11,>,6,35,67,<,-32,44.333333333333336,42.666666666666664,>,1.6666666666666714,35,32,>,3,59,60,<,-1,214,241,<,-27
0,7,30.333333333333332,68.33333333333333,<,-38.0,11,57,<,-46,67,88,<,-21,42.666666666666664,47.666666666666664,<,-5.0,32,37,<,-5,60,58,>,2,241,210,>,31
240,7,68.33333333333333,30.333333333333332,>,38.0,57,11,>,46,88,67,>,21,47.666666666666664,42.666666666666664,>,5.0,37,32,>,5,58,60,<,-2,210,241,<,-31
0,6,32.666666666666664,42.666666666666664,<,-10.0,13,30,<,-17,57,58,<,-1,47.0,47.333333333333336,<,-0.3333333333333357,35,41,<,-6,58,53,>,5,122,256,<,-134
0,6,42.666666666666664,32.666666666666664,>,10.0,30,13,>,17,58,57,>,1,47.333333333333336,47.0,>,0.3333333333333357,41,35,>,6,53,58,<,-5,256,122,>,134
0,6,32.666666666666664,56.0,<,-23.333333333333336,13,46,<,-33,57,65,<,-8,47.0,31.666666666666668,>,15.333333333333332,35,31,>,4,58,33,>,25,122,270,<,-148
50,6,56.0,32.666666666666664,>,23.333333333333336,46,13,>,33,65,57,>,8,31.666666666666668,47.0,<,-15.333333333333332,31,35,<,-4,33,58,<,-25,270,122,>,148
0,6,32.666666666666664,29.333333333333332,>,3.333333333333332,13,17,<,-4,57,36,>,21,47.0,44.333333333333336,>,2.6666666666666643,35,35,=,0,58,59,<,-1,122,214,<,-92
108,6,29.333333333333332,32.666666666666664,<,-3.333333333333332,17,13,>,4,36,57,<,-21,44.333333333333336,47.0,<,-2.6666666666666643,35,35,=,0,59,58,>,1,214,122,>,92
0,6,32.666666666666664,69.0,<,-36.333333333333336,13,64,<,-51,57,75,<,-18,47.0,36.666666666666664,>,10.333333333333336,35,30,>,5,58,42,>,16,122,236,<,-114
154,6,69.0,32.666666666666664,>,36.333333333333336,64,13,>,51,75,57,>,18,36.666666666666664,47.0,<,-10.333333333333336,30,35,<,-5,42,58,<,-16,236,122,>,114
0,6,32.666666666666664,71.33333333333333,<,-38.666666666666664,13,57,<,-44,57,88,<,-31,47.0,47.666666666666664,<,-0.6666666666666643,35,37,<,-2,58,58,=,0,122,210,<,-88
228,6,71.33333333333333,32.666666666666664,>,38.666666666666664,57,13,>,44,88,57,>,31,47.666666666666664,47.0,>,0.6666666666666643,37,35,>,2,58,58,=,0,210,122,>,88
0,5,48.0,59.333333333333336,<,-11.333333333333336,30,46,<,-16,58,75,<,-17,47.333333333333336,31.666666666666668,>,15.666666666666668,41,31,>,10,53,33,>,20,256,270,<,-14
50,5,59.333333333333336,48.0,>,11.333333333333336,46,30,>,16,75,58,>,17,31.666666666666668,47.333333333333336,<,-15.666666666666668,31,41,<,-10,33,53,<,-20,270,256,>,14
0,5,48.0,45.333333333333336,>,2.6666666666666643,30,35,<,-5,58,65,<,-7,47.333333333333336,44.333333333333336,>,3.0,41,35,>,6,53,59,<,-6,256,214,>,42
108,5,45.333333333333336,48.0,<,-2.6666666666666643,35,30,>,5,65,58,>,7,44.333333333333336,47.333333333333336,<,-3.0,35,41,<,-6,59,53,>,6,214,256,<,-42
0,5,48.0,57.0,<,-9.0,30,28,>,2,58,75,<,-17,47.333333333333336,36.666666666666664,>,10.666666666666671,41,30,>,11,53,42,>,11,256,236,>,20
71,5,57.0,48.0,>,9.0,28,30,<,-2,75,58,>,17,36.666666666666664,47.333333333333336,<,-10.666666666666671,30,41,<,-11,42,53,<,-11,236,256,<,-20
0,5,48.0,45.666666666666664,>,2.3333333333333357,30,11,>,19,58,69,<,-11,47.333333333333336,47.666666666666664,<,-0.3333333333333286,41,37,>,4,53,58,<,-5,256,210,>,46
0,5,45.666666666666664,48.0,<,-2.3333333333333357,11,30,<,-19,69,58,>,11,47.666666666666664,47.333333333333336,>,0.3333333333333286,37,41,<,-4,58,53,>,5,210,256,<,-46
0,4,49.666666666666664,55.0,<,-5.333333333333336,11,33,<,-22,81,75,>,6,47.666666666666664,31.666666666666668,>,15.999999999999996,37,31,>,6,58,33,>,25,210,270,<,-60
95,4,55.0,49.666666666666664,>,5.333333333333336,33,11,>,22,75,81,<,-6,31.666666666666668,47.666666666666664,<,-15.999999999999996,31,37,<,-6,33,58,<,-25,270,210,>,60
0,4,49.666666666666664,61.666666666666664,<,-12.0,11,28,<,-17,81,89,<,-8,47.666666666666664,36.666666666666664,>,11.0,37,30,>,7,58,42,>,16,210,236,<,-26
71,4,61.666666666666664,49.666666666666664,>,12.0,28,11,>,17,89,81,>,8,36.666666666666664,47.666666666666664,<,-11.0,30,37,<,-7,42,58,<,-16,236,210,>,26
0,4,49.666666666666664,38.0,>,11.666666666666664,11,14,<,-3,81,65,>,16,47.666666666666664,44.333333333333336,>,3.3333333333333286,37,35,>,2,58,59,<,-1,210,214,<,-4
126,4,38.0,49.666666666666664,<,-11.666666666666664,14,11,>,3,65,81,<,-16,44.333333333333336,47.666666666666664,<,-3.3333333333333286,35,37,<,-2,59,58,>,1,214,210,>,4
0,3,21.666666666666668,64.33333333333333,<,-42.66666666666666,14,36,<,-22,35,89,<,-54,44.333333333333336,36.666666666666664,>,7.666666666666671,35,30,>,5,59,42,>,17,214,236,<,-22
84,3,64.33333333333333,21.666666666666668,>,42.66666666666666,36,14,>,22,89,35,>,54,36.666666666666664,44.333333333333336,<,-7.666666666666671,30,35,<,-5,42,59,<,-17,236,214,>,22
0,3,21.666666666666668,34.0,<,-12.333333333333332,14,12,>,2,35,57,<,-22,44.333333333333336,31.666666666666668,>,12.666666666666668,35,31,>,4,59,33,>,26,214,270,<,-56
89,3,34.0,21.666666666666668,>,12.333333333333332,12,14,<,-2,57,35,>,22,31.666666666666668,44.333333333333336,<,-12.666666666666668,31,35,<,-4,33,59,<,-26,270,214,>,56
0,2,59.333333333333336,57.0,>,2.3333333333333357,21,33,<,-12,89,81,>,8,36.666666666666664,31.666666666666668,>,4.9999999999999964,30,31,<,-1,42,33,>,9,236,270,<,-34
95,2,57.0,59.333333333333336,<,-2.3333333333333357,33,21,>,12,81,89,<,-8,31.666666666666668,36.666666666666664,<,-4.9999999999999964,31,30,>,1,33,42,<,-9,270,236,>,34
0,13,0.0,0.0,=,0.0,0,0,=,0,0,0,=,0,42.0,47.333333333333336,<,-5.333333333333336,38,39,<,-1,49,52,<,-3,127,150,<,-23
24,13,0.0,0.0,=,0.0,0,0,=,0,0,0,=,0,47.333333333333336,42.0,>,5.333333333333336,39,38,>,1,52,49,>,3,150,127,>,23
0,13,0.0,0.0,=,0.0,0,0,=,0,0,0,=,0,42.0,41.0,>,1.0,38,30,>,8,49,47,>,2,127,165,<,-38
18,13,0.0,0.0,=,0.0,0,0,=,0,0,0,=,0,41.0,42.0,<,-1.0,30,38,<,-8,47,49,<,-2,165,127,>,38
0,13,0.0,0.0,=,0.0,0,0,=,0,0,0,=,0,42.0,36.666666666666664,>,5.333333333333336,38,32,>,6,49,46,>,3,127,197,<,-70
38,13,0.0,0.0,=,0.0,0,0,=,0,0,0,=,0,36.666666666666664,42.0,<,-5.333333333333336,32,38,<,-6,46,49,<,-3,197,127,>,70
0,13,0.0,0.0,=,0.0,0,0,=,0,0,0,=,0,42.0,47.0,<,-5.0,38,35,>,3,49,57,<,-8,127,193,<,-66
32,13,0.0,0.0,=,0.0,0,0,=,0,0,0,=,0,47.0,42.0,>,5.0,35,38,<,-3,57,49,>,8,193,127,>,66
0,13,0.0,0.0,=,0.0,0,0,=,0,0,0,=,0,42.0,48.333333333333336,<,-6.333333333333336,38,37,>,1,49,59,<,-10,127,169,<,-42
4,13,0.0,0.0,=,0.0,0,0,=,0,0,0,=,0,48.333333333333336,42.0,>,6.333333333333336,37,38,<,-1,59,49,>,10,169,127,>,42
0,13,0.0,0.0,=,0.0,0,0,=,0,0,0,=,0,42.0,41.333333333333336,>,0.6666666666666643,38,33,>,5,49,55,<,-6,127,123,>,4
0,13,0.0,0.0,=,0.0,0,0,=,0,0,0,=,0,41.333333333333336,42.0,<,-0.6666666666666643,33,38,<,-5,55,49,>,6,123,127,<,-4
0,13,0.0,0.0,=,0.0,0,0,=,0,0,0,=,0,42.0,39.666666666666664,>,2.3333333333333357,38,34,>,4,49,48,>,1,127,208,<,-81
32,13,0.0,0.0,=,0.0,0,0,=,0,0,0,=,0,39.666666666666664,42.0,<,-2.3333333333333357,34,38,<,-4,48,49,<,-1,208,127,>,81
0,13,0.0,0.0,=,0.0,0,0,=,0,0,0,=,0,42.0,42.666666666666664,<,-0.6666666666666643,38,34,>,4,49,50,<,-1,127,164,<,-37
0,13,0.0,0.0,=,0.0,0,0,=,0,0,0,=,0,42.666666666666664,42.0,>,0.6666666666666643,34,38,<,-4,50,49,>,1,164,127,>,37
0,13,0.0,0.0,=,0.0,0,0,=,0,0,0,=,0,42.0,44.666666666666664,<,-2.6666666666666643,38,36,>,2,49,52,<,-3,127,197,<,-70
21,13,0.0,0.0,=,0.0,0,0,=,0,0,0,=,0,44.666666666666664,42.0,>,2.6666666666666643,36,38,<,-2,52,49,>,3,197,127,>,70
0,13,0.0,0.0,=,0.0,0,0,=,0,0,0,=,0,42.0,41.333333333333336,>,0.6666666666666643,38,30,>,8,49,55,<,-6,127,164,<,-37
7,13,0.0,0.0,=,0.0,0,0,=,0,0,0,=,0,41.333333333333336,42.0,<,-0.6666666666666643,30,38,<,-8,55,49,>,6,164,127,>,37
0,13,0.0,0.0,=,0.0,0,0,=,0,0,0,=,0,42.0,50.333333333333336,<,-8.333333333333336,38,43,<,-5,49,57,<,-8,127,189,<,-62
43,13,0.0,0.0,=,0.0,0,0,=,0,0,0,=,0,50.333333333333336,42.0,>,8.333333333333336,43,38,>,5,57,49,>,8,189,127,>,62
0,13,0.0,0.0,=,0.0,0,0,=,0,0,0,=,0,42.0,35.0,>,7.0,38,33,>,5,49,37,>,12,127,99,>,28
7,13,0.0,0.0,=,0.0,0,0,=,0,0,0,=,0,35.0,42.0,<,-7.0,33,38,<,-5,37,49,<,-12,99,127,<,-28
0,12,8.0,12.666666666666666,<,-4.666666666666666,0,0,=,0,24,38,<,-14,41.333333333333336,42.666666666666664,<,-1.3333333333333286,33,34,<,-1,55,50,>,5,123,164,<,-41
0,12,12.666666666666666,8.0,>,4.666666666666666,0,0,=,0,38,24,>,14,42.666666666666664,41.333333333333336,>,1.3333333333333286,34,33,>,1,50,55,<,-5,164,123,>,41
0,12,8.0,7.666666666666667,>,0.33333333333333304,0,0,=,0,24,23,>,1,41.333333333333336,48.333333333333336,<,-7.0,33,37,<,-4,55,59,<,-4,123,169,<,-46
4,12,7.666666666666667,8.0,<,-0.33333333333333304,0,0,=,0,23,24,<,-1,48.333333333333336,41.333333333333336,>,7.0,37,33,>,4,59,55,>,4,169,123,>,46
0,12,8.0,17.0,<,-9.0,0,0,=,0,24,51,<,-27,41.333333333333336,41.333333333333336,=,0.0,33,30,>,3,55,55,=,0,123,164,<,-41
9,12,17.0,8.0,>,9.0,0,0,=,0,51,24,>,27,41.333333333333336,41.333333333333336,=,0.0,30,33,<,-3,55,55,=,0,164,123,>,41
0,12,8.0,5.0,>,3.0,0,0,=,0,24,15,>,9,41.333333333333336,35.0,>,6.333333333333336,33,33,=,0,55,37,>,18,123,99,>,24
9,12,5.0,8.0,<,-3.0,0,0,=,0,15,24,<,-9,35.0,41.333333333333336,<,-6.333333333333336,33,33,=,0,37,55,<,-18,99,123,<,-24
0,12,8.0,14.666666666666666,<,-6.666666666666666,0,0,=,0,24,44,<,-20,41.333333333333336,41.0,>,0.3333333333333357,33,30,>,3,55,47,>,8,123,165,<,-42
15,12,14.666666666666666,8.0,>,6.666666666666666,0,0,=,0,44,24,>,20,41.0,41.333333333333336,<,-0.3333333333333357,30,33,<,-3,47,55,<,-8,165,123,>,42
0,12,8.0,22.666666666666668,<,-14.666666666666668,0,0,=,0,24,68,<,-44,41.333333333333336,44.666666666666664,<,-3.3333333333333286,33,36,<,-3,55,52,>,3,123,197,<,-74
44,12,22.666666666666668,8.0,>,14.666666666666668,0,0,=,0,68,24,>,44,44.666666666666664,41.333333333333336,>,3.3333333333333286,36,33,>,3,52,55,<,-3,197,123,>,74
0,12,8.0,19.666666666666668,<,-11.666666666666668,0,0,=,0,24,59,<,-35,41.333333333333336,47.333333333333336,<,-6.0,33,39,<,-6,55,52,>,3,123,150,<,-27
43,12,19.666666666666668,8.0,>,11.666666666666668,0,0,=,0,59,24,>,35,47.333333333333336,41.333333333333336,>,6.0,39,33,>,6,52,55,<,-3,150,123,>,27
0,12,8.0,10.666666666666666,<,-2.666666666666666,0,0,=,0,24,32,<,-8,41.333333333333336,47.0,<,-5.666666666666664,33,35,<,-2,55,57,<,-2,123,193,<,-70
59,12,10.666666666666666,8.0,>,2.666666666666666,0,0,=,0,32,24,>,8,47.0,41.333333333333336,>,5.666666666666664,35,33,>,2,57,55,>,2,193,123,>,70
0,12,8.0,14.0,<,-6.0,0,0,=,0,24,42,<,-18,41.333333333333336,39.666666666666664,>,1.6666666666666714,33,34,<,-1,55,48,>,7,123,208,<,-85
43,12,14.0,8.0,>,6.0,0,0,=,0,42,24,>,18,39.666666666666664,41.333333333333336,<,-1.6666666666666714,34,33,>,1,48,55,<,-7,208,123,>,85
0,12,8.0,3.6666666666666665,>,4.333333333333334,0,0,=,0,24,11,>,13,41.333333333333336,36.666666666666664,>,4.666666666666671,33,32,>,1,55,46,>,9,123,197,<,-74
4,12,3.6666666666666665,8.0,<,-4.333333333333334,0,0,=,0,11,24,<,-13,36.666666666666664,41.333333333333336,<,-4.666666666666671,32,33,<,-1,46,55,<,-9,197,123,>,74
0,12,8.0,10.333333333333334,<,-2.333333333333334,0,0,=,0,24,31,<,-7,41.333333333333336,50.333333333333336,<,-9.0,33,43,<,-10,55,57,<,-2,123,189,<,-66
0,12,10.333333333333334,8.0,>,2.333333333333334,0,0,=,0,31,24,>,7,50.333333333333336,41.333333333333336,>,9.0,43,33,>,10,57,55,>,2,189,123,>,66
0,11,23.666666666666668,32.333333333333336,<,-8.666666666666668,0,0,=,0,38,66,<,-28,42.666666666666664,50.333333333333336,<,-7.666666666666671,34,43,<,-9,50,57,<,-7,164,189,<,-25
0,11,32.333333333333336,23.666666666666668,>,8.666666666666668,0,0,=,0,66,38,>,28,50.333333333333336,42.666666666666664,>,7.666666666666671,43,34,>,9,57,50,>,7,189,164,>,25
0,11,23.666666666666668,32.333333333333336,<,-8.666666666666668,0,0,=,0,38,86,<,-48,42.666666666666664,36.666666666666664,>,6.0,34,32,>,2,50,46,>,4,164,197,<,-33
4,11,32.333333333333336,23.666666666666668,>,8.666666666666668,0,0,=,0,86,38,>,48,36.666666666666664,42.666666666666664,<,-6.0,32,34,<,-2,46,50,<,-4,197,164,>,33
0,11,23.666666666666668,37.666666666666664,<,-13.999999999999996,0,0,=,0,38,90,<,-52,42.666666666666664,48.333333333333336,<,-5.666666666666671,34,37,<,-3,50,59,<,-9,164,169,<,-5
4,11,37.666666666666664,23.666666666666668,>,13.999999999999996,0,0,=,0,90,38,>,52,48.333333333333336,42.666666666666664,>,5.666666666666671,37,34,>,3,59,50,>,9,169,164,>,5
0,11,23.666666666666668,41.333333333333336,<,-17.666666666666668,0,0,=,0,38,73,<,-35,42.666666666666664,41.333333333333336,>,1.3333333333333286,34,30,>,4,50,55,<,-5,164,164,=,0
11,11,41.333333333333336,23.666666666666668,>,17.666666666666668,0,0,=,0,73,38,>,35,41.333333333333336,42.666666666666664,<,-1.3333333333333286,30,34,<,-4,55,50,>,5,164,164,=,0
0,11,23.666666666666668,14.333333333333334,>,9.333333333333334,0,0,=,0,38,28,>,10,42.666666666666664,35.0,>,7.666666666666664,34,33,>,1,50,37,>,13,164,99,>,65
0,11,14.333333333333334,23.666666666666668,<,-9.333333333333334,0,0,=,0,28,38,<,-10,35.0,42.666666666666664,<,-7.666666666666664,33,34,<,-1,37,50,<,-13,99,164,<,-65
0,11,23.666666666666668,38.333333333333336,<,-14.666666666666668,0,0,=,0,38,71,<,-33,42.666666666666664,41.0,>,1.6666666666666643,34,30,>,4,50,47,>,3,164,165,<,-1
15,11,38.333333333333336,23.666666666666668,>,14.666666666666668,0,0,=,0,71,38,>,33,41.0,42.666666666666664,<,-1.6666666666666643,30,34,<,-4,47,50,<,-3,165,164,>,1
0,11,23.666666666666668,32.333333333333336,<,-8.666666666666668,0,0,=,0,38,59,<,-21,42.666666666666664,47.333333333333336,<,-4.666666666666671,34,39,<,-5,50,52,<,-2,164,150,>,14
38,11,32.333333333333336,23.666666666666668,>,8.666666666666668,0,0,=,0,59,38,>,21,47.333333333333336,42.666666666666664,>,4.666666666666671,39,34,>,5,52,50,>,2,150,164,<,-14
0,11,23.666666666666668,34.333333333333336,<,-10.666666666666668,0,0,=,0,38,61,<,-23,42.666666666666664,39.666666666666664,>,3.0,34,34,=,0,50,48,>,2,164,208,<,-44
43,11,34.333333333333336,23.666666666666668,>,10.666666666666668,0,0,=,0,61,38,>,23,39.666666666666664,42.666666666666664,<,-3.0,34,34,=,0,48,50,<,-2,208,164,>,44
0,11,23.666666666666668,35.0,<,-11.333333333333332,0,0,=,0,38,68,<,-30,42.666666666666664,44.666666666666664,<,-2.0,34,36,<,-2,50,52,<,-2,164,197,<,-33
57,11,35.0,23.666666666666668,>,11.333333333333332,0,0,=,0,68,38,>,30,44.666666666666664,42.666666666666664,>,2.0,36,34,>,2,52,50,>,2,197,164,>,33
0,11,23.666666666666668,25.666666666666668,<,-2.0,0,0,=,0,38,45,<,-7,42.666666666666664,47.0,<,-4.333333333333336,34,35,<,-1,50,57,<,-7,164,193,<,-29
59,11,25.666666666666668,23.666666666666668,>,2.0,0,0,=,0,45,38,>,7,47.0,42.666666666666664,>,4.333333333333336,35,34,>,1,57,50,>,7,193,164,>,29
0,10,52.333333333333336,23.333333333333332,>,29.000000000000004,31,15,>,16,66,28,>,38,50.333333333333336,35.0,>,15.333333333333336,43,33,>,10,57,37,>,20,189,99,>,90
0,10,23.333333333333332,52.333333333333336,<,-29.000000000000004,15,31,<,-16,28,66,<,-38,35.0,50.333333333333336,<,-15.333333333333336,33,43,<,-10,37,57,<,-20,99,189,<,-90
0,10,52.333333333333336,45.333333333333336,>,7.0,31,11,>,20,66,86,<,-20,50.333333333333336,36.666666666666664,>,13.666666666666671,43,32,>,11,57,46,>,11,189,197,<,-8
20,10,45.333333333333336,52.333333333333336,<,-7.0,11,31,<,-20,86,66,>,20,36.666666666666664,50.333333333333336,<,-13.666666666666671,32,43,<,-11,46,57,<,-11,197,189,>,8
0,10,52.333333333333336,41.666666666666664,>,10.666666666666671,31,12,>,19,66,90,<,-24,50.333333333333336,48.333333333333336,>,2.0,43,37,>,6,57,59,<,-2,189,169,>,20
0,10,41.666666666666664,52.333333333333336,<,-10.666666666666671,12,31,<,-19,90,66,>,24,48.333333333333336,50.333333333333336,<,-2.0,37,43,<,-6,59,57,>,2,169,189,<,-20
0,10,52.333333333333336,62.333333333333336,<,-10.0,31,51,<,-20,66,73,<,-7,50.333333333333336,41.333333333333336,>,9.0,43,30,>,13,57,55,>,2,189,164,>,25
93,10,62.333333333333336,52.333333333333336,>,10.0,51,31,>,20,73,66,>,7,41.333333333333336,50.333333333333336,<,-9.0,30,43,<,-13,55,57,<,-2,164,189,<,-25
0,10,52.333333333333336,46.666666666666664,>,5.666666666666671,31,25,>,6,66,71,<,-5,50.333333333333336,41.0,>,9.333333333333336,43,30,>,13,57,47,>,10,189,165,>,24
15,10,46.666666666666664,52.333333333333336,<,-5.666666666666671,25,31,<,-6,71,66,>,5,41.0,50.333333333333336,<,-9.333333333333336,30,43,<,-13,47,57,<,-10,165,189,<,-24
0,10,52.333333333333336,41.666666666666664,>,10.666666666666671,31,28,>,3,66,59,>,7,50.333333333333336,47.333333333333336,>,3.0,43,39,>,4,57,52,>,5,189,150,>,39
51,10,41.666666666666664,52.333333333333336,<,-10.666666666666671,28,31,<,-3,59,66,<,-7,47.333333333333336,50.333333333333336,<,-3.0,39,43,<,-4,52,57,<,-5,150,189,<,-39
0,10,52.333333333333336,63.666666666666664,<,-11.333333333333329,31,42,<,-11,66,88,<,-22,50.333333333333336,39.666666666666664,>,10.666666666666671,43,34,>,9,57,48,>,9,189,208,<,-19
43,10,63.666666666666664,52.333333333333336,>,11.333333333333329,42,31,>,11,88,66,>,22,39.666666666666664,50.333333333333336,<,-10.666666666666671,34,43,<,-9,48,57,<,-9,208,189,>,19
0,10,52.333333333333336,39.0,>,13.333333333333336,31,12,>,19,66,68,<,-2,50.333333333333336,44.666666666666664,>,5.666666666666671,43,36,>,7,57,52,>,5,189,197,<,-8
57,10,39.0,52.333333333333336,<,-13.333333333333336,12,31,<,-19,68,66,>,2,44.666666666666664,50.333333333333336,<,-5.666666666666671,36,43,<,-7,52,57,<,-5,197,189,>,8
0,10,52.333333333333336,54.666666666666664,<,-2.3333333333333286,31,32,<,-1,66,87,<,-21,50.333333333333336,47.0,>,3.3333333333333357,43,35,>,8,57,57,=,0,189,193,<,-4
63,10,54.666666666666664,52.333333333333336,>,2.3333333333333286,32,31,>,1,87,66,>,21,47.0,50.333333333333336,<,-3.3333333333333357,35,43,<,-8,57,57,=,0,193,189,>,4
0,9,53.333333333333336,36.0,>,17.333333333333336,12,27,<,-15,90,53,>,37,48.333333333333336,35.0,>,13.333333333333336,37,33,>,4,59,37,>,22,169,99,>,70
0,9,36.0,53.333333333333336,<,-17.333333333333336,27,12,>,15,53,90,<,-37,35.0,48.333333333333336,<,-13.333333333333336,33,37,<,-4,37,59,<,-22,99,169,<,-70
0,9,53.333333333333336,42.333333333333336,>,11.0,12,25,<,-13,90,71,>,19,48.333333333333336,41.0,>,7.333333333333336,37,30,>,7,59,47,>,12,169,165,>,4
0,9,42.333333333333336,53.333333333333336,<,-11.0,25,12,>,13,71,90,<,-19,41.0,48.333333333333336,<,-7.333333333333336,30,37,<,-7,47,59,<,-12,165,169,<,-4
0,9,53.333333333333336,57.0,<,-3.6666666666666643,12,39,<,-27,90,86,>,4,48.333333333333336,36.666666666666664,>,11.666666666666671,37,32,>,5,59,46,>,13,169,197,<,-28
85,9,57.0,53.333333333333336,>,3.6666666666666643,39,12,>,27,86,90,<,-4,36.666666666666664,48.333333333333336,<,-11.666666666666671,32,37,<,-5,46,59,<,-13,197,169,>,28
0,9,53.333333333333336,59.666666666666664,<,-6.333333333333329,12,30,<,-18,90,88,>,2,48.333333333333336,39.666666666666664,>,8.666666666666671,37,34,>,3,59,48,>,11,169,208,<,-39
65,9,59.666666666666664,53.333333333333336,>,6.333333333333329,30,12,>,18,88,90,<,-2,39.666666666666664,48.333333333333336,<,-8.666666666666671,34,37,<,-3,48,59,<,-11,208,169,>,39
0,9,53.333333333333336,50.333333333333336,>,3.0,12,28,<,-16,90,85,>,5,48.333333333333336,47.333333333333336,>,1.0,37,39,<,-2,59,52,>,7,169,150,>,19
126,9,50.333333333333336,53.333333333333336,<,-3.0,28,12,>,16,85,90,<,-5,47.333333333333336,48.333333333333336,<,-1.0,39,37,>,2,52,59,<,-7,150,169,<,-19
0,9,53.333333333333336,39.333333333333336,>,14.0,12,12,=,0,90,69,>,21,48.333333333333336,44.666666666666664,>,3.6666666666666714,37,36,>,1,59,52,>,7,169,197,<,-28
86,9,39.333333333333336,53.333333333333336,<,-14.0,12,12,=,0,69,90,<,-21,44.666666666666664,48.333333333333336,<,-3.6666666666666714,36,37,<,-1,52,59,<,-7,197,169,>,28
0,9,53.333333333333336,66.33333333333333,<,-12.999999999999993,12,45,<,-33,90,87,>,3,48.333333333333336,47.0,>,1.3333333333333357,37,35,>,2,59,57,>,2,169,193,<,-24
112,9,66.33333333333333,53.333333333333336,>,12.999999999999993,45,12,>,33,87,90,<,-3,47.0,48.333333333333336,<,-1.3333333333333357,35,37,<,-2,57,59,<,-2,193,169,>,24
0,9,53.333333333333336,60.333333333333336,<,-7.0,12,45,<,-33,90,73,>,17,48.333333333333336,41.333333333333336,>,7.0,37,30,>,7,59,55,>,4,169,164,>,5
125,9,60.333333333333336,53.333333333333336,>,7.0,45,12,>,33,73,90,<,-17,41.333333333333336,48.333333333333336,<,-7.0,30,37,<,-7,55,59,<,-4,164,169,<,-5
0,8,46.333333333333336,34.666666666666664,>,11.666666666666671,31,23,>,8,71,53,>,18,41.0,35.0,>,6.0,30,33,<,-3,47,37,>,10,165,99,>,66
0,8,34.666666666666664,46.333333333333336,<,-11.666666666666671,23,31,<,-8,53,71,<,-18,35.0,41.0,<,-6.0,33,30,>,3,37,47,<,-10,99,165,<,-66
0,8,46.333333333333336,44.0,>,2.3333333333333357,31,30,>,1,71,61,>,10,41.0,39.666666666666664,>,1.3333333333333357,30,34,<,-4,47,48,<,-1,165,208,<,-43
65,8,44.0,46.333333333333336,<,-2.3333333333333357,30,31,<,-1,61,71,<,-10,39.666666666666664,41.0,<,-1.3333333333333357,34,30,>,4,48,47,>,1,208,165,>,43
0,8,46.333333333333336,51.666666666666664,<,-5.333333333333329,31,23,>,8,71,86,<,-15,41.0,36.666666666666664,>,4.333333333333336,30,32,<,-2,47,46,>,1,165,197,<,-32
74,8,51.666666666666664,46.333333333333336,>,5.333333333333329,23,31,<,-8,86,71,>,15,36.666666666666664,41.0,<,-4.333333333333336,32,30,>,2,46,47,<,-1,197,165,>,32
0,8,46.333333333333336,59.333333333333336,<,-13.0,31,37,<,-6,71,72,<,-1,41.0,44.666666666666664,<,-3.6666666666666643,30,36,<,-6,47,52,<,-5,165,197,<,-32
86,8,59.333333333333336,46.333333333333336,>,13.0,37,31,>,6,72,71,>,1,44.666666666666664,41.0,>,3.6666666666666643,36,30,>,6,52,47,>,5,197,165,>,32
0,8,46.333333333333336,47.333333333333336,<,-1.0,31,30,>,1,71,67,>,4,41.0,47.0,<,-6.0,30,35,<,-5,47,57,<,-10,165,193,<,-28
61,8,47.333333333333336,46.333333333333336,>,1.0,30,31,<,-1,67,71,<,-4,47.0,41.0,>,6.0,35,30,>,5,57,47,>,10,193,165,>,28
0,8,46.333333333333336,45.666666666666664,>,0.6666666666666714,31,19,>,12,71,73,<,-2,41.0,41.333333333333336,<,-0.3333333333333357,30,30,=,0,47,55,<,-8,165,164,>,1
0,8,45.666666666666664,46.333333333333336,<,-0.6666666666666714,19,31,<,-12,73,71,>,2,41.333333333333336,41.0,>,0.3333333333333357,30,30,=,0,55,47,>,8,164,165,<,-1
0,8,46.333333333333336,48.0,<,-1.6666666666666643,31,21,>,10,71,85,<,-14,41.0,47.333333333333336,<,-6.333333333333336,30,39,<,-9,47,52,<,-5,165,150,>,15
140,8,48.0,46.333333333333336,>,1.6666666666666643,21,31,<,-10,85,71,>,14,47.333333333333336,41.0,>,6.333333333333336,39,30,>,9,52,47,>,5,150,165,<,-15
0,7,55.666666666666664,28.666666666666668,>,26.999999999999996,19,23,<,-4,75,35,>,40,41.333333333333336,35.0,>,6.333333333333336,30,33,<,-3,55,37,>,18,164,99,>,65
0,7,28.666666666666668,55.666666666666664,<,-26.999999999999996,23,19,>,4,35,75,<,-40,35.0,41.333333333333336,<,-6.333333333333336,33,30,>,3,37,55,<,-18,99,164,<,-65
0,7,55.666666666666664,47.333333333333336,>,8.333333333333329,19,30,<,-11,75,67,>,8,41.333333333333336,47.0,<,-5.666666666666664,30,35,<,-5,55,57,<,-2,164,193,<,-29
61,7,47.333333333333336,55.666666666666664,<,-8.333333333333329,30,19,>,11,67,75,<,-8,47.0,41.333333333333336,>,5.666666666666664,35,30,>,5,57,55,>,2,193,164,>,29
0,7,55.666666666666664,57.0,<,-1.3333333333333357,19,41,<,-22,75,69,>,6,41.333333333333336,39.666666666666664,>,1.6666666666666714,30,34,<,-4,55,48,>,7,164,208,<,-44
83,7,57.0,55.666666666666664,>,1.3333333333333357,41,19,>,22,69,75,<,-6,39.666666666666664,41.333333333333336,<,-1.6666666666666714,34,30,>,4,48,55,<,-7,208,164,>,44
0,7,55.666666666666664,60.333333333333336,<,-4.666666666666671,19,23,<,-4,75,86,<,-11,41.333333333333336,36.666666666666664,>,4.666666666666671,30,32,<,-2,55,46,>,9,164,197,<,-33
74,7,60.333333333333336,55.666666666666664,>,4.666666666666671,23,19,>,4,86,75,>,11,36.666666666666664,41.333333333333336,<,-4.666666666666671,32,30,>,2,46,55,<,-9,197,164,>,33
0,7,55.666666666666664,43.333333333333336,>,12.333333333333329,19,21,<,-2,75,72,>,3,41.333333333333336,44.666666666666664,<,-3.3333333333333286,30,36,<,-6,55,52,>,3,164,197,<,-33
0,7,43.333333333333336,55.666666666666664,<,-12.333333333333329,21,19,>,2,72,75,<,-3,44.666666666666664,41.333333333333336,>,3.3333333333333286,36,30,>,6,52,55,<,-3,197,164,>,33
0,7,55.666666666666664,34.0,>,21.666666666666664,19,21,<,-2,75,43,>,32,41.333333333333336,47.333333333333336,<,-6.0,30,39,<,-9,55,52,>,3,164,150,>,14
132,7,34.0,55.666666666666664,<,-21.666666666666664,21,19,>,2,43,75,<,-32,47.333333333333336,41.333333333333336,>,6.0,39,30,>,9,52,55,<,-3,150,164,<,-14
0,6,43.0,29.666666666666668,>,13.333333333333332,21,26,<,-5,71,35,>,36,44.666666666666664,35.0,>,9.666666666666664,36,33,>,3,52,37,>,15,197,99,>,98
0,6,29.666666666666668,43.0,<,-13.333333333333332,26,21,>,5,35,71,<,-36,35.0,44.666666666666664,<,-9.666666666666664,33,36,<,-3,37,52,<,-15,99,197,<,-98
0,6,43.0,46.333333333333336,<,-3.3333333333333357,21,27,<,-6,71,67,>,4,44.666666666666664,47.0,<,-2.3333333333333357,36,35,>,1,52,57,<,-5,197,193,>,4
0,6,46.333333333333336,43.0,>,3.3333333333333357,27,21,>,6,67,71,<,-4,47.0,44.666666666666664,>,2.3333333333333357,35,36,<,-1,57,52,>,5,193,197,<,-4
0,6,43.0,62.333333333333336,<,-19.333333333333336,21,29,<,-8,71,86,<,-15,44.666666666666664,36.666666666666664,>,8.0,36,32,>,4,52,46,>,6,197,197,=,0
37,6,62.333333333333336,43.0,>,19.333333333333336,29,21,>,8,86,71,>,15,36.666666666666664,44.666666666666664,<,-8.0,32,36,<,-4,46,52,<,-6,197,197,=,0
0,6,43.0,70.33333333333333,<,-27.33333333333333,21,61,<,-40,71,81,<,-10,44.666666666666664,39.666666666666664,>,5.0,36,34,>,2,52,48,>,4,197,208,<,-11
83,6,70.33333333333333,43.0,>,27.33333333333333,61,21,>,40,81,71,>,10,39.666666666666664,44.666666666666664,<,-5.0,34,36,<,-2,48,52,<,-4,208,197,>,11
0,6,43.0,48.666666666666664,<,-5.666666666666664,21,38,<,-17,71,65,>,6,44.666666666666664,47.333333333333336,<,-2.6666666666666714,36,39,<,-3,52,52,=,0,197,150,>,47
132,6,48.666666666666664,43.0,>,5.666666666666664,38,21,>,17,65,71,<,-6,47.333333333333336,44.666666666666664,>,2.6666666666666714,39,36,>,3,52,52,=,0,150,197,<,-47
0,5,49.333333333333336,31.333333333333332,>,18.000000000000004,27,26,>,1,76,40,>,36,47.0,35.0,>,12.0,35,33,>,2,57,37,>,20,193,99,>,94
0,5,31.333333333333332,49.333333333333336,<,-18.000000000000004,26,27,<,-1,40,76,<,-36,35.0,47.0,<,-12.0,33,35,<,-2,37,57,<,-20,99,193,<,-94
0,5,49.333333333333336,58.333333333333336,<,-9.0,27,29,<,-2,76,86,<,-10,47.0,36.666666666666664,>,10.333333333333336,35,32,>,3,57,46,>,11,193,197,<,-4
37,5,58.333333333333336,49.333333333333336,>,9.0,29,27,>,2,86,76,>,10,36.666666666666664,47.0,<,-10.333333333333336,32,35,<,-3,46,57,<,-11,197,193,>,4
0,5,49.333333333333336,62.666666666666664,<,-13.333333333333329,27,46,<,-19,76,81,<,-5,47.0,39.666666666666664,>,7.333333333333336,35,34,>,1,57,48,>,9,193,208,<,-15
68,5,62.666666666666664,49.333333333333336,>,13.333333333333329,46,27,>,19,81,76,>,5,39.666666666666664,47.0,<,-7.333333333333336,34,35,<,-1,48,57,<,-9,208,193,>,15
0,5,49.333333333333336,43.666666666666664,>,5.666666666666671,27,28,<,-1,76,65,>,11,47.0,47.333333333333336,<,-0.3333333333333357,35,39,<,-4,57,52,>,5,193,150,>,43
148,5,43.666666666666664,49.333333333333336,<,-5.666666666666671,28,27,>,1,65,76,<,-11,47.333333333333336,47.0,>,0.3333333333333357,39,35,>,4,52,57,<,-5,150,193,<,-43
0,4,33.666666666666664,59.333333333333336,<,-25.66666666666667,28,32,<,-4,40,86,<,-46,35.0,36.666666666666664,<,-1.6666666666666643,33,32,>,1,37,46,<,-9,99,197,<,-98
69,4,59.333333333333336,33.666666666666664,>,25.66666666666667,32,28,>,4,86,40,>,46,36.666666666666664,35.0,>,1.6666666666666643,32,33,<,-1,46,37,>,9,197,99,>,98
0,4,33.666666666666664,41.0,<,-7.333333333333336,28,16,>,12,40,61,<,-21,35.0,39.666666666666664,<,-4.666666666666664,33,34,<,-1,37,48,<,-11,99,208,<,-109
0,4,41.0,33.666666666666664,>,7.333333333333336,16,28,<,-12,61,40,>,21,39.666666666666664,35.0,>,4.666666666666664,34,33,>,1,48,37,>,11,208,99,>,109
0,4,33.666666666666664,47.333333333333336,<,-13.666666666666671,28,28,=,0,40,76,<,-36,35.0,47.333333333333336,<,-12.333333333333336,33,39,<,-6,37,52,<,-15,99,150,<,-51
155,4,47.333333333333336,33.666666666666664,>,13.666666666666671,28,28,=,0,76,40,>,36,47.333333333333336,35.0,>,12.333333333333336,39,33,>,6,52,37,>,15,150,99,>,51
0,3,30.333333333333332,51.666666666666664,<,-21.333333333333332,16,32,<,-16,46,63,<,-17,39.666666666666664,36.666666666666664,>,3.0,34,32,>,2,48,46,>,2,208,197,>,11
69,3,51.666666666666664,30.333333333333332,>,21.333333333333332,32,16,>,16,63,46,>,17,36.666666666666664,39.666666666666664,<,-3.0,32,34,<,-2,46,48,<,-2,197,208,<,-11
0,3,30.333333333333332,38.0,<,-7.666666666666668,16,10,>,6,46,76,<,-30,39.666666666666664,47.333333333333336,<,-7.666666666666671,34,39,<,-5,48,52,<,-4,208,150,>,58
0,3,38.0,30.333333333333332,>,7.666666666666668,10,16,<,-6,76,46,>,30,47.333333333333336,39.666666666666664,>,7.666666666666671,39,34,>,5,52,48,>,4,150,208,<,-58
0,2,24.333333333333332,58.0,<,-33.66666666666667,10,51,<,-41,35,63,<,-28,47.333333333333336,36.666666666666664,>,10.666666666666671,39,32,>,7,52,46,>,6,150,197,<,-47
112,2,58.0,24.333333333333332,>,33.66666666666667,51,10,>,41,63,35,>,28,36.666666666666664,47.333333333333336,<,-10.666666666666671,32,39,<,-7,46,52,<,-6,197,150,>,47
0,10,0.0,0.0,=,0.0,0,0,=,0,0,0,=,0,37.333333333333336,42.0,<,-4.666666666666664,31,39,<,-8,45,46,<,-1,56,155,<,-99
60,10,0.0,0.0,=,0.0,0,0,=,0,0,0,=,0,42.0,37.333333333333336,>,4.666666666666664,39,31,>,8,46,45,>,1,155,56,>,99
0,10,0.0,0.0,=,0.0,0,0,=,0,0,0,=,0,37.333333333333336,45.0,<,-7.666666666666664,31,38,<,-7,45,56,<,-11,56,123,<,-67
51,10,0.0,0.0,=,0.0,0,0,=,0,0,0,=,0,45.0,37.333333333333336,>,7.666666666666664,38,31,>,7,56,45,>,11,123,56,>,67
0,10,0.0,0.0,=,0.0,0,0,=,0,0,0,=,0,37.333333333333336,47.0,<,-9.666666666666664,31,37,<,-6,45,60,<,-15,56,164,<,-108
84,10,0.0,0.0,=,0.0,0,0,=,0,0,0,=,0,47.0,37.333333333333336,>,9.666666666666664,37,31,>,6,60,45,>,15,164,56,>,108
0,10,0.0,0.0,=,0.0,0,0,=,0,0,0,=,0,37.333333333333336,52.0,<,-14.666666666666664,31,51,<,-20,45,54,<,-9,56,65,<,-9
0,10,0.0,0.0,=,0.0,0,0,=,0,0,0,=,0,52.0,37.333333333333336,>,14.666666666666664,51,31,>,20,54,45,>,9,65,56,>,9
0,10,0.0,0.0,=,0.0,0,0,=,0,0,0,=,0,37.333333333333336,40.666666666666664,<,-3.3333333333333286,31,34,<,-3,45,50,<,-5,56,128,<,-72
8,10,0.0,0.0,=,0.0,0,0,=,0,0,0,=,0,40.666666666666664,37.333333333333336,>,3.3333333333333286,34,31,>,3,50,45,>,5,128,56,>,72
0,10,0.0,0.0,=,0.0,0,0,=,0,0,0,=,0,37.333333333333336,41.333333333333336,<,-4.0,31,31,=,0,45,51,<,-6,56,56,=,0
0,10,0.0,0.0,=,0.0,0,0,=,0,0,0,=,0,41.333333333333336,37.333333333333336,>,4.0,31,31,=,0,51,45,>,6,56,56,=,0
0,10,0.0,0.0,=,0.0,0,0,=,0,0,0,=,0,37.333333333333336,48.333333333333336,<,-11.0,31,39,<,-8,45,56,<,-11,56,153,<,-97
73,10,0.0,0.0,=,0.0,0,0,=,0,0,0,=,0,48.333333333333336,37.333333333333336,>,11.0,39,31,>,8,56,45,>,11,153,56,>,97
0,10,0.0,0.0,=,0.0,0,0,=,0,0,0,=,0,37.333333333333336,36.666666666666664,>,0.6666666666666714,31,36,<,-5,45,37,>,8,56,76,<,-20
32,10,0.0,0.0,=,0.0,0,0,=,0,0,0,=,0,36.666666666666664,37.333333333333336,<,-0.6666666666666714,36,31,>,5,37,45,<,-8,76,56,>,20
0,10,0.0,0.0,=,0.0,0,0,=,0,0,0,=,0,37.333333333333336,46.333333333333336,<,-9.0,31,40,<,-9,45,50,<,-5,56,107,<,-51
27,10,0.0,0.0,=,0.0,0,0,=,0,0,0,=,0,46.333333333333336,37.333333333333336,>,9.0,40,31,>,9,50,45,>,5,107,56,>,51
0,9,19.666666666666668,12.333333333333334,>,7.333333333333334,0,0,=,0,59,37,>,22,52.0,41.333333333333336,>,10.666666666666664,51,31,>,20,54,51,>,3,65,56,>,9
0,9,12.333333333333334,19.666666666666668,<,-7.333333333333334,0,0,=,0,37,59,<,-22,41.333333333333336,52.0,<,-10.666666666666664,31,51,<,-20,51,54,<,-3,56,65,<,-9
0,9,19.666666666666668,11.666666666666666,>,8.000000000000002,0,0,=,0,59,35,>,24,52.0,40.666666666666664,>,11.333333333333336,51,34,>,17,54,50,>,4,65,128,<,-63
0,9,11.666666666666666,19.666666666666668,<,-8.000000000000002,0,0,=,0,35,59,<,-24,40.666666666666664,52.0,<,-11.333333333333336,34,51,<,-17,50,54,<,-4,128,65,>,63
0,9,19.666666666666668,27.666666666666668,<,-8.0,0,0,=,0,59,83,<,-24,52.0,46.333333333333336,>,5.666666666666664,51,40,>,11,54,50,>,4,65,107,<,-42
106,9,27.666666666666668,19.666666666666668,>,8.0,0,0,=,0,83,59,>,24,46.333333333333336,52.0,<,-5.666666666666664,40,51,<,-11,50,54,<,-4,107,65,>,42
0,9,19.666666666666668,19.0,>,0.6666666666666679,0,0,=,0,59,57,>,2,52.0,36.666666666666664,>,15.333333333333336,51,36,>,15,54,37,>,17,65,76,<,-11
51,9,19.0,19.666666666666668,<,-0.6666666666666679,0,0,=,0,57,59,<,-2,36.666666666666664,52.0,<,-15.333333333333336,36,51,<,-15,37,54,<,-17,76,65,>,11
0,9,19.666666666666668,22.333333333333332,<,-2.6666666666666643,0,0,=,0,59,67,<,-8,52.0,45.0,>,7.0,51,38,>,13,54,56,<,-2,65,123,<,-58
84,9,22.333333333333332,19.666666666666668,>,2.6666666666666643,0,0,=,0,67,59,>,8,45.0,52.0,<,-7.0,38,51,<,-13,56,54,>,2,123,65,>,58
0,9,19.666666666666668,15.0,>,4.666666666666668,0,0,=,0,59,45,>,14,52.0,42.0,>,10.0,51,39,>,12,54,46,>,8,65,155,<,-90
110,9,15.0,19.666666666666668,<,-4.666666666666668,0,0,=,0,45,59,<,-14,42.0,52.0,<,-10.0,39,51,<,-12,46,54,<,-8,155,65,>,90
0,9,19.666666666666668,18.333333333333332,>,1.3333333333333357,0,0,=,0,59,55,>,4,52.0,48.333333333333336,>,3.6666666666666643,51,39,>,12,54,56,<,-2,65,153,<,-88
73,9,18.333333333333332,19.666666666666668,<,-1.3333333333333357,0,0,=,0,55,59,<,-4,48.333333333333336,52.0,<,-3.6666666666666643,39,51,<,-12,56,54,>,2,153,65,>,88
0,9,19.666666666666668,19.333333333333332,>,0.3333333333333357,0,0,=,0,59,58,>,1,52.0,47.0,>,5.0,51,37,>,14,54,60,<,-6,65,164,<,-99
114,9,19.333333333333332,19.666666666666668,<,-0.3333333333333357,0,0,=,0,58,59,<,-1,47.0,52.0,<,-5.0,37,51,<,-14,60,54,>,6,164,65,>,99
0,8,18.333333333333332,29.0,<,-10.666666666666668,0,0,=,0,35,50,<,-15,40.666666666666664,41.333333333333336,<,-0.6666666666666714,34,31,>,3,50,51,<,-1,128,56,>,72
0,8,29.0,18.333333333333332,>,10.666666666666668,0,0,=,0,50,35,>,15,41.333333333333336,40.666666666666664,>,0.6666666666666714,31,34,<,-3,51,50,>,1,56,128,<,-72
0,8,18.333333333333332,23.666666666666668,<,-5.333333333333336,0,0,=,0,35,57,<,-22,40.666666666666664,36.666666666666664,>,4.0,34,36,<,-2,50,37,>,13,128,76,>,52
0,8,23.666666666666668,18.333333333333332,>,5.333333333333336,0,0,=,0,57,35,>,22,36.666666666666664,40.666666666666664,<,-4.0,36,34,>,2,37,50,<,-13,76,128,<,-52
0,8,18.333333333333332,39.0,<,-20.666666666666668,0,0,=,0,35,62,<,-27,40.666666666666664,48.333333333333336,<,-7.666666666666671,34,39,<,-5,50,56,<,-6,128,153,<,-25
73,8,39.0,18.333333333333332,>,20.666666666666668,0,0,=,0,62,35,>,27,48.333333333333336,40.666666666666664,>,7.666666666666671,39,34,>,5,56,50,>,6,153,128,>,25
0,8,18.333333333333332,44.0,<,-25.666666666666668,0,0,=,0,35,67,<,-32,40.666666666666664,45.0,<,-4.333333333333336,34,38,<,-4,50,56,<,-6,128,123,>,5
84,8,44.0,18.333333333333332,>,25.666666666666668,0,0,=,0,67,35,>,32,45.0,40.666666666666664,>,4.333333333333336,38,34,>,4,56,50,>,6,123,128,<,-5
0,8,18.333333333333332,45.333333333333336,<,-27.000000000000004,0,0,=,0,35,83,<,-48,40.666666666666664,46.333333333333336,<,-5.666666666666671,34,40,<,-6,50,50,=,0,128,107,>,21
117,8,45.333333333333336,18.333333333333332,>,27.000000000000004,0,0,=,0,83,35,>,48,46.333333333333336,40.666666666666664,>,5.666666666666671,40,34,>,6,50,50,=,0,107,128,<,-21
0,8,18.333333333333332,41.0,<,-22.666666666666668,0,0,=,0,35,78,<,-43,40.666666666666664,42.0,<,-1.3333333333333357,34,39,<,-5,50,46,>,4,128,155,<,-27
110,8,41.0,18.333333333333332,>,22.666666666666668,0,0,=,0,78,35,>,43,42.0,40.666666666666664,>,1.3333333333333357,39,34,>,5,46,50,<,-4,155,128,>,27
0,8,18.333333333333332,47.666666666666664,<,-29.333333333333332,0,0,=,0,35,85,<,-50,40.666666666666664,47.0,<,-6.333333333333336,34,37,<,-3,50,60,<,-10,128,164,<,-36
114,8,47.666666666666664,18.333333333333332,>,29.333333333333332,0,0,=,0,85,35,>,50,47.0,40.666666666666664,>,6.333333333333336,37,34,>,3,60,50,>,10,164,128,>,36
0,7,31.666666666666668,18.666666666666668,>,13.0,0,0,=,0,50,42,>,8,41.333333333333336,36.666666666666664,>,4.666666666666671,31,36,<,-5,51,37,>,14,56,76,<,-20
0,7,18.666666666666668,31.666666666666668,<,-13.0,0,0,=,0,42,50,<,-8,36.666666666666664,41.333333333333336,<,-4.666666666666671,36,31,>,5,37,51,<,-14,76,56,>,20
0,7,31.666666666666668,42.0,<,-10.333333333333332,0,0,=,0,50,64,<,-14,41.333333333333336,48.333333333333336,<,-7.0,31,39,<,-8,51,56,<,-5,56,153,<,-97
73,7,42.0,31.666666666666668,>,10.333333333333332,0,0,=,0,64,50,>,14,48.333333333333336,41.333333333333336,>,7.0,39,31,>,8,56,51,>,5,153,56,>,97
0,7,31.666666666666668,30.333333333333332,>,1.3333333333333357,0,0,=,0,50,65,<,-15,41.333333333333336,45.0,<,-3.6666666666666643,31,38,<,-7,51,56,<,-5,56,123,<,-67
84,7,30.333333333333332,31.666666666666668,<,-1.3333333333333357,0,0,=,0,65,50,>,15,45.0,41.333333333333336,>,3.6666666666666643,38,31,>,7,56,51,>,5,123,56,>,67
0,7,31.666666666666668,53.0,<,-21.333333333333332,0,0,=,0,50,81,<,-31,41.333333333333336,42.0,<,-0.6666666666666643,31,39,<,-8,51,46,>,5,56,155,<,-99
110,7,53.0,31.666666666666668,>,21.333333333333332,0,0,=,0,81,50,>,31,42.0,41.333333333333336,>,0.6666666666666643,39,31,>,8,46,51,<,-5,155,56,>,99
0,7,31.666666666666668,43.333333333333336,<,-11.666666666666668,0,0,=,0,50,85,<,-35,41.333333333333336,47.0,<,-5.666666666666664,31,37,<,-6,51,60,<,-9,56,164,<,-108
81,7,43.333333333333336,31.666666666666668,>,11.666666666666668,0,0,=,0,85,50,>,35,47.0,41.333333333333336,>,5.666666666666664,37,31,>,6,60,51,>,9,164,56,>,108
0,7,31.666666666666668,22.0,>,9.666666666666668,0,0,=,0,50,53,<,-3,41.333333333333336,46.333333333333336,<,-5.0,31,40,<,-9,51,50,>,1,56,107,<,-51
0,7,22.0,31.666666666666668,<,-9.666666666666668,0,0,=,0,53,50,>,3,46.333333333333336,41.333333333333336,>,5.0,40,31,>,9,50,51,<,-1,107,56,>,51
0,6,42.333333333333336,44.0,<,-1.6666666666666643,14,13,>,1,71,66,>,5,36.666666666666664,46.333333333333336,<,-9.666666666666671,36,40,<,-4,37,50,<,-13,76,107,<,-31
0,6,44.0,42.333333333333336,>,1.6666666666666643,13,14,<,-1,66,71,<,-5,46.333333333333336,36.666666666666664,>,9.666666666666671,40,36,>,4,50,37,>,13,107,76,>,31
0,6,42.333333333333336,65.0,<,-22.666666666666664,14,62,<,-48,71,69,>,2,36.666666666666664,48.333333333333336,<,-11.666666666666671,36,39,<,-3,37,56,<,-19,76,153,<,-77
49,6,65.0,42.333333333333336,>,22.666666666666664,62,14,>,48,69,71,<,-2,48.333333333333336,36.666666666666664,>,11.666666666666671,39,36,>,3,56,37,>,19,153,76,>,77
0,6,42.333333333333336,63.0,<,-20.666666666666664,14,45,<,-31,71,85,<,-14,36.666666666666664,47.0,<,-10.333333333333336,36,37,<,-1,37,60,<,-23,76,164,<,-88
76,6,63.0,42.333333333333336,>,20.666666666666664,45,14,>,31,85,71,>,14,47.0,36.666666666666664,>,10.333333333333336,37,36,>,1,60,37,>,23,164,76,>,88
0,6,42.333333333333336,57.333333333333336,<,-15.0,14,26,<,-12,71,81,<,-10,36.666666666666664,45.0,<,-8.333333333333336,36,38,<,-2,37,56,<,-19,76,123,<,-47
119,6,57.333333333333336,42.333333333333336,>,15.0,26,14,>,12,81,71,>,10,45.0,36.666666666666664,>,8.333333333333336,38,36,>,2,56,37,>,19,123,76,>,47
0,6,42.333333333333336,63.333333333333336,<,-21.0,14,31,<,-17,71,81,<,-10,36.666666666666664,42.0,<,-5.333333333333336,36,39,<,-3,37,46,<,-9,76,155,<,-79
0,6,63.333333333333336,42.333333333333336,>,21.0,31,14,>,17,81,71,>,10,42.0,36.666666666666664,>,5.333333333333336,39,36,>,3,46,37,>,9,155,76,>,79
0,5,48.666666666666664,53.333333333333336,<,-4.666666666666671,31,13,>,18,81,81,=,0,42.0,46.333333333333336,<,-4.333333333333336,39,40,<,-1,46,50,<,-4,155,107,>,48
0,5,53.333333333333336,48.666666666666664,>,4.666666666666671,13,31,<,-18,81,81,=,0,46.333333333333336,42.0,>,4.333333333333336,40,39,>,1,50,46,>,4,107,155,<,-48
0,5,48.666666666666664,67.66666666666667,<,-19.000000000000007,31,64,<,-33,81,70,>,11,42.0,48.333333333333336,<,-6.333333333333336,39,39,=,0,46,56,<,-10,155,153,>,2
49,5,67.66666666666667,48.666666666666664,>,19.000000000000007,64,31,>,33,70,81,<,-11,48.333333333333336,42.0,>,6.333333333333336,39,39,=,0,56,46,>,10,153,155,<,-2
0,5,48.666666666666664,57.0,<,-8.333333333333336,31,45,<,-14,81,67,>,14,42.0,47.0,<,-5.0,39,37,>,2,46,60,<,-14,155,164,<,-9
73,5,57.0,48.666666666666664,>,8.333333333333336,45,31,>,14,67,81,<,-14,47.0,42.0,>,5.0,37,39,<,-2,60,46,>,14,164,155,>,9
0,5,48.666666666666664,40.333333333333336,>,8.333333333333329,31,14,>,17,81,81,=,0,42.0,45.0,<,-3.0,39,38,>,1,46,56,<,-10,155,123,>,32
0,5,40.333333333333336,48.666666666666664,<,-8.333333333333329,14,31,<,-17,81,81,=,0,45.0,42.0,>,3.0,38,39,<,-1,56,46,>,10,123,155,<,-32
0,4,17.0,48.333333333333336,<,-31.333333333333336,11,13,<,-2,26,81,<,-55,45.0,46.333333333333336,<,-1.3333333333333357,38,40,<,-2,56,50,>,6,123,107,>,16
0,4,48.333333333333336,17.0,>,31.333333333333336,13,11,>,2,81,26,>,55,46.333333333333336,45.0,>,1.3333333333333357,40,38,>,2,50,56,<,-6,107,123,<,-16
0,4,17.0,53.666666666666664,<,-36.666666666666664,11,27,<,-16,26,70,<,-44,45.0,48.333333333333336,<,-3.3333333333333357,38,39,<,-1,56,56,=,0,123,153,<,-30
0,4,53.666666666666664,17.0,>,36.666666666666664,27,11,>,16,70,26,>,44,48.333333333333336,45.0,>,3.3333333333333357,39,38,>,1,56,56,=,0,153,123,>,30
0,4,17.0,66.0,<,-49.0,11,45,<,-34,26,86,<,-60,45.0,47.0,<,-2.0,38,37,>,1,56,60,<,-4,123,164,<,-41
73,4,66.0,17.0,>,49.0,45,11,>,34,86,26,>,60,47.0,45.0,>,2.0,37,38,<,-1,60,56,>,4,164,123,>,41
0,3,53.666666666666664,49.333333333333336,>,4.333333333333329,27,13,>,14,70,84,<,-14,48.333333333333336,46.333333333333336,>,2.0,39,40,<,-1,56,50,>,6,153,107,>,46
0,3,49.333333333333336,53.666666666666664,<,-4.333333333333329,13,27,<,-14,84,70,>,14,46.333333333333336,48.333333333333336,<,-2.0,40,39,>,1,50,56,<,-6,107,153,<,-46
0,3,53.666666666666664,71.33333333333333,<,-17.666666666666664,27,45,<,-18,70,86,<,-16,48.333333333333336,47.0,>,1.3333333333333357,39,37,>,2,56,60,<,-4,153,164,<,-11
66,3,71.33333333333333,53.666666666666664,>,17.666666666666664,45,27,>,18,86,70,>,16,47.0,48.333333333333336,<,-1.3333333333333357,37,39,<,-2,60,56,>,4,164,153,>,11
0,2,49.0,60.0,<,-11.0,13,45,<,-32,84,83,>,1,46.333333333333336,47.0,<,-0.6666666666666643,40,37,>,3,50,60,<,-10,107,164,<,-57
64,2,60.0,49.0,>,11.0,45,13,>,32,83,84,<,-1,47.0,46.333333333333336,>,0.6666666666666643,37,40,<,-3,60,50,>,10,164,107,>,57
0,17,0.0,0.0,=,0.0,0,0,=,0,0,0,=,0,41.666666666666664,52.333333333333336,<,-10.666666666666671,31,44,<,-13,55,58,<,-3,169,252,<,-83
98,17,0.0,0.0,=,0.0,0,0,=,0,0,0,=,0,52.333333333333336,41.666666666666664,>,10.666666666666671,44,31,>,13,58,55,>,3,252,169,>,83
0,17,0.0,0.0,=,0.0,0,0,=,0,0,0,=,0,41.666666666666664,47.0,<,-5.333333333333336,31,35,<,-4,55,57,<,-2,169,106,>,63
9,17,0.0,0.0,=,0.0,0,0,=,0,0,0,=,0,47.0,41.666666666666664,>,5.333333333333336,35,31,>,4,57,55,>,2,106,169,<,-63
0,17,0.0,0.0,=,0.0,0,0,=,0,0,0,=,0,41.666666666666664,50.0,<,-8.333333333333336,31,41,<,-10,55,58,<,-3,169,134,>,35
80,17,0.0,0.0,=,0.0,0,0,=,0,0,0,=,0,50.0,41.666666666666664,>,8.333333333333336,41,31,>,10,58,55,>,3,134,169,<,-35
0,17,0.0,0.0,=,0.0,0,0,=,0,0,0,=,0,41.666666666666664,51.666666666666664,<,-10.0,31,46,<,-15,55,58,<,-3,169,235,<,-66
55,17,0.0,0.0,=,0.0,0,0,=,0,0,0,=,0,51.666666666666664,41.666666666666664,>,10.0,46,31,>,15,58,55,>,3,235,169,>,66
0,17,0.0,0.0,=,0.0,0,0,=,0,0,0,=,0,41.666666666666664,48.0,<,-6.333333333333336,31,36,<,-5,55,54,>,1,169,200,<,-31
81,17,0.0,0.0,=,0.0,0,0,=,0,0,0,=,0,48.0,41.666666666666664,>,6.333333333333336,36,31,>,5,54,55,<,-1,200,169,>,31
0,17,0.0,0.0,=,0.0,0,0,=,0,0,0,=,0,41.666666666666664,53.333333333333336,<,-11.666666666666671,31,53,<,-22,55,54,>,1,169,126,>,43
17,17,0.0,0.0,=,0.0,0,0,=,0,0,0,=,0,53.333333333333336,41.666666666666664,>,11.666666666666671,53,31,>,22,54,55,<,-1,126,169,<,-43
0,17,0.0,0.0,=,0.0,0,0,=,0,0,0,=,0,41.666666666666664,47.333333333333336,<,-5.666666666666671,31,39,<,-8,55,57,<,-2,169,126,>,43
63,17,0.0,0.0,=,0.0,0,0,=,0,0,0,=,0,47.333333333333336,41.666666666666664,>,5.666666666666671,39,31,>,8,57,55,>,2,126,169,<,-43
0,17,0.0,0.0,=,0.0,0,0,=,0,0,0,=,0,41.666666666666664,44.666666666666664,<,-3.0,31,41,<,-10,55,47,>,8,169,252,<,-83
93,17,0.0,0.0,=,0.0,0,0,=,0,0,0,=,0,44.666666666666664,41.666666666666664,>,3.0,41,31,>,10,47,55,<,-8,252,169,>,83
0,17,0.0,0.0,=,0.0,0,0,=,0,0,0,=,0,41.666666666666664,48.0,<,-6.333333333333336,31,39,<,-8,55,58,<,-3,169,190,<,-21
29,17,0.0,0.0,=,0.0,0,0,=,0,0,0,=,0,48.0,41.666666666666664,>,6.333333333333336,39,31,>,8,58,55,>,3,190,169,>,21
0,17,0.0,0.0,=,0.0,0,0,=,0,0,0,=,0,41.666666666666664,51.0,<,-9.333333333333336,31,48,<,-17,55,56,<,-1,169,132,>,37
17,17,0.0,0.0,=,0.0,0,0,=,0,0,0,=,0,51.0,41.666666666666664,>,9.333333333333336,48,31,>,17,56,55,>,1,132,169,<,-37
0,17,0.0,0.0,=,0.0,0,0,=,0,0,0,=,0,41.666666666666664,41.333333333333336,>,0.3333333333333286,31,32,<,-1,55,56,<,-1,169,215,<,-46
10,17,0.0,0.0,=,0.0,0,0,=,0,0,0,=,0,41.333333333333336,41.666666666666664,<,-0.3333333333333286,32,31,>,1,56,55,>,1,215,169,>,46
0,17,0.0,0.0,=,0.0,0,0,=,0,0,0,=,0,41.666666666666664,43.666666666666664,<,-2.0,31,30,>,1,55,51,>,4,169,237,<,-68
188,17,0.0,0.0,=,0.0,0,0,=,0,0,0,=,0,43.666666666666664,41.666666666666664,>,2.0,30,31,<,-1,51,55,<,-4,237,169,>,68
0,17,0.0,0.0,=,0.0,0,0,=,0,0,0,=,0,41.666666666666664,46.333333333333336,<,-4.666666666666671,31,40,<,-9,55,55,=,0,169,160,>,9
77,17,0.0,0.0,=,0.0,0,0,=,0,0,0,=,0,46.333333333333336,41.666666666666664,>,4.666666666666671,40,31,>,9,55,55,=,0,160,169,<,-9
0,17,0.0,0.0,=,0.0,0,0,=,0,0,0,=,0,41.666666666666664,42.333333333333336,<,-0.6666666666666714,31,34,<,-3,55,49,>,6,169,244,<,-75
110,17,0.0,0.0,=,0.0,0,0,=,0,0,0,=,0,42.333333333333336,41.666666666666664,>,0.6666666666666714,34,31,>,3,49,55,<,-6,244,169,>,75
0,17,0.0,0.0,=,0.0,0,0,=,0,0,0,=,0,41.666666666666664,42.0,<,-0.3333333333333357,31,35,<,-4,55,56,<,-1,169,162,>,7
53,17,0.0,0.0,=,0.0,0,0,=,0,0,0,=,0,42.0,41.666666666666664,>,0.3333333333333357,35,31,>,4,56,55,>,1,162,169,<,-7
0,17,0.0,0.0,=,0.0,0,0,=,0,0,0,=,0,41.666666666666664,48.0,<,-6.333333333333336,31,47,<,-16,55,50,>,5,169,251,<,-82
157,17,0.0,0.0,=,0.0,0,0,=,0,0,0,=,0,48.0,41.666666666666664,>,6.333333333333336,47,31,>,16,50,55,<,-5,251,169,>,82
0,16,16.0,19.0,<,-3.0,0,0,=,0,48,57,<,-9,51.0,47.0,>,4.0,48,35,>,13,56,57,<,-1,132,106,>,26
9,16,19.0,16.0,>,3.0,0,0,=,0,57,48,>,9,47.0,51.0,<,-4.0,35,48,<,-13,57,56,>,1,106,132,<,-26
0,16,16.0,27.666666666666668,<,-11.666666666666668,0,0,=,0,48,83,<,-35,51.0,41.333333333333336,>,9.666666666666664,48,32,>,16,56,56,=,0,132,215,<,-83
129,16,27.666666666666668,16.0,>,11.666666666666668,0,0,=,0,83,48,>,35,41.333333333333336,51.0,<,-9.666666666666664,32,48,<,-16,56,56,=,0,215,132,>,83
0,16,16.0,6.333333333333333,>,9.666666666666668,0,0,=,0,48,19,>,29,51.0,53.333333333333336,<,-2.3333333333333357,48,53,<,-5,56,54,>,2,132,126,>,6
46,16,6.333333333333333,16.0,<,-9.666666666666668,0,0,=,0,19,48,<,-29,53.333333333333336,51.0,>,2.3333333333333357,53,48,>,5,54,56,<,-2,126,132,<,-6
0,16,16.0,3.3333333333333335,>,12.666666666666666,0,0,=,0,48,10,>,38,51.0,48.0,>,3.0,48,39,>,9,56,58,<,-2,132,190,<,-58
20,16,3.3333333333333335,16.0,<,-12.666666666666666,0,0,=,0,10,48,<,-38,48.0,51.0,<,-3.0,39,48,<,-9,58,56,>,2,190,132,>,58
0,16,16.0,19.666666666666668,<,-3.666666666666668,0,0,=,0,48,59,<,-11,51.0,42.0,>,9.0,48,35,>,13,56,56,=,0,132,162,<,-30
72,16,19.666666666666668,16.0,>,3.666666666666668,0,0,=,0,59,48,>,11,42.0,51.0,<,-9.0,35,48,<,-13,56,56,=,0,162,132,>,30
0,16,16.0,8.333333333333334,>,7.666666666666666,0,0,=,0,48,25,>,23,51.0,51.666666666666664,<,-0.6666666666666643,48,46,>,2,56,58,<,-2,132,235,<,-103
77,16,8.333333333333334,16.0,<,-7.666666666666666,0,0,=,0,25,48,<,-23,51.666666666666664,51.0,>,0.6666666666666643,46,48,<,-2,58,56,>,2,235,132,>,103
0,16,16.0,7.0,>,9.0,0,0,=,0,48,21,>,27,51.0,47.333333333333336,>,3.6666666666666643,48,39,>,9,56,57,<,-1,132,126,>,6
59,16,7.0,16.0,<,-9.0,0,0,=,0,21,48,<,-27,47.333333333333336,51.0,<,-3.6666666666666643,39,48,<,-9,57,56,>,1,126,132,<,-6
0,16,16.0,5.0,>,11.0,0,0,=,0,48,15,>,33,51.0,46.333333333333336,>,4.666666666666664,48,40,>,8,56,55,>,1,132,160,<,-28
0,16,5.0,16.0,<,-11.0,0,0,=,0,15,48,<,-33,46.333333333333336,51.0,<,-4.666666666666664,40,48,<,-8,55,56,<,-1,160,132,>,28
0,16,16.0,24.0,<,-8.0,0,0,=,0,48,72,<,-24,51.0,50.0,>,1.0,48,41,>,7,56,58,<,-2,132,134,<,-2
104,16,24.0,16.0,>,8.0,0,0,=,0,72,48,>,24,50.0,51.0,<,-1.0,41,48,<,-7,58,56,>,2,134,132,>,2
0,16,16.0,18.0,<,-2.0,0,0,=,0,48,54,<,-6,51.0,48.0,>,3.0,48,36,>,12,56,54,>,2,132,200,<,-68
118,16,18.0,16.0,>,2.0,0,0,=,0,54,48,>,6,48.0,51.0,<,-3.0,36,48,<,-12,54,56,<,-2,200,132,>,68
0,16,16.0,15.0,>,1.0,0,0,=,0,48,45,>,3,51.0,44.666666666666664,>,6.333333333333336,48,41,>,7,56,47,>,9,132,252,<,-120
123,16,15.0,16.0,<,-1.0,0,0,=,0,45,48,<,-3,44.666666666666664,51.0,<,-6.333333333333336,41,48,<,-7,47,56,<,-9,252,132,>,120
0,16,16.0,17.0,<,-1.0,0,0,=,0,48,51,<,-3,51.0,52.333333333333336,<,-1.3333333333333357,48,44,>,4,56,58,<,-2,132,252,<,-120
136,16,17.0,16.0,>,1.0,0,0,=,0,51,48,>,3,52.333333333333336,51.0,>,1.3333333333333357,44,48,<,-4,58,56,>,2,252,132,>,120
0,16,16.0,10.333333333333334,>,5.666666666666666,0,0,=,0,48,31,>,17,51.0,42.333333333333336,>,8.666666666666664,48,34,>,14,56,49,>,7,132,244,<,-112
114,16,10.333333333333334,16.0,<,-5.666666666666666,0,0,=,0,31,48,<,-17,42.333333333333336,51.0,<,-8.666666666666664,34,48,<,-14,49,56,<,-7,244,132,>,112
0,16,16.0,22.0,<,-6.0,0,0,=,0,48,66,<,-18,51.0,48.0,>,3.0,48,47,>,1,56,50,>,6,132,251,<,-119
214,16,22.0,16.0,>,6.0,0,0,=,0,66,48,>,18,48.0,51.0,<,-3.0,47,48,<,-1,50,56,<,-6,251,132,>,119
0,16,16.0,26.333333333333332,<,-10.333333333333332,0,0,=,0,48,79,<,-31,51.0,43.666666666666664,>,7.333333333333336,48,30,>,18,56,51,>,5,132,237,<,-105
214,16,26.333333333333332,16.0,>,10.333333333333332,0,0,=,0,79,48,>,31,43.666666666666664,51.0,<,-7.333333333333336,30,48,<,-18,51,56,<,-5,237,132,>,105
0,15,24.333333333333332,46.333333333333336,<,-22.000000000000004,0,0,=,0,58,82,<,-24,46.333333333333336,47.0,<,-0.6666666666666643,40,35,>,5,55,57,<,-2,160,106,>,54
9,15,46.333333333333336,24.333333333333332,>,22.000000000000004,0,0,=,0,82,58,>,24,47.0,46.333333333333336,>,0.6666666666666643,35,40,<,-5,57,55,>,2,106,160,<,-54
0,15,24.333333333333332,24.0,>,0.33333333333333215,0,0,=,0,58,62,<,-4,46.333333333333336,48.0,<,-1.6666666666666643,40,39,>,1,55,58,<,-3,160,190,<,-30
20,15,24.0,24.333333333333332,<,-0.33333333333333215,0,0,=,0,62,58,>,4,48.0,46.333333333333336,>,1.6666666666666643,39,40,<,-1,58,55,>,3,190,160,>,30
0,15,24.333333333333332,23.0,>,1.3333333333333321,0,0,=,0,58,50,>,8,46.333333333333336,53.333333333333336,<,-7.0,40,53,<,-13,55,54,>,1,160,126,>,34
0,15,23.0,24.333333333333332,<,-1.3333333333333321,0,0,=,0,50,58,<,-8,53.333333333333336,46.333333333333336,>,7.0,53,40,>,13,54,55,<,-1,126,160,<,-34
0,15,24.333333333333332,32.666666666666664,<,-8.333333333333332,0,0,=,0,58,77,<,-19,46.333333333333336,47.333333333333336,<,-1.0,40,39,>,1,55,57,<,-2,160,126,>,34
92,15,32.666666666666664,24.333333333333332,>,8.333333333333332,0,0,=,0,77,58,>,19,47.333333333333336,46.333333333333336,>,1.0,39,40,<,-1,57,55,>,2,126,160,<,-34
0,15,24.333333333333332,26.0,<,-1.6666666666666679,0,0,=,0,58,59,<,-1,46.333333333333336,42.0,>,4.333333333333336,40,35,>,5,55,56,<,-1,160,162,<,-2
0,15,26.0,24.333333333333332,>,1.6666666666666679,0,0,=,0,59,58,>,1,42.0,46.333333333333336,<,-4.333333333333336,35,40,<,-5,56,55,>,1,162,160,>,2
0,15,24.333333333333332,30.666666666666668,<,-6.333333333333336,0,0,=,0,58,67,<,-9,46.333333333333336,51.666666666666664,<,-5.333333333333329,40,46,<,-6,55,58,<,-3,160,235,<,-75
77,15,30.666666666666668,24.333333333333332,>,6.333333333333336,0,0,=,0,67,58,>,9,51.666666666666664,46.333333333333336,>,5.333333333333329,46,40,>,6,58,55,>,3,235,160,>,75
0,15,24.333333333333332,37.0,<,-12.666666666666668,0,0,=,0,58,72,<,-14,46.333333333333336,50.0,<,-3.6666666666666643,40,41,<,-1,55,58,<,-3,160,134,>,26
136,15,37.0,24.333333333333332,>,12.666666666666668,0,0,=,0,72,58,>,14,50.0,46.333333333333336,>,3.6666666666666643,41,40,>,1,58,55,>,3,134,160,<,-26
0,15,24.333333333333332,20.0,>,4.333333333333332,0,0,=,0,58,31,>,27,46.333333333333336,42.333333333333336,>,4.0,40,34,>,6,55,49,>,6,160,244,<,-84
147,15,20.0,24.333333333333332,<,-4.333333333333332,0,0,=,0,31,58,<,-27,42.333333333333336,46.333333333333336,<,-4.0,34,40,<,-6,49,55,<,-6,244,160,>,84
0,15,24.333333333333332,31.333333333333332,<,-7.0,0,0,=,0,58,54,>,4,46.333333333333336,48.0,<,-1.6666666666666643,40,36,>,4,55,54,>,1,160,200,<,-40
78,15,31.333333333333332,24.333333333333332,>,7.0,0,0,=,0,54,58,<,-4,48.0,46.333333333333336,>,1.6666666666666643,36,40,<,-4,54,55,<,-1,200,160,>,40
0,15,24.333333333333332,26.666666666666668,<,-2.3333333333333357,0,0,=,0,58,45,>,13,46.333333333333336,44.666666666666664,>,1.6666666666666714,40,41,<,-1,55,47,>,8,160,252,<,-92
123,15,26.666666666666668,24.333333333333332,>,2.3333333333333357,0,0,=,0,45,58,<,-13,44.666666666666664,46.333333333333336,<,-1.6666666666666714,41,40,>,1,47,55,<,-8,252,160,>,92
0,15,24.333333333333332,41.666666666666664,<,-17.333333333333332,0,0,=,0,58,83,<,-25,46.333333333333336,41.333333333333336,>,5.0,40,32,>,8,55,56,<,-1,160,215,<,-55
128,15,41.666666666666664,24.333333333333332,>,17.333333333333332,0,0,=,0,83,58,>,25,41.333333333333336,46.333333333333336,<,-5.0,32,40,<,-8,56,55,>,1,215,160,>,55
0,15,24.333333333333332,43.0,<,-18.666666666666668,0,0,=,0,58,78,<,-20,46.333333333333336,52.333333333333336,<,-6.0,40,44,<,-4,55,58,<,-3,160,252,<,-92
136,15,43.0,24.333333333333332,>,18.666666666666668,0,0,=,0,78,58,>,20,52.333333333333336,46.333333333333336,>,6.0,44,40,>,4,58,55,>,3,252,160,>,92
0,15,24.333333333333332,36.666666666666664,<,-12.333333333333332,0,0,=,0,58,79,<,-21,46.333333333333336,43.666666666666664,>,2.6666666666666714,40,30,>,10,55,51,>,4,160,237,<,-77
196,15,36.666666666666664,24.333333333333332,>,12.333333333333332,0,0,=,0,79,58,>,21,43.666666666666664,46.333333333333336,<,-2.6666666666666714,30,40,<,-10,51,55,<,-4,237,160,>,77
0,15,24.333333333333332,26.666666666666668,<,-2.3333333333333357,0,0,=,0,58,66,<,-8,46.333333333333336,48.0,<,-1.6666666666666643,40,47,<,-7,55,50,>,5,160,251,<,-91
92,15,26.666666666666668,24.333333333333332,>,2.3333333333333357,0,0,=,0,66,58,>,8,48.0,46.333333333333336,>,1.6666666666666643,47,40,>,7,50,55,<,-5,251,160,>,91
0,14,25.666666666666668,18.333333333333332,>,7.333333333333336,0,0,=,0,50,36,>,14,53.333333333333336,42.0,>,11.333333333333336,53,35,>,18,54,56,<,-2,126,162,<,-36
0,14,18.333333333333332,25.666666666666668,<,-7.333333333333336,0,0,=,0,36,50,<,-14,42.0,53.333333333333336,<,-11.333333333333336,35,53,<,-18,56,54,>,2,162,126,>,36
0,14,25.666666666666668,40.333333333333336,<,-14.666666666666668,0,0,=,0,50,82,<,-32,53.333333333333336,47.0,>,6.333333333333336,53,35,>,18,54,57,<,-3,126,106,>,20
9,14,40.333333333333336,25.666666666666668,>,14.666666666666668,0,0,=,0,82,50,>,32,47.0,53.333333333333336,<,-6.333333333333336,35,53,<,-18,57,54,>,3,106,126,<,-20
0,14,25.666666666666668,29.666666666666668,<,-4.0,0,0,=,0,50,62,<,-12,53.333333333333336,48.0,>,5.333333333333336,53,39,>,14,54,58,<,-4,126,190,<,-64
0,14,29.666666666666668,25.666666666666668,>,4.0,0,0,=,0,62,50,>,12,48.0,53.333333333333336,<,-5.333333333333336,39,53,<,-14,58,54,>,4,190,126,>,64
0,14,25.666666666666668,47.333333333333336,<,-21.666666666666668,0,0,=,0,50,75,<,-25,53.333333333333336,51.666666666666664,>,1.6666666666666714,53,46,>,7,54,58,<,-4,126,235,<,-109
127,14,47.333333333333336,25.666666666666668,>,21.666666666666668,0,0,=,0,75,50,>,25,51.666666666666664,53.333333333333336,<,-1.6666666666666714,46,53,<,-7,58,54,>,4,235,126,>,109
0,14,25.666666666666668,38.666666666666664,<,-12.999999999999996,0,0,=,0,50,76,<,-26,53.333333333333336,48.0,>,5.333333333333336,53,36,>,17,54,54,=,0,126,200,<,-74
78,14,38.666666666666664,25.666666666666668,>,12.999999999999996,0,0,=,0,76,50,>,26,48.0,53.333333333333336,<,-5.333333333333336,36,53,<,-17,54,54,=,0,200,126,>,74
0,14,25.666666666666668,39.666666666666664,<,-13.999999999999996,0,0,=,0,50,77,<,-27,53.333333333333336,47.333333333333336,>,6.0,53,39,>,14,54,57,<,-3,126,126,=,0
100,14,39.666666666666664,25.666666666666668,>,13.999999999999996,0,0,=,0,77,50,>,27,47.333333333333336,53.333333333333336,<,-6.0,39,53,<,-14,57,54,>,3,126,126,=,0
0,14,25.666666666666668,20.333333333333332,>,5.333333333333336,0,0,=,0,50,47,>,3,53.333333333333336,48.0,>,5.333333333333336,53,47,>,6,54,50,>,4,126,251,<,-125
120,14,20.333333333333332,25.666666666666668,<,-5.333333333333336,0,0,=,0,47,50,<,-3,48.0,53.333333333333336,<,-5.333333333333336,47,53,<,-6,50,54,<,-4,251,126,>,125
0,14,25.666666666666668,32.0,<,-6.333333333333332,0,0,=,0,50,61,<,-11,53.333333333333336,44.666666666666664,>,8.666666666666671,53,41,>,12,54,47,>,7,126,252,<,-126
133,14,32.0,25.666666666666668,>,6.333333333333332,0,0,=,0,61,50,>,11,44.666666666666664,53.333333333333336,<,-8.666666666666671,41,53,<,-12,47,54,<,-7,252,126,>,126
0,14,25.666666666666668,37.333333333333336,<,-11.666666666666668,0,0,=,0,50,70,<,-20,53.333333333333336,41.333333333333336,>,12.0,53,32,>,21,54,56,<,-2,126,215,<,-89
90,14,37.333333333333336,25.666666666666668,>,11.666666666666668,0,0,=,0,70,50,>,20,41.333333333333336,53.333333333333336,<,-12.0,32,53,<,-21,56,54,>,2,215,126,>,89
0,14,25.666666666666668,38.0,<,-12.333333333333332,0,0,=,0,50,78,<,-28,53.333333333333336,52.333333333333336,>,1.0,53,44,>,9,54,58,<,-4,126,252,<,-126
93,14,38.0,25.666666666666668,>,12.333333333333332,0,0,=,0,78,50,>,28,52.333333333333336,53.333333333333336,<,-1.0,44,53,<,-9,58,54,>,4,252,126,>,126
0,14,25.666666666666668,17.666666666666668,>,8.0,0,0,=,0,50,39,>,11,53.333333333333336,50.0,>,3.3333333333333357,53,41,>,12,54,58,<,-4,126,134,<,-8
44,14,17.666666666666668,25.666666666666668,<,-8.0,0,0,=,0,39,50,<,-11,50.0,53.333333333333336,<,-3.3333333333333357,41,53,<,-12,58,54,>,4,134,126,>,8
0,14,25.666666666666668,24.333333333333332,>,1.3333333333333357,0,0,=,0,50,44,>,6,53.333333333333336,42.333333333333336,>,11.0,53,34,>,19,54,49,>,5,126,244,<,-118
108,14,24.333333333333332,25.666666666666668,<,-1.3333333333333357,0,0,=,0,44,50,<,-6,42.333333333333336,53.333333333333336,<,-11.0,34,53,<,-19,49,54,<,-5,244,126,>,118
0,14,25.666666666666668,36.333333333333336,<,-10.666666666666668,0,0,=,0,50,78,<,-28,53.333333333333336,43.666666666666664,>,9.666666666666671,53,30,>,23,54,51,>,3,126,237,<,-111
246,14,36.333333333333336,25.666666666666668,>,10.666666666666668,0,0,=,0,78,50,>,28,43.666666666666664,53.333333333333336,<,-9.666666666666671,30,53,<,-23,51,54,<,-3,237,126,>,111
0,13,55.0,40.0,>,15.0,27,19,>,8,76,65,>,11,48.0,42.0,>,6.0,39,35,>,4,58,56,>,2,190,162,>,28
0,13,40.0,55.0,<,-15.0,19,27,<,-8,65,76,<,-11,42.0,48.0,<,-6.0,35,39,<,-4,56,58,<,-2,162,190,<,-28
0,13,55.0,46.0,>,9.0,27,17,>,10,76,82,<,-6,48.0,47.0,>,1.0,39,35,>,4,58,57,>,1,190,106,>,84
0,13,46.0,55.0,<,-9.0,17,27,<,-10,82,76,>,6,47.0,48.0,<,-1.0,35,39,<,-4,57,58,<,-1,106,190,<,-84
0,13,55.0,21.0,>,34.0,27,10,>,17,76,39,>,37,48.0,50.0,<,-2.0,39,41,<,-2,58,58,=,0,190,134,>,56
44,13,21.0,55.0,<,-34.0,10,27,<,-17,39,76,<,-37,50.0,48.0,>,2.0,41,39,>,2,58,58,=,0,134,190,<,-56
0,13,55.0,62.666666666666664,<,-7.666666666666664,27,40,<,-13,76,76,=,0,48.0,48.0,=,0.0,39,36,>,3,58,54,>,4,190,200,<,-10
141,13,62.666666666666664,55.0,>,7.666666666666664,40,27,>,13,76,76,=,0,48.0,48.0,=,0.0,36,39,<,-3,54,58,<,-4,200,190,>,10
0,13,55.0,53.666666666666664,>,1.3333333333333357,27,42,<,-15,76,70,>,6,48.0,41.333333333333336,>,6.666666666666664,39,32,>,7,58,56,>,2,190,215,<,-25
90,13,53.666666666666664,55.0,<,-1.3333333333333357,42,27,>,15,70,76,<,-6,41.333333333333336,48.0,<,-6.666666666666664,32,39,<,-7,56,58,<,-2,215,190,>,25
0,13,55.0,51.0,>,4.0,27,36,<,-9,76,78,<,-2,48.0,52.333333333333336,<,-4.333333333333336,39,44,<,-5,58,58,=,0,190,252,<,-62
93,13,51.0,55.0,<,-4.0,36,27,>,9,78,76,>,2,52.333333333333336,48.0,>,4.333333333333336,44,39,>,5,58,58,=,0,252,190,>,62
0,13,55.0,43.333333333333336,>,11.666666666666664,27,11,>,16,76,77,<,-1,48.0,47.333333333333336,>,0.6666666666666643,39,39,=,0,58,57,>,1,190,126,>,64
153,13,43.333333333333336,55.0,<,-11.666666666666664,11,27,<,-16,77,76,>,1,47.333333333333336,48.0,<,-0.6666666666666643,39,39,=,0,57,58,<,-1,126,190,<,-64
0,13,55.0,29.333333333333332,>,25.666666666666668,27,15,>,12,76,44,>,32,48.0,42.333333333333336,>,5.666666666666664,39,34,>,5,58,49,>,9,190,244,<,-54
108,13,29.333333333333332,55.0,<,-25.666666666666668,15,27,<,-12,44,76,<,-32,42.333333333333336,48.0,<,-5.666666666666664,34,39,<,-5,49,58,<,-9,244,190,>,54
0,13,55.0,48.0,>,7.0,27,14,>,13,76,83,<,-7,48.0,48.0,=,0.0,39,47,<,-8,58,50,>,8,190,251,<,-61
120,13,48.0,55.0,<,-7.0,14,27,<,-13,83,76,>,7,48.0,48.0,=,0.0,47,39,>,8,50,58,<,-8,251,190,>,61
0,13,55.0,51.666666666666664,>,3.3333333333333357,27,13,>,14,76,75,>,1,48.0,51.666666666666664,<,-3.6666666666666643,39,46,<,-7,58,58,=,0,190,235,<,-45
137,13,51.666666666666664,55.0,<,-3.3333333333333357,13,27,<,-14,75,76,<,-1,51.666666666666664,48.0,>,3.6666666666666643,46,39,>,7,58,58,=,0,235,190,>,45
0,13,55.0,41.333333333333336,>,13.666666666666664,27,28,<,-1,76,61,>,15,48.0,44.666666666666664,>,3.3333333333333357,39,41,<,-2,58,47,>,11,190,252,<,-62
133,13,41.333333333333336,55.0,<,-13.666666666666664,28,27,>,1,61,76,<,-15,44.666666666666664,48.0,<,-3.3333333333333357,41,39,>,2,47,58,<,-11,252,190,>,62
0,13,55.0,65.66666666666667,<,-10.666666666666671,27,31,<,-4,76,88,<,-12,48.0,43.666666666666664,>,4.333333333333336,39,30,>,9,58,51,>,7,190,237,<,-47
256,13,65.66666666666667,55.0,>,10.666666666666671,31,27,>,4,88,76,>,12,43.666666666666664,48.0,<,-4.333333333333336,30,39,<,-9,51,58,<,-7,237,190,>,47
0,12,47.333333333333336,51.666666666666664,<,-4.333333333333329,17,19,<,-2,82,71,>,11,47.0,42.0,>,5.0,35,35,=,0,57,56,>,1,106,162,<,-56
0,12,51.666666666666664,47.333333333333336,>,4.333333333333329,19,17,>,2,71,82,<,-11,42.0,47.0,<,-5.0,35,35,=,0,56,57,<,-1,162,106,>,56
0,12,47.333333333333336,28.0,>,19.333333333333336,17,10,>,7,82,39,>,43,47.0,50.0,<,-3.0,35,41,<,-6,57,58,<,-1,106,134,<,-28
63,12,28.0,47.333333333333336,<,-19.333333333333336,10,17,<,-7,39,82,<,-43,50.0,47.0,>,3.0,41,35,>,6,58,57,>,1,134,106,>,28
0,12,47.333333333333336,41.333333333333336,>,6.0,17,33,<,-16,82,49,>,33,47.0,41.333333333333336,>,5.666666666666664,35,32,>,3,57,56,>,1,106,215,<,-109
0,12,41.333333333333336,47.333333333333336,<,-6.0,33,17,>,16,49,82,<,-33,41.333333333333336,47.0,<,-5.666666666666664,32,35,<,-3,56,57,<,-1,215,106,>,109
0,12,47.333333333333336,49.333333333333336,<,-2.0,17,31,<,-14,82,78,>,4,47.0,52.333333333333336,<,-5.333333333333336,35,44,<,-9,57,58,<,-1,106,252,<,-146
38,12,49.333333333333336,47.333333333333336,>,2.0,31,17,>,14,78,82,<,-4,52.333333333333336,47.0,>,5.333333333333336,44,35,>,9,58,57,>,1,252,106,>,146
0,12,47.333333333333336,41.0,>,6.333333333333336,17,15,>,2,82,79,>,3,47.0,42.333333333333336,>,4.666666666666664,35,34,>,1,57,49,>,8,106,244,<,-138
173,12,41.0,47.333333333333336,<,-6.333333333333336,15,17,<,-2,79,82,<,-3,42.333333333333336,47.0,<,-4.666666666666664,34,35,<,-1,49,57,<,-8,244,106,>,138
0,12,47.333333333333336,58.666666666666664,<,-11.333333333333329,17,14,>,3,82,83,<,-1,47.0,48.0,<,-1.0,35,47,<,-12,57,50,>,7,106,251,<,-145
120,12,58.666666666666664,47.333333333333336,>,11.333333333333329,14,17,<,-3,83,82,>,1,48.0,47.0,>,1.0,47,35,>,12,50,57,<,-7,251,106,>,145
0,12,47.333333333333336,28.333333333333332,>,19.000000000000004,17,22,<,-5,82,35,>,47,47.0,44.666666666666664,>,2.3333333333333357,35,41,<,-6,57,47,>,10,106,252,<,-146
50,12,28.333333333333332,47.333333333333336,<,-19.000000000000004,22,17,>,5,35,82,<,-47,44.666666666666664,47.0,<,-2.3333333333333357,41,35,>,6,47,57,<,-10,252,106,>,146
0,12,47.333333333333336,35.333333333333336,>,12.0,17,13,>,4,82,67,>,15,47.0,51.666666666666664,<,-4.666666666666664,35,46,<,-11,57,58,<,-1,106,235,<,-129
38,12,35.333333333333336,47.333333333333336,<,-12.0,13,17,<,-4,67,82,<,-15,51.666666666666664,47.0,>,4.666666666666664,46,35,>,11,58,57,>,1,235,106,>,129
0,12,47.333333333333336,43.0,>,4.333333333333336,17,17,=,0,82,72,>,10,47.0,48.0,<,-1.0,35,36,<,-1,57,54,>,3,106,200,<,-94
108,12,43.0,47.333333333333336,<,-4.333333333333336,17,17,=,0,72,82,<,-10,48.0,47.0,>,1.0,36,35,>,1,54,57,<,-3,200,106,>,94
0,12,47.333333333333336,43.0,>,4.333333333333336,17,11,>,6,82,77,>,5,47.0,47.333333333333336,<,-0.3333333333333357,35,39,<,-4,57,57,=,0,106,126,<,-20
153,12,43.0,47.333333333333336,<,-4.333333333333336,11,17,<,-6,77,82,<,-5,47.333333333333336,47.0,>,0.3333333333333357,39,35,>,4,57,57,=,0,126,106,>,20
0,12,47.333333333333336,48.666666666666664,<,-1.3333333333333286,17,27,<,-10,82,88,<,-6,47.0,43.666666666666664,>,3.3333333333333357,35,30,>,5,57,51,>,6,106,237,<,-131
135,12,48.666666666666664,47.333333333333336,>,1.3333333333333286,27,17,>,10,88,82,>,6,43.666666666666664,47.0,<,-3.3333333333333357,30,35,<,-5,51,57,<,-6,237,106,>,131
0,11,53.666666666666664,57.333333333333336,<,-3.6666666666666714,33,19,>,14,86,82,>,4,41.333333333333336,42.0,<,-0.6666666666666643,32,35,<,-3,56,56,=,0,215,162,>,53
0,11,57.333333333333336,53.666666666666664,>,3.6666666666666714,19,33,<,-14,82,86,<,-4,42.0,41.333333333333336,>,0.6666666666666643,35,32,>,3,56,56,=,0,162,215,<,-53
0,11,53.666666666666664,61.333333333333336,<,-7.666666666666671,33,31,>,2,86,78,>,8,41.333333333333336,52.333333333333336,<,-11.0,32,44,<,-12,56,58,<,-2,215,252,<,-37
38,11,61.333333333333336,53.666666666666664,>,7.666666666666671,31,33,<,-2,78,86,<,-8,52.333333333333336,41.333333333333336,>,11.0,44,32,>,12,58,56,>,2,252,215,>,37
0,11,53.666666666666664,57.333333333333336,<,-3.6666666666666714,33,26,>,7,86,79,>,7,41.333333333333336,51.666666666666664,<,-10.333333333333329,32,46,<,-14,56,58,<,-2,215,235,<,-20
38,11,57.333333333333336,53.666666666666664,>,3.6666666666666714,26,33,<,-7,79,86,<,-7,51.666666666666664,41.333333333333336,>,10.333333333333329,46,32,>,14,58,56,>,2,235,215,>,20
0,11,53.666666666666664,44.666666666666664,>,9.0,33,22,>,11,86,77,>,9,41.333333333333336,44.666666666666664,<,-3.3333333333333286,32,41,<,-9,56,47,>,9,215,252,<,-37
50,11,44.666666666666664,53.666666666666664,<,-9.0,22,33,<,-11,77,86,<,-9,44.666666666666664,41.333333333333336,>,3.3333333333333286,41,32,>,9,47,56,<,-9,252,215,>,37
0,11,53.666666666666664,31.0,>,22.666666666666664,33,19,>,14,86,39,>,47,41.333333333333336,50.0,<,-8.666666666666664,32,41,<,-9,56,58,<,-2,215,134,>,81
0,11,31.0,53.666666666666664,<,-22.666666666666664,19,33,<,-14,39,86,<,-47,50.0,41.333333333333336,>,8.666666666666664,41,32,>,9,58,56,>,2,134,215,<,-81
0,11,53.666666666666664,22.333333333333332,>,31.333333333333332,33,10,>,23,86,40,>,46,41.333333333333336,48.0,<,-6.666666666666664,32,36,<,-4,56,54,>,2,215,200,>,15
108,11,22.333333333333332,53.666666666666664,<,-31.333333333333332,10,33,<,-23,40,86,<,-46,48.0,41.333333333333336,>,6.666666666666664,36,32,>,4,54,56,<,-2,200,215,<,-15
0,11,53.666666666666664,54.666666666666664,<,-1.0,33,14,>,19,86,79,>,7,41.333333333333336,48.0,<,-6.666666666666664,32,47,<,-15,56,50,>,6,215,251,<,-36
120,11,54.666666666666664,53.666666666666664,>,1.0,14,33,<,-19,79,86,<,-7,48.0,41.333333333333336,>,6.666666666666664,47,32,>,15,50,56,<,-6,251,215,>,36
0,11,53.666666666666664,38.666666666666664,>,15.0,33,27,>,6,86,58,>,28,41.333333333333336,43.666666666666664,<,-2.3333333333333286,32,30,>,2,56,51,>,5,215,237,<,-22
135,11,38.666666666666664,53.666666666666664,<,-15.0,27,33,<,-6,58,86,<,-28,43.666666666666664,41.333333333333336,>,2.3333333333333286,30,32,<,-2,51,56,<,-5,237,215,>,22
0,11,53.666666666666664,47.666666666666664,>,6.0,33,25,>,8,86,77,>,9,41.333333333333336,47.333333333333336,<,-6.0,32,39,<,-7,56,57,<,-1,215,126,>,89
230,11,47.666666666666664,53.666666666666664,<,-6.0,25,33,<,-8,77,86,<,-9,47.333333333333336,41.333333333333336,>,6.0,39,32,>,7,57,56,>,1,126,215,<,-89
0,11,53.666666666666664,53.666666666666664,=,0.0,33,29,>,4,86,79,>,7,41.333333333333336,42.333333333333336,<,-1.0,32,34,<,-2,56,49,>,7,215,244,<,-29
147,11,53.666666666666664,53.666666666666664,=,0.0,29,33,<,-4,79,86,<,-7,42.333333333333336,41.333333333333336,>,1.0,34,32,>,2,49,56,<,-7,244,215,>,29
0,10,49.0,40.333333333333336,>,8.666666666666664,19,19,=,0,89,82,>,7,50.0,42.0,>,8.0,41,35,>,6,58,56,>,2,134,162,<,-28
0,10,40.333333333333336,49.0,<,-8.666666666666664,19,19,=,0,82,89,<,-7,42.0,50.0,<,-8.0,35,41,<,-6,56,58,<,-2,162,134,>,28
0,10,49.0,67.0,<,-18.0,19,48,<,-29,89,78,>,11,50.0,52.333333333333336,<,-2.3333333333333357,41,44,<,-3,58,58,=,0,134,252,<,-118
44,10,67.0,49.0,>,18.0,48,19,>,29,78,89,<,-11,52.333333333333336,50.0,>,2.3333333333333357,44,41,>,3,58,58,=,0,252,134,>,118
0,10,49.0,76.33333333333333,<,-27.33333333333333,19,67,<,-48,89,83,>,6,50.0,51.666666666666664,<,-1.6666666666666643,41,46,<,-5,58,58,=,0,134,235,<,-101
61,10,76.33333333333333,49.0,>,27.33333333333333,67,19,>,48,83,89,<,-6,51.666666666666664,50.0,>,1.6666666666666643,46,41,>,5,58,58,=,0,235,134,>,101
0,10,49.0,45.0,>,4.0,19,23,<,-4,89,77,>,12,50.0,44.666666666666664,>,5.333333333333336,41,41,=,0,58,47,>,11,134,252,<,-118
0,10,45.0,49.0,<,-4.0,23,19,>,4,77,89,<,-12,44.666666666666664,50.0,<,-5.333333333333336,41,41,=,0,47,58,<,-11,252,134,>,118
0,10,49.0,41.0,>,8.0,19,10,>,9,89,73,>,16,50.0,48.0,>,2.0,41,36,>,5,58,54,>,4,134,200,<,-66
141,10,41.0,49.0,<,-8.0,10,19,<,-9,73,89,<,-16,48.0,50.0,<,-2.0,36,41,<,-5,54,58,<,-4,200,134,>,66
0,10,49.0,38.333333333333336,>,10.666666666666664,19,14,>,5,89,71,>,18,50.0,48.0,>,2.0,41,47,<,-6,58,50,>,8,134,251,<,-117
70,10,38.333333333333336,49.0,<,-10.666666666666664,14,19,<,-5,71,89,<,-18,48.0,50.0,<,-2.0,47,41,>,6,50,58,<,-8,251,134,>,117
0,10,49.0,53.333333333333336,<,-4.333333333333336,19,31,<,-12,89,71,>,18,50.0,43.666666666666664,>,6.333333333333336,41,30,>,11,58,51,>,7,134,237,<,-103
175,10,53.333333333333336,49.0,>,4.333333333333336,31,19,>,12,71,89,<,-18,43.666666666666664,50.0,<,-6.333333333333336,30,41,<,-11,51,58,<,-7,237,134,>,103
0,10,49.0,38.333333333333336,>,10.666666666666664,19,29,<,-10,89,53,>,36,50.0,42.333333333333336,>,7.666666666666664,41,34,>,7,58,49,>,9,134,244,<,-110
59,10,38.333333333333336,49.0,<,-10.666666666666664,29,19,>,10,53,89,<,-36,42.333333333333336,50.0,<,-7.666666666666664,34,41,<,-7,49,58,<,-9,244,134,>,110
0,10,49.0,43.666666666666664,>,5.333333333333336,19,25,<,-6,89,77,>,12,50.0,47.333333333333336,>,2.6666666666666643,41,39,>,2,58,57,>,1,134,126,>,8
174,10,43.666666666666664,49.0,<,-5.333333333333336,25,19,>,6,77,89,<,-12,47.333333333333336,50.0,<,-2.6666666666666643,39,41,<,-2,57,58,<,-1,126,134,<,-8
0,9,42.333333333333336,34.333333333333336,>,8.0,23,19,>,4,69,64,>,5,44.666666666666664,42.0,>,2.6666666666666643,41,35,>,6,47,56,<,-9,252,162,>,90
0,9,34.333333333333336,42.333333333333336,<,-8.0,19,23,<,-4,64,69,<,-5,42.0,44.666666666666664,<,-2.6666666666666643,35,41,<,-6,56,47,>,9,162,252,<,-90
0,9,42.333333333333336,66.0,<,-23.666666666666664,23,48,<,-25,69,78,<,-9,44.666666666666664,52.333333333333336,<,-7.666666666666671,41,44,<,-3,47,58,<,-11,252,252,=,0
44,9,66.0,42.333333333333336,>,23.666666666666664,48,23,>,25,78,69,>,9,52.333333333333336,44.666666666666664,>,7.666666666666671,44,41,>,3,58,47,>,11,252,252,=,0
0,9,42.333333333333336,36.333333333333336,>,6.0,23,29,<,-6,69,47,>,22,44.666666666666664,42.333333333333336,>,2.3333333333333286,41,34,>,7,47,49,<,-2,252,244,>,8
59,9,36.333333333333336,42.333333333333336,<,-6.0,29,23,>,6,47,69,<,-22,42.333333333333336,44.666666666666664,<,-2.3333333333333286,34,41,<,-7,49,47,>,2,244,252,<,-8
0,9,42.333333333333336,76.0,<,-33.666666666666664,23,67,<,-44,69,83,<,-14,44.666666666666664,51.666666666666664,<,-7.0,41,46,<,-5,47,58,<,-11,252,235,>,17
61,9,76.0,42.333333333333336,>,33.666666666666664,67,23,>,44,83,69,>,14,51.666666666666664,44.666666666666664,>,7.0,46,41,>,5,58,47,>,11,235,252,<,-17
0,9,42.333333333333336,21.333333333333332,>,21.000000000000004,23,14,>,9,69,30,>,39,44.666666666666664,48.0,<,-3.3333333333333357,41,47,<,-6,47,50,<,-3,252,251,>,1
70,9,21.333333333333332,42.333333333333336,<,-21.000000000000004,14,23,<,-9,30,69,<,-39,48.0,44.666666666666664,>,3.3333333333333357,47,41,>,6,50,47,>,3,251,252,<,-1
0,9,42.333333333333336,51.0,<,-8.666666666666664,23,40,<,-17,69,73,<,-4,44.666666666666664,48.0,<,-3.3333333333333357,41,36,>,5,47,54,<,-7,252,200,>,52
141,9,51.0,42.333333333333336,>,8.666666666666664,40,23,>,17,73,69,>,4,48.0,44.666666666666664,>,3.3333333333333357,36,41,<,-5,54,47,>,7,200,252,<,-52
0,9,42.333333333333336,50.666666666666664,<,-8.333333333333329,23,29,<,-6,69,77,<,-8,44.666666666666664,47.333333333333336,<,-2.6666666666666714,41,39,>,2,47,57,<,-10,252,126,>,126
174,9,50.666666666666664,42.333333333333336,>,8.333333333333329,29,23,>,6,77,69,>,8,47.333333333333336,44.666666666666664,>,2.6666666666666714,39,41,<,-2,57,47,>,10,126,252,<,-126
0,9,42.333333333333336,38.0,>,4.333333333333336,23,12,>,11,69,71,<,-2,44.666666666666664,43.666666666666664,>,1.0,41,30,>,11,47,51,<,-4,252,237,>,15
0,9,38.0,42.333333333333336,<,-4.333333333333336,12,23,<,-11,71,69,>,2,43.666666666666664,44.666666666666664,<,-1.0,30,41,<,-11,51,47,>,4,237,252,<,-15
0,8,33.0,35.666666666666664,<,-2.6666666666666643,12,19,<,-7,56,64,<,-8,43.666666666666664,42.0,>,1.6666666666666643,30,35,<,-5,51,56,<,-5,237,162,>,75
0,8,35.666666666666664,33.0,>,2.6666666666666643,19,12,>,7,64,56,>,8,42.0,43.666666666666664,<,-1.6666666666666643,35,30,>,5,56,51,>,5,162,237,<,-75
0,8,33.0,72.33333333333333,<,-39.33333333333333,12,67,<,-55,56,78,<,-22,43.666666666666664,52.333333333333336,<,-8.666666666666671,30,44,<,-14,51,58,<,-7,237,252,<,-15
52,8,72.33333333333333,33.0,>,39.33333333333333,67,12,>,55,78,56,>,22,52.333333333333336,43.666666666666664,>,8.666666666666671,44,30,>,14,58,51,>,7,252,237,>,15
0,8,33.0,44.0,<,-11.0,12,29,<,-17,56,56,=,0,43.666666666666664,42.333333333333336,>,1.3333333333333286,30,34,<,-4,51,49,>,2,237,244,<,-7
90,8,44.0,33.0,>,11.0,29,12,>,17,56,56,=,0,42.333333333333336,43.666666666666664,<,-1.3333333333333286,34,30,>,4,49,51,<,-2,244,237,>,7
0,8,33.0,68.66666666666667,<,-35.66666666666667,12,61,<,-49,56,78,<,-22,43.666666666666664,51.666666666666664,<,-8.0,30,46,<,-16,51,58,<,-7,237,235,>,2
53,8,68.66666666666667,33.0,>,35.66666666666667,61,12,>,49,78,56,>,22,51.666666666666664,43.666666666666664,>,8.0,46,30,>,16,58,51,>,7,235,237,<,-2
0,8,33.0,33.333333333333336,<,-0.3333333333333357,12,14,<,-2,56,66,<,-10,43.666666666666664,48.0,<,-4.333333333333336,30,47,<,-17,51,50,>,1,237,251,<,-14
103,8,33.333333333333336,33.0,>,0.3333333333333357,14,12,>,2,66,56,>,10,48.0,43.666666666666664,>,4.333333333333336,47,30,>,17,50,51,<,-1,251,237,>,14
0,8,33.0,33.333333333333336,<,-0.3333333333333357,12,20,<,-8,56,40,>,16,43.666666666666664,48.0,<,-4.333333333333336,30,36,<,-6,51,54,<,-3,237,200,>,37
97,8,33.333333333333336,33.0,>,0.3333333333333357,20,12,>,8,40,56,<,-16,48.0,43.666666666666664,>,4.333333333333336,36,30,>,6,54,51,>,3,200,237,<,-37
0,8,33.0,62.333333333333336,<,-29.333333333333336,12,46,<,-34,56,77,<,-21,43.666666666666664,47.333333333333336,<,-3.6666666666666714,30,39,<,-9,51,57,<,-6,237,126,>,111
199,8,62.333333333333336,33.0,>,29.333333333333336,46,12,>,34,77,56,>,21,47.333333333333336,43.666666666666664,>,3.6666666666666714,39,30,>,9,57,51,>,6,126,237,<,-111
0,7,37.333333333333336,65.0,<,-27.666666666666664,19,50,<,-31,69,78,<,-9,42.0,52.333333333333336,<,-10.333333333333336,35,44,<,-9,56,58,<,-2,162,252,<,-90
52,7,65.0,37.333333333333336,>,27.666666666666664,50,19,>,31,78,69,>,9,52.333333333333336,42.0,>,10.333333333333336,44,35,>,9,58,56,>,2,252,162,>,90
0,7,37.333333333333336,57.666666666666664,<,-20.33333333333333,19,45,<,-26,69,67,>,2,42.0,51.666666666666664,<,-9.666666666666664,35,46,<,-11,56,58,<,-2,162,235,<,-73
53,7,57.666666666666664,37.333333333333336,>,20.33333333333333,45,19,>,26,67,69,<,-2,51.666666666666664,42.0,>,9.666666666666664,46,35,>,11,58,56,>,2,235,162,>,73
0,7,37.333333333333336,35.666666666666664,>,1.6666666666666714,19,22,<,-3,69,56,>,13,42.0,42.333333333333336,<,-0.3333333333333357,35,34,>,1,56,49,>,7,162,244,<,-82
0,7,35.666666666666664,37.333333333333336,<,-1.6666666666666714,22,19,>,3,56,69,<,-13,42.333333333333336,42.0,>,0.3333333333333357,34,35,<,-1,49,56,<,-7,244,162,>,82
0,7,37.333333333333336,35.0,>,2.3333333333333357,19,20,<,-1,69,45,>,24,42.0,48.0,<,-6.0,35,36,<,-1,56,54,>,2,162,200,<,-38
97,7,35.0,37.333333333333336,<,-2.3333333333333357,20,19,>,1,45,69,<,-24,48.0,42.0,>,6.0,36,35,>,1,54,56,<,-2,200,162,>,38
0,7,37.333333333333336,30.0,>,7.333333333333336,19,10,>,9,69,66,>,3,42.0,48.0,<,-6.0,35,47,<,-12,56,50,>,6,162,251,<,-89
103,7,30.0,37.333333333333336,<,-7.333333333333336,10,19,<,-9,66,69,<,-3,48.0,42.0,>,6.0,47,35,>,12,50,56,<,-6,251,162,>,89
0,7,37.333333333333336,74.33333333333333,<,-36.99999999999999,19,64,<,-45,69,82,<,-13,42.0,47.333333333333336,<,-5.333333333333336,35,39,<,-4,56,57,<,-1,162,126,>,36
199,7,74.33333333333333,37.333333333333336,>,36.99999999999999,64,19,>,45,82,69,>,13,47.333333333333336,42.0,>,5.333333333333336,39,35,>,4,57,56,>,1,126,162,<,-36
0,6,43.0,48.0,<,-5.0,22,27,<,-5,56,67,<,-11,42.333333333333336,52.333333333333336,<,-10.0,34,44,<,-10,49,58,<,-9,244,252,<,-8
52,6,48.0,43.0,>,5.0,27,22,>,5,67,56,>,11,52.333333333333336,42.333333333333336,>,10.0,44,34,>,10,58,49,>,9,252,244,>,8
0,6,43.0,46.0,<,-3.0,22,32,<,-10,56,61,<,-5,42.333333333333336,51.666666666666664,<,-9.333333333333329,34,46,<,-12,49,58,<,-9,244,235,>,9
53,6,46.0,43.0,>,3.0,32,22,>,10,61,56,>,5,51.666666666666664,42.333333333333336,>,9.333333333333329,46,34,>,12,58,49,>,9,235,244,<,-9
0,6,43.0,39.0,>,4.0,22,20,>,2,56,52,>,4,42.333333333333336,48.0,<,-5.666666666666664,34,36,<,-2,49,54,<,-5,244,200,>,44
97,6,39.0,43.0,<,-4.0,20,22,<,-2,52,56,<,-4,48.0,42.333333333333336,>,5.666666666666664,36,34,>,2,54,49,>,5,200,244,<,-44
0,6,43.0,47.0,<,-4.0,22,10,>,12,56,66,<,-10,42.333333333333336,48.0,<,-5.666666666666664,34,47,<,-13,49,50,<,-1,244,251,<,-7
103,6,47.0,43.0,>,4.0,10,22,<,-12,66,56,>,10,48.0,42.333333333333336,>,5.666666666666664,47,34,>,13,50,49,>,1,251,244,>,7
0,6,43.0,52.0,<,-9.0,22,10,>,12,56,82,<,-26,42.333333333333336,47.333333333333336,<,-5.0,34,39,<,-5,49,57,<,-8,244,126,>,118
0,6,52.0,43.0,>,9.0,10,22,<,-12,82,56,>,26,47.333333333333336,42.333333333333336,>,5.0,39,34,>,5,57,49,>,8,126,244,<,-118
0,5,52.666666666666664,38.333333333333336,>,14.333333333333329,10,21,<,-11,84,67,>,17,47.333333333333336,52.333333333333336,<,-5.0,39,44,<,-5,57,58,<,-1,126,252,<,-126
0,5,38.333333333333336,52.666666666666664,<,-14.333333333333329,21,10,>,11,67,84,<,-17,52.333333333333336,47.333333333333336,>,5.0,44,39,>,5,58,57,>,1,252,126,>,126
0,5,52.666666666666664,55.0,<,-2.3333333333333357,10,32,<,-22,84,72,>,12,47.333333333333336,51.666666666666664,<,-4.333333333333329,39,46,<,-7,57,58,<,-1,126,235,<,-109
53,5,55.0,52.666666666666664,>,2.3333333333333357,32,10,>,22,72,84,<,-12,51.666666666666664,47.333333333333336,>,4.333333333333329,46,39,>,7,58,57,>,1,235,126,>,109
0,5,52.666666666666664,37.666666666666664,>,15.0,10,20,<,-10,84,52,>,32,47.333333333333336,48.0,<,-0.6666666666666643,39,36,>,3,57,54,>,3,126,200,<,-74
97,5,37.666666666666664,52.666666666666664,<,-15.0,20,10,>,10,52,84,<,-32,48.0,47.333333333333336,>,0.6666666666666643,36,39,<,-3,54,57,<,-3,200,126,>,74
0,5,52.666666666666664,71.0,<,-18.333333333333336,10,65,<,-55,84,82,>,2,47.333333333333336,48.0,<,-0.6666666666666643,39,47,<,-8,57,50,>,7,126,251,<,-125
103,5,71.0,52.666666666666664,>,18.333333333333336,65,10,>,55,82,84,<,-2,48.0,47.333333333333336,>,0.6666666666666643,47,39,>,8,50,57,<,-7,251,126,>,125
0,4,51.333333333333336,51.0,>,0.3333333333333357,21,20,>,1,67,72,<,-5,52.333333333333336,51.666666666666664,>,0.6666666666666714,44,46,<,-2,58,58,=,0,252,235,>,17
53,4,51.0,51.333333333333336,<,-0.3333333333333357,20,21,<,-1,72,67,>,5,51.666666666666664,52.333333333333336,<,-0.6666666666666714,46,44,>,2,58,58,=,0,235,252,<,-17
0,4,51.333333333333336,24.666666666666668,>,26.666666666666668,21,13,>,8,67,41,>,26,52.333333333333336,48.0,>,4.333333333333336,44,36,>,8,58,54,>,4,252,200,>,52
0,4,24.666666666666668,51.333333333333336,<,-26.666666666666668,13,21,<,-8,41,67,<,-26,48.0,52.333333333333336,<,-4.333333333333336,36,44,<,-8,54,58,<,-4,200,252,<,-52
0,4,51.333333333333336,55.666666666666664,<,-4.333333333333329,21,19,>,2,67,82,<,-15,52.333333333333336,48.0,>,4.333333333333336,44,47,<,-3,58,50,>,8,252,251,>,1
94,4,55.666666666666664,51.333333333333336,>,4.333333333333329,19,21,<,-2,82,67,>,15,48.0,52.333333333333336,<,-4.333333333333336,47,44,>,3,50,58,<,-8,251,252,<,-1
0,3,25.0,48.333333333333336,<,-23.333333333333336,13,20,<,-7,42,64,<,-22,48.0,51.666666666666664,<,-3.6666666666666643,36,46,<,-10,54,58,<,-4,200,235,<,-35
53,3,48.333333333333336,25.0,>,23.333333333333336,20,13,>,7,64,42,>,22,51.666666666666664,48.0,>,3.6666666666666643,46,36,>,10,58,54,>,4,235,200,>,35
0,3,25.0,47.666666666666664,<,-22.666666666666664,13,19,<,-6,42,66,<,-24,48.0,48.0,=,0.0,36,47,<,-11,54,50,>,4,200,251,<,-51
94,3,47.666666666666664,25.0,>,22.666666666666664,19,13,>,6,66,42,>,24,48.0,48.0,=,0.0,47,36,>,11,50,54,<,-4,251,200,>,51
0,2,46.666666666666664,60.333333333333336,<,-13.666666666666671,16,56,<,-40,66,64,>,2,48.0,51.666666666666664,<,-3.6666666666666643,47,46,>,1,50,58,<,-8,251,235,>,16
53,2,60.333333333333336,46.666666666666664,>,13.666666666666671,56,16,>,40,64,66,<,-2,51.666666666666664,48.0,>,3.6666666666666643,46,47,<,-1,58,50,>,8,235,251,<,-16
0,11,0.0,0.0,=,0.0,0,0,=,0,0,0,=,0,45.666666666666664,49.333333333333336,<,-3.6666666666666714,32,31,>,1,56,59,<,-3,109,129,<,-20
26,11,0.0,0.0,=,0.0,0,0,=,0,0,0,=,0,49.333333333333336,45.666666666666664,>,3.6666666666666714,31,32,<,-1,59,56,>,3,129,109,>,20
0,11,0.0,0.0,=,0.0,0,0,=,0,0,0,=,0,45.666666666666664,43.0,>,2.6666666666666643,32,37,<,-5,56,53,>,3,109,101,>,8
4,11,0.0,0.0,=,0.0,0,0,=,0,0,0,=,0,43.0,45.666666666666664,<,-2.6666666666666643,37,32,>,5,53,56,<,-3,101,109,<,-8
0,11,0.0,0.0,=,0.0,0,0,=,0,0,0,=,0,45.666666666666664,38.666666666666664,>,7.0,32,36,<,-4,56,41,>,15,109,174,<,-65
43,11,0.0,0.0,=,0.0,0,0,=,0,0,0,=,0,38.666666666666664,45.666666666666664,<,-7.0,36,32,>,4,41,56,<,-15,174,109,>,65
0,11,0.0,0.0,=,0.0,0,0,=,0,0,0,=,0,45.666666666666664,45.333333333333336,>,0.3333333333333286,32,39,<,-7,56,55,>,1,109,133,<,-24
0,11,0.0,0.0,=,0.0,0,0,=,0,0,0,=,0,45.333333333333336,45.666666666666664,<,-0.3333333333333286,39,32,>,7,55,56,<,-1,133,109,>,24
0,11,0.0,0.0,=,0.0,0,0,=,0,0,0,=,0,45.666666666666664,40.666666666666664,>,5.0,32,35,<,-3,56,45,>,11,109,154,<,-45
24,11,0.0,0.0,=,0.0,0,0,=,0,0,0,=,0,40.666666666666664,45.666666666666664,<,-5.0,35,32,>,3,45,56,<,-11,154,109,>,45
0,11,0.0,0.0,=,0.0,0,0,=,0,0,0,=,0,45.666666666666664,43.666666666666664,>,2.0,32,39,<,-7,56,52,>,4,109,63,>,46
0,11,0.0,0.0,=,0.0,0,0,=,0,0,0,=,0,43.666666666666664,45.666666666666664,<,-2.0,39,32,>,7,52,56,<,-4,63,109,<,-46
0,11,0.0,0.0,=,0.0,0,0,=,0,0,0,=,0,45.666666666666664,49.333333333333336,<,-3.6666666666666714,32,40,<,-8,56,60,<,-4,109,142,<,-33
27,11,0.0,0.0,=,0.0,0,0,=,0,0,0,=,0,49.333333333333336,45.666666666666664,>,3.6666666666666714,40,32,>,8,60,56,>,4,142,109,>,33
0,11,0.0,0.0,=,0.0,0,0,=,0,0,0,=,0,45.666666666666664,49.666666666666664,<,-4.0,32,42,<,-10,56,54,>,2,109,131,<,-22
24,11,0.0,0.0,=,0.0,0,0,=,0,0,0,=,0,49.666666666666664,45.666666666666664,>,4.0,42,32,>,10,54,56,<,-2,131,109,>,22
0,11,0.0,0.0,=,0.0,0,0,=,0,0,0,=,0,45.666666666666664,49.333333333333336,<,-3.6666666666666714,32,32,=,0,56,59,<,-3,109,148,<,-39
49,11,0.0,0.0,=,0.0,0,0,=,0,0,0,=,0,49.333333333333336,45.666666666666664,>,3.6666666666666714,32,32,=,0,59,56,>,3,148,109,>,39
0,11,0.0,0.0,=,0.0,0,0,=,0,0,0,=,0,45.666666666666664,40.666666666666664,>,5.0,32,33,<,-1,56,56,=,0,109,145,<,-36
22,11,0.0,0.0,=,0.0,0,0,=,0,0,0,=,0,40.666666666666664,45.666666666666664,<,-5.0,33,32,>,1,56,56,=,0,145,109,>,36
0,10,23.0,16.0,>,7.0,0,0,=,0,69,48,>,21,45.333333333333336,43.666666666666664,>,1.6666666666666714,39,39,=,0,55,52,>,3,133,63,>,70
0,10,16.0,23.0,<,-7.0,0,0,=,0,48,69,<,-21,43.666666666666664,45.333333333333336,<,-1.6666666666666714,39,39,=,0,52,55,<,-3,63,133,<,-70
0,10,23.0,10.666666666666666,>,12.333333333333334,0,0,=,0,69,32,>,37,45.333333333333336,43.0,>,2.3333333333333357,39,37,>,2,55,53,>,2,133,101,>,32
4,10,10.666666666666666,23.0,<,-12.333333333333334,0,0,=,0,32,69,<,-37,43.0,45.333333333333336,<,-2.3333333333333357,37,39,<,-2,53,55,<,-2,101,133,<,-32
0,10,23.0,15.0,>,8.0,0,0,=,0,69,45,>,24,45.333333333333336,40.666666666666664,>,4.666666666666671,39,33,>,6,55,56,<,-1,133,145,<,-12
22,10,15.0,23.0,<,-8.0,0,0,=,0,45,69,<,-24,40.666666666666664,45.333333333333336,<,-4.666666666666671,33,39,<,-6,56,55,>,1,145,133,>,12
0,10,23.0,26.333333333333332,<,-3.333333333333332,0,0,=,0,69,79,<,-10,45.333333333333336,40.666666666666664,>,4.666666666666671,39,35,>,4,55,45,>,10,133,154,<,-21
53,10,26.333333333333332,23.0,>,3.333333333333332,0,0,=,0,79,69,>,10,40.666666666666664,45.333333333333336,<,-4.666666666666671,35,39,<,-4,45,55,<,-10,154,133,>,21
0,10,23.0,3.3333333333333335,>,19.666666666666668,0,0,=,0,69,10,>,59,45.333333333333336,49.666666666666664,<,-4.333333333333329,39,42,<,-3,55,54,>,1,133,131,>,2
0,10,3.3333333333333335,23.0,<,-19.666666666666668,0,0,=,0,10,69,<,-59,49.666666666666664,45.333333333333336,>,4.333333333333329,42,39,>,3,54,55,<,-1,131,133,<,-2
0,10,23.0,25.0,<,-2.0,0,0,=,0,69,75,<,-6,45.333333333333336,49.333333333333336,<,-4.0,39,31,>,8,55,59,<,-4,133,129,>,4
26,10,25.0,23.0,>,2.0,0,0,=,0,75,69,>,6,49.333333333333336,45.333333333333336,>,4.0,31,39,<,-8,59,55,>,4,129,133,<,-4
0,10,23.0,3.6666666666666665,>,19.333333333333332,0,0,=,0,69,11,>,58,45.333333333333336,49.333333333333336,<,-4.0,39,40,<,-1,55,60,<,-5,133,142,<,-9
27,10,3.6666666666666665,23.0,<,-19.333333333333332,0,0,=,0,11,69,<,-58,49.333333333333336,45.333333333333336,>,4.0,40,39,>,1,60,55,>,5,142,133,>,9
0,10,23.0,30.0,<,-7.0,0,0,=,0,69,90,<,-21,45.333333333333336,38.666666666666664,>,6.666666666666671,39,36,>,3,55,41,>,14,133,174,<,-41
61,10,30.0,23.0,>,7.0,0,0,=,0,90,69,>,21,38.666666666666664,45.333333333333336,<,-6.666666666666671,36,39,<,-3,41,55,<,-14,174,133,>,41
0,10,23.0,9.0,>,14.0,0,0,=,0,69,27,>,42,45.333333333333336,49.333333333333336,<,-4.0,39,32,>,7,55,59,<,-4,133,148,<,-15
10,10,9.0,23.0,<,-14.0,0,0,=,0,27,69,<,-42,49.333333333333336,45.333333333333336,>,4.0,32,39,<,-7,59,55,>,4,148,133,>,15
0,9,31.333333333333332,26.0,>,5.333333333333332,0,0,=,0,48,68,<,-20,43.666666666666664,49.666666666666664,<,-6.0,39,42,<,-3,52,54,<,-2,63,131,<,-68
0,9,26.0,31.333333333333332,<,-5.333333333333332,0,0,=,0,68,48,>,20,49.666666666666664,43.666666666666664,>,6.0,42,39,>,3,54,52,>,2,131,63,>,68
0,9,31.333333333333332,21.333333333333332,>,10.0,0,0,=,0,48,32,>,16,43.666666666666664,43.0,>,0.6666666666666643,39,37,>,2,52,53,<,-1,63,101,<,-38
0,9,21.333333333333332,31.333333333333332,<,-10.0,0,0,=,0,32,48,<,-16,43.0,43.666666666666664,<,-0.6666666666666643,37,39,<,-2,53,52,>,1,101,63,>,38
0,9,31.333333333333332,36.0,<,-4.666666666666668,0,0,=,0,48,81,<,-33,43.666666666666664,49.333333333333336,<,-5.666666666666671,39,32,>,7,52,59,<,-7,63,148,<,-85
37,9,36.0,31.333333333333332,>,4.666666666666668,0,0,=,0,81,48,>,33,49.333333333333336,43.666666666666664,>,5.666666666666671,32,39,<,-7,59,52,>,7,148,63,>,85
0,9,31.333333333333332,25.0,>,6.333333333333332,0,0,=,0,48,45,>,3,43.666666666666664,40.666666666666664,>,3.0,39,33,>,6,52,56,<,-4,63,145,<,-82
71,9,25.0,31.333333333333332,<,-6.333333333333332,0,0,=,0,45,48,<,-3,40.666666666666664,43.666666666666664,<,-3.0,33,39,<,-6,56,52,>,4,145,63,>,82
0,9,31.333333333333332,38.333333333333336,<,-7.0000000000000036,0,0,=,0,48,75,<,-27,43.666666666666664,49.333333333333336,<,-5.666666666666671,39,31,>,8,52,59,<,-7,63,129,<,-66
73,9,38.333333333333336,31.333333333333332,>,7.0000000000000036,0,0,=,0,75,48,>,27,49.333333333333336,43.666666666666664,>,5.666666666666671,31,39,<,-8,59,52,>,7,129,63,>,66
0,9,31.333333333333332,11.0,>,20.333333333333332,0,0,=,0,48,22,>,26,43.666666666666664,49.333333333333336,<,-5.666666666666671,39,40,<,-1,52,60,<,-8,63,142,<,-79
78,9,11.0,31.333333333333332,<,-20.333333333333332,0,0,=,0,22,48,<,-26,49.333333333333336,43.666666666666664,>,5.666666666666671,40,39,>,1,60,52,>,8,142,63,>,79
0,9,31.333333333333332,52.666666666666664,<,-21.333333333333332,0,0,=,0,48,79,<,-31,43.666666666666664,40.666666666666664,>,3.0,39,35,>,4,52,45,>,7,63,154,<,-91
92,9,52.666666666666664,31.333333333333332,>,21.333333333333332,0,0,=,0,79,48,>,31,40.666666666666664,43.666666666666664,<,-3.0,35,39,<,-4,45,52,<,-7,154,63,>,91
0,9,31.333333333333332,41.0,<,-9.666666666666668,0,0,=,0,48,90,<,-42,43.666666666666664,38.666666666666664,>,5.0,39,36,>,3,52,41,>,11,63,174,<,-111
73,9,41.0,31.333333333333332,>,9.666666666666668,0,0,=,0,90,48,>,42,38.666666666666664,43.666666666666664,<,-5.0,36,39,<,-3,41,52,<,-11,174,63,>,111
0,8,41.0,46.666666666666664,<,-5.666666666666664,32,10,>,22,59,68,<,-9,43.0,49.666666666666664,<,-6.666666666666664,37,42,<,-5,53,54,<,-1,101,131,<,-30
0,8,46.666666666666664,41.0,>,5.666666666666664,10,32,<,-22,68,59,>,9,49.666666666666664,43.0,>,6.666666666666664,42,37,>,5,54,53,>,1,131,101,>,30
0,8,41.0,55.0,<,-14.0,32,27,>,5,59,81,<,-22,43.0,49.333333333333336,<,-6.333333333333336,37,32,>,5,53,59,<,-6,101,148,<,-47
37,8,55.0,41.0,>,14.0,27,32,<,-5,81,59,>,22,49.333333333333336,43.0,>,6.333333333333336,32,37,<,-5,59,53,>,6,148,101,>,47
0,8,41.0,31.333333333333332,>,9.666666666666668,32,19,>,13,59,45,>,14,43.0,40.666666666666664,>,2.3333333333333357,37,33,>,4,53,56,<,-3,101,145,<,-44
0,8,31.333333333333332,41.0,<,-9.666666666666668,19,32,<,-13,45,59,<,-14,40.666666666666664,43.0,<,-2.3333333333333357,33,37,<,-4,56,53,>,3,145,101,>,44
0,8,41.0,61.0,<,-20.0,32,40,<,-8,59,75,<,-16,43.0,49.333333333333336,<,-6.333333333333336,37,31,>,6,53,59,<,-6,101,129,<,-28
91,8,61.0,41.0,>,20.0,40,32,>,8,75,59,>,16,49.333333333333336,43.0,>,6.333333333333336,31,37,<,-6,59,53,>,6,129,101,>,28
0,8,41.0,62.333333333333336,<,-21.333333333333336,32,33,<,-1,59,90,<,-31,43.0,38.666666666666664,>,4.333333333333336,37,36,>,1,53,41,>,12,101,174,<,-73
73,8,62.333333333333336,41.0,>,21.333333333333336,33,32,>,1,90,59,>,31,38.666666666666664,43.0,<,-4.333333333333336,36,37,<,-1,41,53,<,-12,174,101,>,73
0,8,41.0,37.0,>,4.0,32,11,>,21,59,78,<,-19,43.0,49.333333333333336,<,-6.333333333333336,37,40,<,-3,53,60,<,-7,101,142,<,-41
78,8,37.0,41.0,<,-4.0,11,32,<,-21,78,59,>,19,49.333333333333336,43.0,>,6.333333333333336,40,37,>,3,60,53,>,7,142,101,>,41
0,8,41.0,75.0,<,-34.0,32,67,<,-35,59,79,<,-20,43.0,40.666666666666664,>,2.3333333333333357,37,35,>,2,53,45,>,8,101,154,<,-53
40,8,75.0,41.0,>,34.0,67,32,>,35,79,59,>,20,40.666666666666664,43.0,<,-2.3333333333333357,35,37,<,-2,45,53,<,-8,154,101,>,53
0,7,43.0,36.333333333333336,>,6.666666666666664,10,19,<,-9,62,45,>,17,49.666666666666664,40.666666666666664,>,9.0,42,33,>,9,54,56,<,-2,131,145,<,-14
0,7,36.333333333333336,43.0,<,-6.666666666666664,19,10,>,9,45,62,<,-17,40.666666666666664,49.666666666666664,<,-9.0,33,42,<,-9,56,54,>,2,145,131,>,14
0,7,43.0,56.333333333333336,<,-13.333333333333336,10,27,<,-17,62,85,<,-23,49.666666666666664,49.333333333333336,>,0.3333333333333286,42,32,>,10,54,59,<,-5,131,148,<,-17
37,7,56.333333333333336,43.0,>,13.333333333333336,27,10,>,17,85,62,>,23,49.333333333333336,49.666666666666664,<,-0.3333333333333286,32,42,<,-10,59,54,>,5,148,131,>,17
0,7,43.0,66.33333333333333,<,-23.33333333333333,10,53,<,-43,62,79,<,-17,49.666666666666664,40.666666666666664,>,9.0,42,35,>,7,54,45,>,9,131,154,<,-23
40,7,66.33333333333333,43.0,>,23.33333333333333,53,10,>,43,79,62,>,17,40.666666666666664,49.666666666666664,<,-9.0,35,42,<,-7,45,54,<,-9,154,131,>,23
0,7,43.0,58.0,<,-15.0,10,20,<,-10,62,90,<,-28,49.666666666666664,38.666666666666664,>,11.0,42,36,>,6,54,41,>,13,131,174,<,-43
0,7,58.0,43.0,>,15.0,20,10,>,10,90,62,>,28,38.666666666666664,49.666666666666664,<,-11.0,36,42,<,-6,41,54,<,-13,174,131,>,43
0,7,43.0,33.666666666666664,>,9.333333333333336,10,11,<,-1,62,78,<,-16,49.666666666666664,49.333333333333336,>,0.3333333333333286,42,40,>,2,54,60,<,-6,131,142,<,-11
16,7,33.666666666666664,43.0,<,-9.333333333333336,11,10,>,1,78,62,>,16,49.333333333333336,49.666666666666664,<,-0.3333333333333286,40,42,<,-2,60,54,>,6,142,131,>,11
0,7,43.0,77.66666666666667,<,-34.66666666666667,10,68,<,-58,62,90,<,-28,49.666666666666664,49.333333333333336,>,0.3333333333333286,42,31,>,11,54,59,<,-5,131,129,>,2
91,7,77.66666666666667,43.0,>,34.66666666666667,68,10,>,58,90,62,>,28,49.333333333333336,49.666666666666664,<,-0.3333333333333286,31,42,<,-11,59,54,>,5,129,131,<,-2
0,6,40.666666666666664,39.0,>,1.6666666666666643,20,19,>,1,64,53,>,11,38.666666666666664,40.666666666666664,<,-2.0,36,33,>,3,41,56,<,-15,174,145,>,29
0,6,39.0,40.666666666666664,<,-1.6666666666666643,19,20,<,-1,53,64,<,-11,40.666666666666664,38.666666666666664,>,2.0,33,36,<,-3,56,41,>,15,145,174,<,-29
0,6,40.666666666666664,35.666666666666664,>,5.0,20,12,>,8,64,78,<,-14,38.666666666666664,49.333333333333336,<,-10.666666666666671,36,40,<,-4,41,60,<,-19,174,142,>,32
16,6,35.666666666666664,40.666666666666664,<,-5.0,12,20,<,-8,78,64,>,14,49.333333333333336,38.666666666666664,>,10.666666666666671,40,36,>,4,60,41,>,19,142,174,<,-32
0,6,40.666666666666664,54.0,<,-13.333333333333336,20,20,=,0,64,85,<,-21,38.666666666666664,49.333333333333336,<,-10.666666666666671,36,32,>,4,41,59,<,-18,174,148,>,26
0,6,54.0,40.666666666666664,>,13.333333333333336,20,20,=,0,85,64,>,21,49.333333333333336,38.666666666666664,>,10.666666666666671,32,36,<,-4,59,41,>,18,148,174,<,-26
0,6,40.666666666666664,70.0,<,-29.333333333333336,20,53,<,-33,64,90,<,-26,38.666666666666664,40.666666666666664,<,-2.0,36,35,>,1,41,45,<,-4,174,154,>,20
40,6,70.0,40.666666666666664,>,29.333333333333336,53,20,>,33,90,64,>,26,40.666666666666664,38.666666666666664,>,2.0,35,36,<,-1,45,41,>,4,154,174,<,-20
0,6,40.666666666666664,63.666666666666664,<,-23.0,20,33,<,-13,64,90,<,-26,38.666666666666664,49.333333333333336,<,-10.666666666666671,36,31,>,5,41,59,<,-18,174,129,>,45
74,6,63.666666666666664,40.666666666666664,>,23.0,33,20,>,13,90,64,>,26,49.333333333333336,38.666666666666664,>,10.666666666666671,31,36,<,-5,59,41,>,18,129,174,<,-45
0,5,43.0,38.333333333333336,>,4.666666666666664,20,19,>,1,57,53,>,4,49.333333333333336,40.666666666666664,>,8.666666666666671,32,33,<,-1,59,56,>,3,148,145,>,3
0,5,38.333333333333336,43.0,<,-4.666666666666664,19,20,<,-1,53,57,<,-4,40.666666666666664,49.333333333333336,<,-8.666666666666671,33,32,>,1,56,59,<,-3,145,148,<,-3
0,5,43.0,43.0,=,0.0,20,17,>,3,57,78,<,-21,49.333333333333336,49.333333333333336,=,0.0,32,40,<,-8,59,60,<,-1,148,142,>,6
28,5,43.0,43.0,=,0.0,17,20,<,-3,78,57,>,21,49.333333333333336,49.333333333333336,=,0.0,40,32,>,8,60,59,>,1,142,148,<,-6
0,5,43.0,59.666666666666664,<,-16.666666666666664,20,22,<,-2,57,90,<,-33,49.333333333333336,40.666666666666664,>,8.666666666666671,32,35,<,-3,59,45,>,14,148,154,<,-6
0,5,59.666666666666664,43.0,>,16.666666666666664,22,20,>,2,90,57,>,33,40.666666666666664,49.333333333333336,<,-8.666666666666671,35,32,>,3,45,59,<,-14,154,148,>,6
0,5,43.0,47.333333333333336,<,-4.333333333333336,20,33,<,-13,57,68,<,-11,49.333333333333336,49.333333333333336,=,0.0,32,31,>,1,59,59,=,0,148,129,>,19
33,5,47.333333333333336,43.0,>,4.333333333333336,33,20,>,13,68,57,>,11,49.333333333333336,49.333333333333336,=,0.0,31,32,<,-1,59,59,=,0,129,148,<,-19
0,4,34.333333333333336,32.0,>,2.3333333333333357,14,19,<,-5,67,43,>,24,40.666666666666664,40.666666666666664,=,0.0,35,33,>,2,45,56,<,-11,154,145,>,9
0,4,32.0,34.333333333333336,<,-2.3333333333333357,19,14,>,5,43,67,<,-24,40.666666666666664,40.666666666666664,=,0.0,33,35,<,-2,56,45,>,11,145,154,<,-9
0,4,34.333333333333336,66.66666666666667,<,-32.333333333333336,14,34,<,-20,67,88,<,-21,40.666666666666664,49.333333333333336,<,-8.666666666666671,35,40,<,-5,45,60,<,-15,154,142,>,12
28,4,66.66666666666667,34.333333333333336,>,32.333333333333336,34,14,>,20,88,67,>,21,49.333333333333336,40.666666666666664,>,8.666666666666671,40,35,>,5,60,45,>,15,142,154,<,-12
0,4,34.333333333333336,47.666666666666664,<,-13.333333333333329,14,34,<,-20,67,68,<,-1,40.666666666666664,49.333333333333336,<,-8.666666666666671,35,31,>,4,45,59,<,-14,154,129,>,25
0,4,47.666666666666664,34.333333333333336,>,13.333333333333329,34,14,>,20,68,67,>,1,49.333333333333336,40.666666666666664,>,8.666666666666671,31,35,<,-4,59,45,>,14,129,154,<,-25
0,3,45.0,24.0,>,21.0,33,19,>,14,68,34,>,34,49.333333333333336,40.666666666666664,>,8.666666666666671,31,33,<,-2,59,56,>,3,129,145,<,-16
0,3,24.0,45.0,<,-21.0,19,33,<,-14,34,68,<,-34,40.666666666666664,49.333333333333336,<,-8.666666666666671,33,31,>,2,56,59,<,-3,145,129,>,16
0,3,45.0,64.0,<,-19.0,33,26,>,7,68,88,<,-20,49.333333333333336,49.333333333333336,=,0.0,31,40,<,-9,59,60,<,-1,129,142,<,-13
87,3,64.0,45.0,>,19.0,26,33,<,-7,88,68,>,20,49.333333333333336,49.333333333333336,=,0.0,40,31,>,9,60,59,>,1,142,129,>,13
0,2,30.666666666666668,63.333333333333336,<,-32.66666666666667,19,26,<,-7,54,86,<,-32,40.666666666666664,49.333333333333336,<,-8.666666666666671,33,40,<,-7,56,60,<,-4,145,142,>,3
87,2,63.333333333333336,30.666666666666668,>,32.66666666666667,26,19,>,7,86,54,>,32,49.333333333333336,40.666666666666664,>,8.666666666666671,40,33,>,7,60,56,>,4,142,145,<,-3
0,17,0.0,0.0,=,0.0,0,0,=,0,0,0,=,0,42.666666666666664,47.0,<,-4.333333333333336,38,31,>,7,51,56,<,-5,181,143,>,38
31,17,0.0,0.0,=,0.0,0,0,=,0,0,0,=,0,47.0,42.666666666666664,>,4.333333333333336,31,38,<,-7,56,51,>,5,143,181,<,-38
0,17,0.0,0.0,=,0.0,0,0,=,0,0,0,=,0,42.666666666666664,47.333333333333336,<,-4.666666666666671,38,37,>,1,51,57,<,-6,181,257,<,-76
45,17,0.0,0.0,=,0.0,0,0,=,0,0,0,=,0,47.333333333333336,42.666666666666664,>,4.666666666666671,37,38,<,-1,57,51,>,6,257,181,>,76
0,17,0.0,0.0,=,0.0,0,0,=,0,0,0,=,0,42.666666666666664,35.333333333333336,>,7.333333333333329,38,31,>,7,51,40,>,11,181,143,>,38
34,17,0.0,0.0,=,0.0,0,0,=,0,0,0,=,0,35.333333333333336,42.666666666666664,<,-7.333333333333329,31,38,<,-7,40,51,<,-11,143,181,<,-38
0,17,0.0,0.0,=,0.0,0,0,=,0,0,0,=,0,42.666666666666664,40.666666666666664,>,2.0,38,33,>,5,51,47,>,4,181,240,<,-59
80,17,0.0,0.0,=,0.0,0,0,=,0,0,0,=,0,40.666666666666664,42.666666666666664,<,-2.0,33,38,<,-5,47,51,<,-4,240,181,>,59
0,17,0.0,0.0,=,0.0,0,0,=,0,0,0,=,0,42.666666666666664,41.333333333333336,>,1.3333333333333286,38,35,>,3,51,49,>,2,181,191,<,-10
49,17,0.0,0.0,=,0.0,0,0,=,0,0,0,=,0,41.333333333333336,42.666666666666664,<,-1.3333333333333286,35,38,<,-3,49,51,<,-2,191,181,>,10
0,17,0.0,0.0,=,0.0,0,0,=,0,0,0,=,0,42.666666666666664,40.333333333333336,>,2.3333333333333286,38,34,>,4,51,45,>,6,181,192,<,-11
29,17,0.0,0.0,=,0.0,0,0,=,0,0,0,=,0,40.333333333333336,42.666666666666664,<,-2.3333333333333286,34,38,<,-4,45,51,<,-6,192,181,>,11
0,17,0.0,0.0,=,0.0,0,0,=,0,0,0,=,0,42.666666666666664,54.333333333333336,<,-11.666666666666671,38,48,<,-10,51,59,<,-8,181,172,>,9
72,17,0.0,0.0,=,0.0,0,0,=,0,0,0,=,0,54.333333333333336,42.666666666666664,>,11.666666666666671,48,38,>,10,59,51,>,8,172,181,<,-9
0,17,0.0,0.0,=,0.0,0,0,=,0,0,0,=,0,42.666666666666664,37.666666666666664,>,5.0,38,33,>,5,51,46,>,5,181,157,>,24
31,17,0.0,0.0,=,0.0,0,0,=,0,0,0,=,0,37.666666666666664,42.666666666666664,<,-5.0,33,38,<,-5,46,51,<,-5,157,181,<,-24
0,17,0.0,0.0,=,0.0,0,0,=,0,0,0,=,0,42.666666666666664,39.333333333333336,>,3.3333333333333286,38,35,>,3,51,42,>,9,181,150,>,31
47,17,0.0,0.0,=,0.0,0,0,=,0,0,0,=,0,39.333333333333336,42.666666666666664,<,-3.3333333333333286,35,38,<,-3,42,51,<,-9,150,181,<,-31
0,17,0.0,0.0,=,0.0,0,0,=,0,0,0,=,0,42.666666666666664,41.666666666666664,>,1.0,38,34,>,4,51,48,>,3,181,242,<,-61
67,17,0.0,0.0,=,0.0,0,0,=,0,0,0,=,0,41.666666666666664,42.666666666666664,<,-1.0,34,38,<,-4,48,51,<,-3,242,181,>,61
0,17,0.0,0.0,=,0.0,0,0,=,0,0,0,=,0,42.666666666666664,46.333333333333336,<,-3.6666666666666714,38,32,>,6,51,56,<,-5,181,209,<,-28
57,17,0.0,0.0,=,0.0,0,0,=,0,0,0,=,0,46.333333333333336,42.666666666666664,>,3.6666666666666714,32,38,<,-6,56,51,>,5,209,181,>,28
0,17,0.0,0.0,=,0.0,0,0,=,0,0,0,=,0,42.666666666666664,33.333333333333336,>,9.333333333333329,38,30,>,8,51,36,>,15,181,143,>,38
31,17,0.0,0.0,=,0.0,0,0,=,0,0,0,=,0,33.333333333333336,42.666666666666664,<,-9.333333333333329,30,38,<,-8,36,51,<,-15,143,181,<,-38
0,17,0.0,0.0,=,0.0,0,0,=,0,0,0,=,0,42.666666666666664,46.0,<,-3.3333333333333357,38,38,=,0,51,60,<,-9,181,117,>,64
6,17,0.0,0.0,=,0.0,0,0,=,0,0,0,=,0,46.0,42.666666666666664,>,3.3333333333333357,38,38,=,0,60,51,>,9,117,181,<,-64
0,17,0.0,0.0,=,0.0,0,0,=,0,0,0,=,0,42.666666666666664,45.666666666666664,<,-3.0,38,36,>,2,51,55,<,-4,181,153,>,28
42,17,0.0,0.0,=,0.0,0,0,=,0,0,0,=,0,45.666666666666664,42.666666666666664,>,3.0,36,38,<,-2,55,51,>,4,153,181,<,-28
0,17,0.0,0.0,=,0.0,0,0,=,0,0,0,=,0,42.666666666666664,46.0,<,-3.3333333333333357,38,36,>,2,51,54,<,-3,181,208,<,-27
74,17,0.0,0.0,=,0.0,0,0,=,0,0,0,=,0,46.0,42.666666666666664,>,3.3333333333333357,36,38,<,-2,54,51,>,3,208,181,>,27
0,17,0.0,0.0,=,0.0,0,0,=,0,0,0,=,0,42.666666666666664,46.666666666666664,<,-4.0,38,37,>,1,51,56,<,-5,181,267,<,-86
76,17,0.0,0.0,=,0.0,0,0,=,0,0,0,=,0,46.666666666666664,42.666666666666664,>,4.0,37,38,<,-1,56,51,>,5,267,181,>,86
0,16,29.666666666666668,14.0,>,15.666666666666668,0,0,=,0,89,42,>,47,46.0,40.333333333333336,>,5.666666666666664,38,34,>,4,60,45,>,15,117,192,<,-75
122,16,14.0,29.666666666666668,<,-15.666666666666668,0,0,=,0,42,89,<,-47,40.333333333333336,46.0,<,-5.666666666666664,34,38,<,-4,45,60,<,-15,192,117,>,75
0,16,29.666666666666668,6.0,>,23.666666666666668,0,0,=,0,89,18,>,71,46.0,47.0,<,-1.0,38,31,>,7,60,56,>,4,117,143,<,-26
0,16,6.0,29.666666666666668,<,-23.666666666666668,0,0,=,0,18,89,<,-71,47.0,46.0,>,1.0,31,38,<,-7,56,60,<,-4,143,117,>,26
0,16,29.666666666666668,13.666666666666666,>,16.0,0,0,=,0,89,41,>,48,46.0,37.666666666666664,>,8.333333333333336,38,33,>,5,60,46,>,14,117,157,<,-40
0,16,13.666666666666666,29.666666666666668,<,-16.0,0,0,=,0,41,89,<,-48,37.666666666666664,46.0,<,-8.333333333333336,33,38,<,-5,46,60,<,-14,157,117,>,40
0,16,29.666666666666668,29.666666666666668,=,0.0,0,0,=,0,89,89,=,0,46.0,33.333333333333336,>,12.666666666666664,38,30,>,8,60,36,>,24,117,143,<,-26
65,16,29.666666666666668,29.666666666666668,=,0.0,0,0,=,0,89,89,=,0,33.333333333333336,46.0,<,-12.666666666666664,30,38,<,-8,36,60,<,-24,143,117,>,26
0,16,29.666666666666668,14.0,>,15.666666666666668,0,0,=,0,89,42,>,47,46.0,35.333333333333336,>,10.666666666666664,38,31,>,7,60,40,>,20,117,143,<,-26
77,16,14.0,29.666666666666668,<,-15.666666666666668,0,0,=,0,42,89,<,-47,35.333333333333336,46.0,<,-10.666666666666664,31,38,<,-7,40,60,<,-20,143,117,>,26
0,16,29.666666666666668,21.0,>,8.666666666666668,0,0,=,0,89,63,>,26,46.0,45.666666666666664,>,0.3333333333333357,38,36,>,2,60,55,>,5,117,153,<,-36
139,16,21.0,29.666666666666668,<,-8.666666666666668,0,0,=,0,63,89,<,-26,45.666666666666664,46.0,<,-0.3333333333333357,36,38,<,-2,55,60,<,-5,153,117,>,36
0,16,29.666666666666668,17.666666666666668,>,12.0,0,0,=,0,89,53,>,36,46.0,47.333333333333336,<,-1.3333333333333357,38,37,>,1,60,57,>,3,117,257,<,-140
129,16,17.666666666666668,29.666666666666668,<,-12.0,0,0,=,0,53,89,<,-36,47.333333333333336,46.0,>,1.3333333333333357,37,38,<,-1,57,60,<,-3,257,117,>,140
0,16,29.666666666666668,21.666666666666668,>,8.0,0,0,=,0,89,65,>,24,46.0,39.333333333333336,>,6.666666666666664,38,35,>,3,60,42,>,18,117,150,<,-33
110,16,21.666666666666668,29.666666666666668,<,-8.0,0,0,=,0,65,89,<,-24,39.333333333333336,46.0,<,-6.666666666666664,35,38,<,-3,42,60,<,-18,150,117,>,33
0,16,29.666666666666668,18.666666666666668,>,11.0,0,0,=,0,89,56,>,33,46.0,41.333333333333336,>,4.666666666666664,38,35,>,3,60,49,>,11,117,191,<,-74
77,16,18.666666666666668,29.666666666666668,<,-11.0,0,0,=,0,56,89,<,-33,41.333333333333336,46.0,<,-4.666666666666664,35,38,<,-3,49,60,<,-11,191,117,>,74
0,16,29.666666666666668,22.0,>,7.666666666666668,0,0,=,0,89,66,>,23,46.0,46.333333333333336,<,-0.3333333333333357,38,32,>,6,60,56,>,4,117,209,<,-92
68,16,22.0,29.666666666666668,<,-7.666666666666668,0,0,=,0,66,89,<,-23,46.333333333333336,46.0,>,0.3333333333333357,32,38,<,-6,56,60,<,-4,209,117,>,92
0,16,29.666666666666668,23.0,>,6.666666666666668,0,0,=,0,89,69,>,20,46.0,41.666666666666664,>,4.333333333333336,38,34,>,4,60,48,>,12,117,242,<,-125
127,16,23.0,29.666666666666668,<,-6.666666666666668,0,0,=,0,69,89,<,-20,41.666666666666664,46.0,<,-4.333333333333336,34,38,<,-4,48,60,<,-12,242,117,>,125
0,16,29.666666666666668,7.333333333333333,>,22.333333333333336,0,0,=,0,89,22,>,67,46.0,54.333333333333336,<,-8.333333333333336,38,48,<,-10,60,59,>,1,117,172,<,-55
69,16,7.333333333333333,29.666666666666668,<,-22.333333333333336,0,0,=,0,22,89,<,-67,54.333333333333336,46.0,>,8.333333333333336,48,38,>,10,59,60,<,-1,172,117,>,55
0,16,29.666666666666668,28.666666666666668,>,1.0,0,0,=,0,89,86,>,3,46.0,46.0,=,0.0,38,36,>,2,60,54,>,6,117,208,<,-91
138,16,28.666666666666668,29.666666666666668,<,-1.0,0,0,=,0,86,89,<,-3,46.0,46.0,=,0.0,36,38,<,-2,54,60,<,-6,208,117,>,91
0,16,29.666666666666668,28.333333333333332,>,1.3333333333333357,0,0,=,0,89,85,>,4,46.0,46.666666666666664,<,-0.6666666666666643,38,37,>,1,60,56,>,4,117,267,<,-150
98,16,28.333333333333332,29.666666666666668,<,-1.3333333333333357,0,0,=,0,85,89,<,-4,46.666666666666664,46.0,>,0.6666666666666643,37,38,<,-1,56,60,<,-4,267,117,>,150
0,16,29.666666666666668,9.666666666666666,>,20.0,0,0,=,0,89,29,>,60,46.0,40.666666666666664,>,5.333333333333336,38,33,>,5,60,47,>,13,117,240,<,-123
105,16,9.666666666666666,29.666666666666668,<,-20.0,0,0,=,0,29,89,<,-60,40.666666666666664,46.0,<,-5.333333333333336,33,38,<,-5,47,60,<,-13,240,117,>,123
0,15,33.333333333333336,38.666666666666664,<,-5.333333333333329,0,0,=,0,82,75,>,7,47.0,37.666666666666664,>,9.333333333333336,31,33,<,-2,56,46,>,10,143,157,<,-14
0,15,38.666666666666664,33.333333333333336,>,5.333333333333329,0,0,=,0,75,82,<,-7,37.666666666666664,47.0,<,-9.333333333333336,33,31,>,2,46,56,<,-10,157,143,>,14
0,15,33.333333333333336,43.333333333333336,<,-10.0,0,0,=,0,82,89,<,-7,47.0,33.333333333333336,>,13.666666666666664,31,30,>,1,56,36,>,20,143,143,=,0
69,15,43.333333333333336,33.333333333333336,>,10.0,0,0,=,0,89,82,>,7,33.333333333333336,47.0,<,-13.666666666666664,30,31,<,-1,36,56,<,-20,143,143,=,0
0,15,33.333333333333336,51.666666666666664,<,-18.33333333333333,0,0,=,0,82,89,<,-7,47.0,46.333333333333336,>,0.6666666666666643,31,32,<,-1,56,56,=,0,143,209,<,-66
201,15,51.666666666666664,33.333333333333336,>,18.33333333333333,0,0,=,0,89,82,>,7,46.333333333333336,47.0,<,-0.6666666666666643,32,31,>,1,56,56,=,0,209,143,>,66
0,15,33.333333333333336,28.666666666666668,>,4.666666666666668,0,0,=,0,82,64,>,18,47.0,54.333333333333336,<,-7.333333333333336,31,48,<,-17,56,59,<,-3,143,172,<,-29
58,15,28.666666666666668,33.333333333333336,<,-4.666666666666668,0,0,=,0,64,82,<,-18,54.333333333333336,47.0,>,7.333333333333336,48,31,>,17,59,56,>,3,172,143,>,29
0,15,33.333333333333336,18.333333333333332,>,15.000000000000004,0,0,=,0,82,42,>,40,47.0,35.333333333333336,>,11.666666666666664,31,31,=,0,56,40,>,16,143,143,=,0
68,15,18.333333333333332,33.333333333333336,<,-15.000000000000004,0,0,=,0,42,82,<,-40,35.333333333333336,47.0,<,-11.666666666666664,31,31,=,0,40,56,<,-16,143,143,=,0
0,15,33.333333333333336,24.666666666666668,>,8.666666666666668,0,0,=,0,82,56,>,26,47.0,41.333333333333336,>,5.666666666666664,31,35,<,-4,56,49,>,7,143,191,<,-48
58,15,24.666666666666668,33.333333333333336,<,-8.666666666666668,0,0,=,0,56,82,<,-26,41.333333333333336,47.0,<,-5.666666666666664,35,31,>,4,49,56,<,-7,191,143,>,48
0,15,33.333333333333336,41.333333333333336,<,-8.0,0,0,=,0,82,85,<,-3,47.0,46.666666666666664,>,0.3333333333333357,31,37,<,-6,56,56,=,0,143,267,<,-124
98,15,41.333333333333336,33.333333333333336,>,8.0,0,0,=,0,85,82,>,3,46.666666666666664,47.0,<,-0.3333333333333357,37,31,>,6,56,56,=,0,267,143,>,124
0,15,33.333333333333336,26.666666666666668,>,6.666666666666668,0,0,=,0,82,51,>,31,47.0,40.666666666666664,>,6.333333333333336,31,33,<,-2,56,47,>,9,143,240,<,-97
105,15,26.666666666666668,33.333333333333336,<,-6.666666666666668,0,0,=,0,51,82,<,-31,40.666666666666664,47.0,<,-6.333333333333336,33,31,>,2,47,56,<,-9,240,143,>,97
0,15,33.333333333333336,40.333333333333336,<,-7.0,0,0,=,0,82,65,>,17,47.0,39.333333333333336,>,7.666666666666664,31,35,<,-4,56,42,>,14,143,150,<,-7
126,15,40.333333333333336,33.333333333333336,>,7.0,0,0,=,0,65,82,<,-17,39.333333333333336,47.0,<,-7.666666666666664,35,31,>,4,42,56,<,-14,150,143,>,7
0,15,33.333333333333336,24.0,>,9.333333333333336,0,0,=,0,82,42,>,40,47.0,40.333333333333336,>,6.666666666666664,31,34,<,-3,56,45,>,11,143,192,<,-49
122,15,24.0,33.333333333333336,<,-9.333333333333336,0,0,=,0,42,82,<,-40,40.333333333333336,47.0,<,-6.666666666666664,34,31,>,3,45,56,<,-11,192,143,>,49
0,15,33.333333333333336,51.666666666666664,<,-18.33333333333333,0,0,=,0,82,86,<,-4,47.0,41.666666666666664,>,5.333333333333336,31,34,<,-3,56,48,>,8,143,242,<,-99
206,15,51.666666666666664,33.333333333333336,>,18.33333333333333,0,0,=,0,86,82,>,4,41.666666666666664,47.0,<,-5.333333333333336,34,31,>,3,48,56,<,-8,242,143,>,99
0,15,33.333333333333336,43.333333333333336,<,-10.0,0,0,=,0,82,77,>,5,47.0,47.333333333333336,<,-0.3333333333333357,31,37,<,-6,56,57,<,-1,143,257,<,-114
229,15,43.333333333333336,33.333333333333336,>,10.0,0,0,=,0,77,82,<,-5,47.333333333333336,47.0,>,0.3333333333333357,37,31,>,6,57,56,>,1,257,143,>,114
0,15,33.333333333333336,33.666666666666664,<,-0.3333333333333286,0,0,=,0,82,86,<,-4,47.0,46.0,>,1.0,31,36,<,-5,56,54,>,2,143,208,<,-65
94,15,33.666666666666664,33.333333333333336,>,0.3333333333333286,0,0,=,0,86,82,>,4,46.0,47.0,<,-1.0,36,31,>,5,54,56,<,-2,208,143,>,65
0,15,33.333333333333336,41.0,<,-7.666666666666664,0,0,=,0,82,63,>,19,47.0,45.666666666666664,>,1.3333333333333357,31,36,<,-5,56,55,>,1,143,153,<,-10
171,15,41.0,33.333333333333336,>,7.666666666666664,0,0,=,0,63,82,<,-19,45.666666666666664,47.0,<,-1.3333333333333357,36,31,>,5,55,56,<,-1,153,143,>,10
0,14,61.333333333333336,49.0,>,12.333333333333336,41,18,>,23,75,73,>,2,37.666666666666664,41.333333333333336,<,-3.6666666666666714,33,35,<,-2,46,49,<,-3,157,191,<,-34
58,14,49.0,61.333333333333336,<,-12.333333333333336,18,41,<,-23,73,75,<,-2,41.333333333333336,37.666666666666664,>,3.6666666666666714,35,33,>,2,49,46,>,3,191,157,>,34
0,14,61.333333333333336,32.0,>,29.333333333333336,41,10,>,31,75,64,>,11,37.666666666666664,54.333333333333336,<,-16.66666666666667,33,48,<,-15,46,59,<,-13,157,172,<,-15
58,14,32.0,61.333333333333336,<,-29.333333333333336,10,41,<,-31,64,75,<,-11,54.333333333333336,37.666666666666664,>,16.66666666666667,48,33,>,15,59,46,>,13,172,157,>,15
0,14,61.333333333333336,35.0,>,26.333333333333336,41,13,>,28,75,50,>,25,37.666666666666664,35.333333333333336,>,2.3333333333333286,33,31,>,2,46,40,>,6,157,143,>,14
0,14,35.0,61.333333333333336,<,-26.333333333333336,13,41,<,-28,50,75,<,-25,35.333333333333336,37.666666666666664,<,-2.3333333333333286,31,33,<,-2,40,46,<,-6,143,157,<,-14
0,14,61.333333333333336,61.333333333333336,=,0.0,41,41,=,0,75,89,<,-14,37.666666666666664,33.333333333333336,>,4.333333333333329,33,30,>,3,46,36,>,10,157,143,>,14
69,14,61.333333333333336,61.333333333333336,=,0.0,41,41,=,0,89,75,>,14,33.333333333333336,37.666666666666664,<,-4.333333333333329,30,33,<,-3,36,46,<,-10,143,157,<,-14
0,14,61.333333333333336,53.0,>,8.333333333333336,41,15,>,26,75,86,<,-11,37.666666666666664,46.0,<,-8.333333333333336,33,36,<,-3,46,54,<,-8,157,208,<,-51
94,14,53.0,61.333333333333336,<,-8.333333333333336,15,41,<,-26,86,75,>,11,46.0,37.666666666666664,>,8.333333333333336,36,33,>,3,54,46,>,8,208,157,>,51
0,14,61.333333333333336,64.0,<,-2.6666666666666643,41,39,>,2,75,85,<,-10,37.666666666666664,46.666666666666664,<,-9.0,33,37,<,-4,46,56,<,-10,157,267,<,-110
199,14,64.0,61.333333333333336,>,2.6666666666666643,39,41,<,-2,85,75,>,10,46.666666666666664,37.666666666666664,>,9.0,37,33,>,4,56,46,>,10,267,157,>,110
0,14,61.333333333333336,55.0,>,6.333333333333336,41,29,>,12,75,85,<,-10,37.666666666666664,40.666666666666664,<,-3.0,33,33,=,0,46,47,<,-1,157,240,<,-83
108,14,55.0,61.333333333333336,<,-6.333333333333336,29,41,<,-12,85,75,>,10,40.666666666666664,37.666666666666664,>,3.0,33,33,=,0,47,46,>,1,240,157,>,83
0,14,61.333333333333336,47.333333333333336,>,14.0,41,30,>,11,75,70,>,5,37.666666666666664,40.333333333333336,<,-2.6666666666666714,33,34,<,-1,46,45,>,1,157,192,<,-35
144,14,47.333333333333336,61.333333333333336,<,-14.0,30,41,<,-11,70,75,<,-5,40.333333333333336,37.666666666666664,>,2.6666666666666714,34,33,>,1,45,46,<,-1,192,157,>,35
0,14,61.333333333333336,44.666666666666664,>,16.66666666666667,41,13,>,28,75,65,>,10,37.666666666666664,39.333333333333336,<,-1.6666666666666714,33,35,<,-2,46,42,>,4,157,150,>,7
88,14,44.666666666666664,61.333333333333336,<,-16.66666666666667,13,41,<,-28,65,75,<,-10,39.333333333333336,37.666666666666664,>,1.6666666666666714,35,33,>,2,42,46,<,-4,150,157,<,-7
0,14,61.333333333333336,45.333333333333336,>,16.0,41,13,>,28,75,63,>,12,37.666666666666664,45.666666666666664,<,-8.0,33,36,<,-3,46,55,<,-9,157,153,>,4
0,14,45.333333333333336,61.333333333333336,<,-16.0,13,41,<,-28,63,75,<,-12,45.666666666666664,37.666666666666664,>,8.0,36,33,>,3,55,46,>,9,153,157,<,-4
0,14,61.333333333333336,75.33333333333333,<,-13.999999999999993,41,66,<,-25,75,89,<,-14,37.666666666666664,46.333333333333336,<,-8.666666666666671,33,32,>,1,46,56,<,-10,157,209,<,-52
215,14,75.33333333333333,61.333333333333336,>,13.999999999999993,66,41,>,25,89,75,>,14,46.333333333333336,37.666666666666664,>,8.666666666666671,32,33,<,-1,56,46,>,10,209,157,>,52
0,14,61.333333333333336,66.0,<,-4.666666666666664,41,43,<,-2,75,86,<,-11,37.666666666666664,41.666666666666664,<,-4.0,33,34,<,-1,46,48,<,-2,157,242,<,-85
206,14,66.0,61.333333333333336,>,4.666666666666664,43,41,>,2,86,75,>,11,41.666666666666664,37.666666666666664,>,4.0,34,33,>,1,48,46,>,2,242,157,>,85
0,14,61.333333333333336,66.66666666666667,<,-5.333333333333336,41,53,<,-12,75,77,<,-2,37.666666666666664,47.333333333333336,<,-9.666666666666671,33,37,<,-4,46,57,<,-11,157,257,<,-100
229,14,66.66666666666667,61.333333333333336,>,5.333333333333336,53,41,>,12,77,75,>,2,47.333333333333336,37.666666666666664,>,9.666666666666671,37,33,>,4,57,46,>,11,257,157,>,100
0,13,28.333333333333332,30.333333333333332,<,-2.0,13,13,=,0,50,60,<,-10,35.333333333333336,45.666666666666664,<,-10.333333333333329,31,36,<,-5,40,55,<,-15,143,153,<,-10
0,13,30.333333333333332,28.333333333333332,>,2.0,13,13,=,0,60,50,>,10,45.666666666666664,35.333333333333336,>,10.333333333333329,36,31,>,5,55,40,>,15,153,143,>,10
0,13,28.333333333333332,46.0,<,-17.666666666666668,13,18,<,-5,50,73,<,-23,35.333333333333336,41.333333333333336,<,-6.0,31,35,<,-4,40,49,<,-9,143,191,<,-48
65,13,46.0,28.333333333333332,>,17.666666666666668,18,13,>,5,73,50,>,23,41.333333333333336,35.333333333333336,>,6.0,35,31,>,4,49,40,>,9,191,143,>,48
0,13,28.333333333333332,32.666666666666664,<,-4.333333333333332,13,10,>,3,50,64,<,-14,35.333333333333336,54.333333333333336,<,-19.0,31,48,<,-17,40,59,<,-19,143,172,<,-29
111,13,32.666666666666664,28.333333333333332,>,4.333333333333332,10,13,<,-3,64,50,>,14,54.333333333333336,35.333333333333336,>,19.0,48,31,>,17,59,40,>,19,172,143,>,29
0,13,28.333333333333332,44.333333333333336,<,-16.000000000000004,13,38,<,-25,50,54,<,-4,35.333333333333336,33.333333333333336,>,2.0,31,30,>,1,40,36,>,4,143,143,=,0
69,13,44.333333333333336,28.333333333333332,>,16.000000000000004,38,13,>,25,54,50,>,4,33.333333333333336,35.333333333333336,<,-2.0,30,31,<,-1,36,40,<,-4,143,143,=,0
0,13,28.333333333333332,42.333333333333336,<,-14.000000000000004,13,13,=,0,50,58,<,-8,35.333333333333336,39.333333333333336,<,-4.0,31,35,<,-4,40,42,<,-2,143,150,<,-7
98,13,42.333333333333336,28.333333333333332,>,14.000000000000004,13,13,=,0,58,50,>,8,39.333333333333336,35.333333333333336,>,4.0,35,31,>,4,42,40,>,2,150,143,>,7
0,13,28.333333333333332,44.333333333333336,<,-16.000000000000004,13,15,<,-2,50,60,<,-10,35.333333333333336,46.0,<,-10.666666666666664,31,36,<,-5,40,54,<,-14,143,208,<,-65
94,13,44.333333333333336,28.333333333333332,>,16.000000000000004,15,13,>,2,60,50,>,10,46.0,35.333333333333336,>,10.666666666666664,36,31,>,5,54,40,>,14,208,143,>,65
0,13,28.333333333333332,54.666666666666664,<,-26.333333333333332,13,28,<,-15,50,85,<,-35,35.333333333333336,40.666666666666664,<,-5.333333333333329,31,33,<,-2,40,47,<,-7,143,240,<,-97
105,13,54.666666666666664,28.333333333333332,>,26.333333333333332,28,13,>,15,85,50,>,35,40.666666666666664,35.333333333333336,>,5.333333333333329,33,31,>,2,47,40,>,7,240,143,>,97
0,13,28.333333333333332,37.0,<,-8.666666666666668,13,11,>,2,50,70,<,-20,35.333333333333336,40.333333333333336,<,-5.0,31,34,<,-3,40,45,<,-5,143,192,<,-49
0,13,37.0,28.333333333333332,>,8.666666666666668,11,13,<,-2,70,50,>,20,40.333333333333336,35.333333333333336,>,5.0,34,31,>,3,45,40,>,5,192,143,>,49
0,13,28.333333333333332,44.0,<,-15.666666666666668,13,25,<,-12,50,68,<,-18,35.333333333333336,46.666666666666664,<,-11.333333333333329,31,37,<,-6,40,56,<,-16,143,267,<,-124
114,13,44.0,28.333333333333332,>,15.666666666666668,25,13,>,12,68,50,>,18,46.666666666666664,35.333333333333336,>,11.333333333333329,37,31,>,6,56,40,>,16,267,143,>,124
0,13,28.333333333333332,73.0,<,-44.66666666666667,13,43,<,-30,50,90,<,-40,35.333333333333336,41.666666666666664,<,-6.333333333333329,31,34,<,-3,40,48,<,-8,143,242,<,-99
237,13,73.0,28.333333333333332,>,44.66666666666667,43,13,>,30,90,50,>,40,41.666666666666664,35.333333333333336,>,6.333333333333329,34,31,>,3,48,40,>,8,242,143,>,99
0,13,28.333333333333332,61.333333333333336,<,-33.0,13,24,<,-11,50,89,<,-39,35.333333333333336,46.333333333333336,<,-11.0,31,32,<,-1,40,56,<,-16,143,209,<,-66
92,13,61.333333333333336,28.333333333333332,>,33.0,24,13,>,11,89,50,>,39,46.333333333333336,35.333333333333336,>,11.0,32,31,>,1,56,40,>,16,209,143,>,66
0,13,28.333333333333332,59.333333333333336,<,-31.000000000000004,13,31,<,-18,50,77,<,-27,35.333333333333336,47.333333333333336,<,-12.0,31,37,<,-6,40,57,<,-17,143,257,<,-114
144,13,59.333333333333336,28.333333333333332,>,31.000000000000004,31,13,>,18,77,50,>,27,47.333333333333336,35.333333333333336,>,12.0,37,31,>,6,57,40,>,17,257,143,>,114
0,12,47.333333333333336,35.666666666666664,>,11.666666666666671,11,13,<,-2,70,76,<,-6,40.333333333333336,45.666666666666664,<,-5.333333333333329,34,36,<,-2,45,55,<,-10,192,153,>,39
0,12,35.666666666666664,47.333333333333336,<,-11.666666666666671,13,11,>,2,76,70,>,6,45.666666666666664,40.333333333333336,>,5.333333333333329,36,34,>,2,55,45,>,10,153,192,<,-39
0,12,47.333333333333336,65.66666666666667,<,-18.333333333333336,11,47,<,-36,70,77,<,-7,40.333333333333336,41.333333333333336,<,-1.0,34,35,<,-1,45,49,<,-4,192,191,>,1
143,12,65.66666666666667,47.333333333333336,>,18.333333333333336,47,11,>,36,77,70,>,7,41.333333333333336,40.333333333333336,>,1.0,35,34,>,1,49,45,>,4,191,192,<,-1
0,12,47.333333333333336,52.0,<,-4.666666666666664,11,38,<,-27,70,64,>,6,40.333333333333336,33.333333333333336,>,7.0,34,30,>,4,45,36,>,9,192,143,>,49
127,12,52.0,47.333333333333336,>,4.666666666666664,38,11,>,27,64,70,<,-6,33.333333333333336,40.333333333333336,<,-7.0,30,34,<,-4,36,45,<,-9,143,192,<,-49
0,12,47.333333333333336,51.666666666666664,<,-4.333333333333329,11,24,<,-13,70,71,<,-1,40.333333333333336,46.333333333333336,<,-6.0,34,32,>,2,45,56,<,-11,192,209,<,-17
92,12,51.666666666666664,47.333333333333336,>,4.333333333333329,24,11,>,13,71,70,>,1,46.333333333333336,40.333333333333336,>,6.0,32,34,<,-2,56,45,>,11,209,192,>,17
0,12,47.333333333333336,46.333333333333336,>,1.0,11,21,<,-10,70,60,>,10,40.333333333333336,46.0,<,-5.666666666666664,34,36,<,-2,45,54,<,-9,192,208,<,-16
109,12,46.333333333333336,47.333333333333336,<,-1.0,21,11,>,10,60,70,<,-10,46.0,40.333333333333336,>,5.666666666666664,36,34,>,2,54,45,>,9,208,192,>,16
0,12,47.333333333333336,44.333333333333336,>,3.0,11,13,<,-2,70,62,>,8,40.333333333333336,39.333333333333336,>,1.0,34,35,<,-1,45,42,>,3,192,150,>,42
116,12,44.333333333333336,47.333333333333336,<,-3.0,13,11,>,2,62,70,<,-8,39.333333333333336,40.333333333333336,<,-1.0,35,34,>,1,42,45,<,-3,150,192,<,-42
0,12,47.333333333333336,49.0,<,-1.6666666666666643,11,28,<,-17,70,85,<,-15,40.333333333333336,40.666666666666664,<,-0.3333333333333286,34,33,>,1,45,47,<,-2,192,240,<,-48
105,12,49.0,47.333333333333336,>,1.6666666666666643,28,11,>,17,85,70,>,15,40.666666666666664,40.333333333333336,>,0.3333333333333286,33,34,<,-1,47,45,>,2,240,192,>,48
0,12,47.333333333333336,18.333333333333332,>,29.000000000000004,11,10,>,1,70,24,>,46,40.333333333333336,54.333333333333336,<,-14.0,34,48,<,-14,45,59,<,-14,192,172,>,20
0,12,18.333333333333332,47.333333333333336,<,-29.000000000000004,10,11,<,-1,24,70,<,-46,54.333333333333336,40.333333333333336,>,14.0,48,34,>,14,59,45,>,14,172,192,<,-20
0,12,47.333333333333336,35.666666666666664,>,11.666666666666671,11,14,<,-3,70,68,>,2,40.333333333333336,46.666666666666664,<,-6.333333333333329,34,37,<,-3,45,56,<,-11,192,267,<,-75
56,12,35.666666666666664,47.333333333333336,<,-11.666666666666671,14,11,>,3,68,70,<,-2,46.666666666666664,40.333333333333336,>,6.333333333333329,37,34,>,3,56,45,>,11,267,192,>,75
0,12,47.333333333333336,58.666666666666664,<,-11.333333333333329,11,31,<,-20,70,75,<,-5,40.333333333333336,47.333333333333336,<,-7.0,34,37,<,-3,45,57,<,-12,192,257,<,-65
144,12,58.666666666666664,47.333333333333336,>,11.333333333333329,31,11,>,20,75,70,>,5,47.333333333333336,40.333333333333336,>,7.0,37,34,>,3,57,45,>,12,257,192,>,65
0,12,47.333333333333336,52.0,<,-4.666666666666664,11,23,<,-12,70,90,<,-20,40.333333333333336,41.666666666666664,<,-1.3333333333333286,34,34,=,0,45,48,<,-3,192,242,<,-50
115,12,52.0,47.333333333333336,>,4.666666666666664,23,11,>,12,90,70,>,20,41.666666666666664,40.333333333333336,>,1.3333333333333286,34,34,=,0,48,45,>,3,242,192,>,50
0,11,28.333333333333332,36.333333333333336,<,-8.000000000000004,10,13,<,-3,54,76,<,-22,54.333333333333336,45.666666666666664,>,8.666666666666671,48,36,>,12,59,55,>,4,172,153,>,19
0,11,36.333333333333336,28.333333333333332,>,8.000000000000004,13,10,>,3,76,54,>,22,45.666666666666664,54.333333333333336,<,-8.666666666666671,36,48,<,-12,55,59,<,-4,153,172,<,-19
0,11,28.333333333333332,47.666666666666664,<,-19.333333333333332,10,14,<,-4,54,68,<,-14,54.333333333333336,46.666666666666664,>,7.666666666666671,48,37,>,11,59,56,>,3,172,267,<,-95
56,11,47.666666666666664,28.333333333333332,>,19.333333333333332,14,10,>,4,68,54,>,14,46.666666666666664,54.333333333333336,<,-7.666666666666671,37,48,<,-11,56,59,<,-3,267,172,>,95
0,11,28.333333333333332,57.0,<,-28.666666666666668,10,40,<,-30,54,71,<,-17,54.333333333333336,46.333333333333336,>,8.0,48,32,>,16,59,56,>,3,172,209,<,-37
89,11,57.0,28.333333333333332,>,28.666666666666668,40,10,>,30,71,54,>,17,46.333333333333336,54.333333333333336,<,-8.0,32,48,<,-16,56,59,<,-3,209,172,>,37
0,11,28.333333333333332,46.666666666666664,<,-18.333333333333332,10,21,<,-11,54,85,<,-31,54.333333333333336,40.666666666666664,>,13.666666666666671,48,33,>,15,59,47,>,12,172,240,<,-68
0,11,46.666666666666664,28.333333333333332,>,18.333333333333332,21,10,>,11,85,54,>,31,40.666666666666664,54.333333333333336,<,-13.666666666666671,33,48,<,-15,47,59,<,-12,240,172,>,68
0,11,28.333333333333332,43.0,<,-14.666666666666668,10,21,<,-11,54,58,<,-4,54.333333333333336,46.0,>,8.333333333333336,48,36,>,12,59,54,>,5,172,208,<,-36
68,11,43.0,28.333333333333332,>,14.666666666666668,21,10,>,11,58,54,>,4,46.0,54.333333333333336,<,-8.333333333333336,36,48,<,-12,54,59,<,-5,208,172,>,36
0,11,28.333333333333332,38.666666666666664,<,-10.333333333333332,10,23,<,-13,54,50,>,4,54.333333333333336,41.666666666666664,>,12.666666666666671,48,34,>,14,59,48,>,11,172,242,<,-70
86,11,38.666666666666664,28.333333333333332,>,10.333333333333332,23,10,>,13,50,54,<,-4,41.666666666666664,54.333333333333336,<,-12.666666666666671,34,48,<,-14,48,59,<,-11,242,172,>,70
0,11,28.333333333333332,54.666666666666664,<,-26.333333333333332,10,13,<,-3,54,89,<,-35,54.333333333333336,39.333333333333336,>,15.0,48,35,>,13,59,42,>,17,172,150,>,22
116,11,54.666666666666664,28.333333333333332,>,26.333333333333332,13,10,>,3,89,54,>,35,39.333333333333336,54.333333333333336,<,-15.0,35,48,<,-13,42,59,<,-17,150,172,<,-22
0,11,28.333333333333332,50.666666666666664,<,-22.333333333333332,10,34,<,-24,54,64,<,-10,54.333333333333336,33.333333333333336,>,21.0,48,30,>,18,59,36,>,23,172,143,>,29
121,11,50.666666666666664,28.333333333333332,>,22.333333333333332,34,10,>,24,64,54,>,10,33.333333333333336,54.333333333333336,<,-21.0,30,48,<,-18,36,59,<,-23,143,172,<,-29
0,11,28.333333333333332,58.0,<,-29.666666666666668,10,24,<,-14,54,77,<,-23,54.333333333333336,41.333333333333336,>,13.0,48,35,>,13,59,49,>,10,172,191,<,-19
74,11,58.0,28.333333333333332,>,29.666666666666668,24,10,>,14,77,54,>,23,41.333333333333336,54.333333333333336,<,-13.0,35,48,<,-13,49,59,<,-10,191,172,>,19
0,11,28.333333333333332,71.66666666666667,<,-43.33333333333334,10,70,<,-60,54,75,<,-21,54.333333333333336,47.333333333333336,>,7.0,48,37,>,11,59,57,>,2,172,257,<,-85
134,11,71.66666666666667,28.333333333333332,>,43.33333333333334,70,10,>,60,75,54,>,21,47.333333333333336,54.333333333333336,<,-7.0,37,48,<,-11,57,59,<,-2,257,172,>,85
0,10,58.0,32.333333333333336,>,25.666666666666664,21,13,>,8,85,64,>,21,40.666666666666664,45.666666666666664,<,-5.0,33,36,<,-3,47,55,<,-8,240,153,>,87
0,10,32.333333333333336,58.0,<,-25.666666666666664,13,21,<,-8,64,85,<,-21,45.666666666666664,40.666666666666664,>,5.0,36,33,>,3,55,47,>,8,153,240,<,-87
0,10,58.0,65.66666666666667,<,-7.666666666666671,21,61,<,-40,85,68,>,17,40.666666666666664,46.666666666666664,<,-6.0,33,37,<,-4,47,56,<,-9,240,267,<,-27
72,10,65.66666666666667,58.0,>,7.666666666666671,61,21,>,40,68,85,<,-17,46.666666666666664,40.666666666666664,>,6.0,37,33,>,4,56,47,>,9,267,240,>,27
0,10,58.0,53.0,>,5.0,21,50,<,-29,85,58,>,27,40.666666666666664,46.0,<,-5.333333333333336,33,36,<,-3,47,54,<,-7,240,208,>,32
68,10,53.0,58.0,<,-5.0,50,21,>,29,58,85,<,-27,46.0,40.666666666666664,>,5.333333333333336,36,33,>,3,54,47,>,7,208,240,<,-32
0,10,58.0,57.0,>,1.0,21,24,<,-3,85,74,>,11,40.666666666666664,41.333333333333336,<,-0.6666666666666714,33,35,<,-2,47,49,<,-2,240,191,>,49
74,10,57.0,58.0,<,-1.0,24,21,>,3,74,85,<,-11,41.333333333333336,40.666666666666664,>,0.6666666666666714,35,33,>,2,49,47,>,2,191,240,<,-49
0,10,58.0,54.0,>,4.0,21,43,<,-22,85,69,>,16,40.666666666666664,41.666666666666664,<,-1.0,33,34,<,-1,47,48,<,-1,240,242,<,-2
86,10,54.0,58.0,<,-4.0,43,21,>,22,69,85,<,-16,41.666666666666664,40.666666666666664,>,1.0,34,33,>,1,48,47,>,1,242,240,>,2
0,10,58.0,54.0,>,4.0,21,40,<,-19,85,71,>,14,40.666666666666664,46.333333333333336,<,-5.666666666666671,33,32,>,1,47,56,<,-9,240,209,>,31
89,10,54.0,58.0,<,-4.0,40,21,>,19,71,85,<,-14,46.333333333333336,40.666666666666664,>,5.666666666666671,32,33,<,-1,56,47,>,9,209,240,<,-31
0,10,58.0,59.666666666666664,<,-1.6666666666666643,21,13,>,8,85,89,<,-4,40.666666666666664,39.333333333333336,>,1.3333333333333286,33,35,<,-2,47,42,>,5,240,150,>,90
148,10,59.666666666666664,58.0,>,1.6666666666666643,13,21,<,-8,89,85,>,4,39.333333333333336,40.666666666666664,<,-1.3333333333333286,35,33,>,2,42,47,<,-5,150,240,<,-90
0,10,58.0,32.666666666666664,>,25.333333333333336,21,10,>,11,85,54,>,31,40.666666666666664,33.333333333333336,>,7.333333333333329,33,30,>,3,47,36,>,11,240,143,>,97
0,10,32.666666666666664,58.0,<,-25.333333333333336,10,21,<,-11,54,85,<,-31,33.333333333333336,40.666666666666664,<,-7.333333333333329,30,33,<,-3,36,47,<,-11,143,240,<,-97
0,10,58.0,73.33333333333333,<,-15.333333333333329,21,70,<,-49,85,80,>,5,40.666666666666664,47.333333333333336,<,-6.666666666666671,33,37,<,-4,47,57,<,-10,240,257,<,-17
124,10,73.33333333333333,58.0,>,15.333333333333329,70,21,>,49,80,85,<,-5,47.333333333333336,40.666666666666664,>,6.666666666666671,37,33,>,4,57,47,>,10,257,240,>,17
0,9,44.666666666666664,46.333333333333336,<,-1.6666666666666714,10,13,<,-3,70,64,>,6,33.333333333333336,45.666666666666664,<,-12.333333333333329,30,36,<,-6,36,55,<,-19,143,153,<,-10
0,9,46.333333333333336,44.666666666666664,>,1.6666666666666714,13,10,>,3,64,70,<,-6,45.666666666666664,33.333333333333336,>,12.333333333333329,36,30,>,6,55,36,>,19,153,143,>,10
0,9,44.666666666666664,57.666666666666664,<,-13.0,10,51,<,-41,70,64,>,6,33.333333333333336,46.0,<,-12.666666666666664,30,36,<,-6,36,54,<,-18,143,208,<,-65
113,9,57.666666666666664,44.666666666666664,>,13.0,51,10,>,41,64,70,<,-6,46.0,33.333333333333336,>,12.666666666666664,36,30,>,6,54,36,>,18,208,143,>,65
0,9,44.666666666666664,60.333333333333336,<,-15.666666666666671,10,45,<,-35,70,68,>,2,33.333333333333336,46.666666666666664,<,-13.333333333333329,30,37,<,-7,36,56,<,-20,143,267,<,-124
69,9,60.333333333333336,44.666666666666664,>,15.666666666666671,45,10,>,35,68,70,<,-2,46.666666666666664,33.333333333333336,>,13.333333333333329,37,30,>,7,56,36,>,20,267,143,>,124
0,9,44.666666666666664,62.666666666666664,<,-18.0,10,41,<,-31,70,74,<,-4,33.333333333333336,41.333333333333336,<,-8.0,30,35,<,-5,36,49,<,-13,143,191,<,-48
115,9,62.666666666666664,44.666666666666664,>,18.0,41,10,>,31,74,70,>,4,41.333333333333336,33.333333333333336,>,8.0,35,30,>,5,49,36,>,13,191,143,>,48
0,9,44.666666666666664,40.666666666666664,>,4.0,10,10,=,0,70,69,>,1,33.333333333333336,41.666666666666664,<,-8.333333333333329,30,34,<,-4,36,48,<,-12,143,242,<,-99
0,9,40.666666666666664,44.666666666666664,<,-4.0,10,10,=,0,69,70,<,-1,41.666666666666664,33.333333333333336,>,8.333333333333329,34,30,>,4,48,36,>,12,242,143,>,99
0,9,44.666666666666664,70.33333333333333,<,-25.666666666666664,10,51,<,-41,70,89,<,-19,33.333333333333336,46.333333333333336,<,-13.0,30,32,<,-2,36,56,<,-20,143,209,<,-66
152,9,70.33333333333333,44.666666666666664,>,25.666666666666664,51,10,>,41,89,70,>,19,46.333333333333336,33.333333333333336,>,13.0,32,30,>,2,56,36,>,20,209,143,>,66
0,9,44.666666666666664,70.66666666666667,<,-26.000000000000007,10,62,<,-52,70,80,<,-10,33.333333333333336,47.333333333333336,<,-14.0,30,37,<,-7,36,57,<,-21,143,257,<,-114
122,9,70.66666666666667,44.666666666666664,>,26.000000000000007,62,10,>,52,80,70,>,10,47.333333333333336,33.333333333333336,>,14.0,37,30,>,7,57,36,>,21,257,143,>,114
0,9,44.666666666666664,54.333333333333336,<,-9.666666666666671,10,13,<,-3,70,77,<,-7,33.333333333333336,39.333333333333336,<,-6.0,30,35,<,-5,36,42,<,-6,143,150,<,-7
148,9,54.333333333333336,44.666666666666664,>,9.666666666666671,13,10,>,3,77,70,>,7,39.333333333333336,33.333333333333336,>,6.0,35,30,>,5,42,36,>,6,150,143,>,7
0,8,29.0,39.0,<,-10.0,10,13,<,-3,43,62,<,-19,41.666666666666664,45.666666666666664,<,-4.0,34,36,<,-2,48,55,<,-7,242,153,>,89
0,8,39.0,29.0,>,10.0,13,10,>,3,62,43,>,19,45.666666666666664,41.666666666666664,>,4.0,36,34,>,2,55,48,>,7,153,242,<,-89
0,8,29.0,59.333333333333336,<,-30.333333333333336,10,45,<,-35,43,68,<,-25,41.666666666666664,46.666666666666664,<,-5.0,34,37,<,-3,48,56,<,-8,242,267,<,-25
67,8,59.333333333333336,29.0,>,30.333333333333336,45,10,>,35,68,43,>,25,46.666666666666664,41.666666666666664,>,5.0,37,34,>,3,56,48,>,8,267,242,>,25
0,8,29.0,46.333333333333336,<,-17.333333333333336,10,17,<,-7,43,64,<,-21,41.666666666666664,46.0,<,-4.333333333333336,34,36,<,-2,48,54,<,-6,242,208,>,34
34,8,46.333333333333336,29.0,>,17.333333333333336,17,10,>,7,64,43,>,21,46.0,41.666666666666664,>,4.333333333333336,36,34,>,2,54,48,>,6,208,242,<,-34
0,8,29.0,65.33333333333333,<,-36.33333333333333,10,41,<,-31,43,82,<,-39,41.666666666666664,41.333333333333336,>,0.3333333333333286,34,35,<,-1,48,49,<,-1,242,191,>,51
110,8,65.33333333333333,29.0,>,36.33333333333333,41,10,>,31,82,43,>,39,41.333333333333336,41.666666666666664,<,-0.3333333333333286,35,34,>,1,49,48,>,1,191,242,<,-51
0,8,29.0,53.666666666666664,<,-24.666666666666664,10,29,<,-19,43,70,<,-27,41.666666666666664,47.333333333333336,<,-5.666666666666671,34,37,<,-3,48,57,<,-9,242,257,<,-15
0,8,53.666666666666664,29.0,>,24.666666666666664,29,10,>,19,70,43,>,27,47.333333333333336,41.666666666666664,>,5.666666666666671,37,34,>,3,57,48,>,9,257,242,>,15
0,8,29.0,40.0,<,-11.0,10,13,<,-3,43,73,<,-30,41.666666666666664,39.333333333333336,>,2.3333333333333286,34,35,<,-1,48,42,>,6,242,150,>,92
184,8,40.0,29.0,>,11.0,13,10,>,3,73,43,>,30,39.333333333333336,41.666666666666664,<,-2.3333333333333286,35,34,>,1,42,48,<,-6,150,242,<,-92
0,8,29.0,75.0,<,-46.0,10,65,<,-55,43,89,<,-46,41.666666666666664,46.333333333333336,<,-4.666666666666671,34,32,>,2,48,56,<,-8,242,209,>,33
91,8,75.0,29.0,>,46.0,65,10,>,55,89,43,>,46,46.333333333333336,41.666666666666664,>,4.666666666666671,32,34,<,-2,56,48,>,8,209,242,<,-33
0,7,46.666666666666664,48.333333333333336,<,-1.6666666666666714,29,13,>,16,70,90,<,-20,47.333333333333336,45.666666666666664,>,1.6666666666666714,37,36,>,1,57,55,>,2,257,153,>,104
0,7,48.333333333333336,46.666666666666664,>,1.6666666666666714,13,29,<,-16,90,70,>,20,45.666666666666664,47.333333333333336,<,-1.6666666666666714,36,37,<,-1,55,57,<,-2,153,257,<,-104
0,7,46.666666666666664,33.0,>,13.666666666666664,29,17,>,12,70,58,>,12,47.333333333333336,46.0,>,1.3333333333333357,37,36,>,1,57,54,>,3,257,208,>,49
0,7,33.0,46.666666666666664,<,-13.666666666666664,17,29,<,-12,58,70,<,-12,46.0,47.333333333333336,<,-1.3333333333333357,36,37,<,-1,54,57,<,-3,208,257,<,-49
0,7,46.666666666666664,73.33333333333333,<,-26.666666666666664,29,65,<,-36,70,87,<,-17,47.333333333333336,46.666666666666664,>,0.6666666666666714,37,37,=,0,57,56,>,1,257,267,<,-10
56,7,73.33333333333333,46.666666666666664,>,26.666666666666664,65,29,>,36,87,70,>,17,46.666666666666664,47.333333333333336,<,-0.6666666666666714,37,37,=,0,56,57,<,-1,267,257,>,10
0,7,46.666666666666664,54.333333333333336,<,-7.666666666666671,29,27,>,2,70,71,<,-1,47.333333333333336,46.333333333333336,>,1.0,37,32,>,5,57,56,>,1,257,209,>,48
39,7,54.333333333333336,46.666666666666664,>,7.666666666666671,27,29,<,-2,71,70,>,1,46.333333333333336,47.333333333333336,<,-1.0,32,37,<,-5,56,57,<,-1,209,257,<,-48
0,7,46.666666666666664,69.33333333333333,<,-22.666666666666664,29,53,<,-24,70,82,<,-12,47.333333333333336,41.333333333333336,>,6.0,37,35,>,2,57,49,>,8,257,191,>,66
106,7,69.33333333333333,46.666666666666664,>,22.666666666666664,53,29,>,24,82,70,>,12,41.333333333333336,47.333333333333336,<,-6.0,35,37,<,-2,49,57,<,-8,191,257,<,-66
0,7,46.666666666666664,33.666666666666664,>,13.0,29,13,>,16,70,54,>,16,47.333333333333336,39.333333333333336,>,8.0,37,35,>,2,57,42,>,15,257,150,>,107
184,7,33.666666666666664,46.666666666666664,<,-13.0,13,29,<,-16,54,70,<,-16,39.333333333333336,47.333333333333336,<,-8.0,35,37,<,-2,42,57,<,-15,150,257,<,-107
0,6,55.0,51.0,>,4.0,13,24,<,-11,90,71,>,19,45.666666666666664,46.0,<,-0.3333333333333357,36,36,=,0,55,54,>,1,153,208,<,-55
0,6,51.0,55.0,<,-4.0,24,13,>,11,71,90,<,-19,46.0,45.666666666666664,>,0.3333333333333357,36,36,=,0,54,55,<,-1,208,153,>,55
0,6,55.0,43.333333333333336,>,11.666666666666664,13,27,<,-14,90,71,>,19,45.666666666666664,46.333333333333336,<,-0.6666666666666714,36,32,>,4,55,56,<,-1,153,209,<,-56
39,6,43.333333333333336,55.0,<,-11.666666666666664,27,13,>,14,71,90,<,-19,46.333333333333336,45.666666666666664,>,0.6666666666666714,32,36,<,-4,56,55,>,1,209,153,>,56
0,6,55.0,75.33333333333333,<,-20.33333333333333,13,68,<,-55,90,87,>,3,45.666666666666664,46.666666666666664,<,-1.0,36,37,<,-1,55,56,<,-1,153,267,<,-114
56,6,75.33333333333333,55.0,>,20.33333333333333,68,13,>,55,87,90,<,-3,46.666666666666664,45.666666666666664,>,1.0,37,36,>,1,56,55,>,1,267,153,>,114
0,6,55.0,58.0,<,-3.0,13,48,<,-35,90,73,>,17,45.666666666666664,41.333333333333336,>,4.333333333333329,36,35,>,1,55,49,>,6,153,191,<,-38
104,6,58.0,55.0,>,3.0,48,13,>,35,73,90,<,-17,41.333333333333336,45.666666666666664,<,-4.333333333333329,35,36,<,-1,49,55,<,-6,191,153,>,38
0,6,55.0,50.0,>,5.0,13,13,=,0,90,83,>,7,45.666666666666664,39.333333333333336,>,6.333333333333329,36,35,>,1,55,42,>,13,153,150,>,3
184,6,50.0,55.0,<,-5.0,13,13,=,0,83,90,<,-7,39.333333333333336,45.666666666666664,<,-6.333333333333329,35,36,<,-1,42,55,<,-13,150,153,<,-3
0,5,53.666666666666664,39.333333333333336,>,14.333333333333329,24,27,<,-3,71,59,>,12,46.0,46.333333333333336,<,-0.3333333333333357,36,32,>,4,54,56,<,-2,208,209,<,-1
39,5,39.333333333333336,53.666666666666664,<,-14.333333333333329,27,24,>,3,59,71,<,-12,46.333333333333336,46.0,>,0.3333333333333357,32,36,<,-4,56,54,>,2,209,208,>,1
0,5,53.666666666666664,78.33333333333333,<,-24.666666666666664,24,71,<,-47,71,87,<,-16,46.0,46.666666666666664,<,-0.6666666666666643,36,37,<,-1,54,56,<,-2,208,267,<,-59
56,5,78.33333333333333,53.666666666666664,>,24.666666666666664,71,24,>,47,87,71,>,16,46.666666666666664,46.0,>,0.6666666666666643,37,36,>,1,56,54,>,2,267,208,>,59
0,5,53.666666666666664,56.0,<,-2.3333333333333357,24,48,<,-24,71,67,>,4,46.0,41.333333333333336,>,4.666666666666664,36,35,>,1,54,49,>,5,208,191,>,17
104,5,56.0,53.666666666666664,>,2.3333333333333357,48,24,>,24,67,71,<,-4,41.333333333333336,46.0,<,-4.666666666666664,35,36,<,-1,49,54,<,-5,191,208,<,-17
0,5,53.666666666666664,49.666666666666664,>,4.0,24,12,>,12,71,83,<,-12,46.0,39.333333333333336,>,6.666666666666664,36,35,>,1,54,42,>,12,208,150,>,58
0,5,49.666666666666664,53.666666666666664,<,-4.0,12,24,<,-12,83,71,>,12,39.333333333333336,46.0,<,-6.666666666666664,35,36,<,-1,42,54,<,-12,150,208,<,-58
0,4,52.666666666666664,56.333333333333336,<,-3.6666666666666714,12,32,<,-20,83,78,>,5,39.333333333333336,46.333333333333336,<,-7.0,35,32,>,3,42,56,<,-14,150,209,<,-59
43,4,56.333333333333336,52.666666666666664,>,3.6666666666666714,32,12,>,20,78,83,<,-5,46.333333333333336,39.333333333333336,>,7.0,32,35,<,-3,56,42,>,14,209,150,>,59
0,4,52.666666666666664,71.66666666666667,<,-19.000000000000007,12,67,<,-55,83,77,>,6,39.333333333333336,46.666666666666664,<,-7.333333333333329,35,37,<,-2,42,56,<,-14,150,267,<,-117
71,4,71.66666666666667,52.666666666666664,>,19.000000000000007,67,12,>,55,77,83,<,-6,46.666666666666664,39.333333333333336,>,7.333333333333329,37,35,>,2,56,42,>,14,267,150,>,117
0,4,52.666666666666664,61.0,<,-8.333333333333336,12,48,<,-36,83,68,>,15,39.333333333333336,41.333333333333336,<,-2.0,35,35,=,0,42,49,<,-7,150,191,<,-41
104,4,61.0,52.666666666666664,>,8.333333333333336,48,12,>,36,68,83,<,-15,41.333333333333336,39.333333333333336,>,2.0,35,35,=,0,49,42,>,7,191,150,>,41
0,3,44.0,46.0,<,-2.0,16,28,<,-12,68,78,<,-10,41.333333333333336,46.333333333333336,<,-5.0,35,32,>,3,49,56,<,-7,191,209,<,-18
43,3,46.0,44.0,>,2.0,28,16,>,12,78,68,>,10,46.333333333333336,41.333333333333336,>,5.0,32,35,<,-3,56,49,>,7,209,191,>,18
0,3,44.0,67.33333333333333,<,-23.33333333333333,16,64,<,-48,68,71,<,-3,41.333333333333336,46.666666666666664,<,-5.333333333333329,35,37,<,-2,49,56,<,-7,191,267,<,-76
71,3,67.33333333333333,44.0,>,23.33333333333333,64,16,>,48,71,68,>,3,46.666666666666664,41.333333333333336,>,5.333333333333329,37,35,>,2,56,49,>,7,267,191,>,76
0,2,58.333333333333336,56.333333333333336,>,2.0,37,32,>,5,71,78,<,-7,46.666666666666664,46.333333333333336,>,0.3333333333333286,37,32,>,5,56,56,=,0,267,209,>,58
43,2,56.333333333333336,58.333333333333336,<,-2.0,32,37,<,-5,78,71,>,7,46.333333333333336,46.666666666666664,<,-0.3333333333333286,32,37,<,-5,56,56,=,0,209,267,<,-58
0,20,0.0,0.0,=,0.0,0,0,=,0,0,0,=,0,46.666666666666664,46.0,>,0.6666666666666643,33,35,<,-2,58,53,>,5,160,234,<,-74
81,20,0.0,0.0,=,0.0,0,0,=,0,0,0,=,0,46.0,46.666666666666664,<,-0.6666666666666643,35,33,>,2,53,58,<,-5,234,160,>,74
0,20,0.0,0.0,=,0.0,0,0,=,0,0,0,=,0,46.666666666666664,41.333333333333336,>,5.333333333333329,33,37,<,-4,58,49,>,9,160,109,>,51
3,20,0.0,0.0,=,0.0,0,0,=,0,0,0,=,0,41.333333333333336,46.666666666666664,<,-5.333333333333329,37,33,>,4,49,58,<,-9,109,160,<,-51
0,20,0.0,0.0,=,0.0,0,0,=,0,0,0,=,0,46.666666666666664,42.666666666666664,>,4.0,33,30,>,3,58,53,>,5,160,273,<,-113
67,20,0.0,0.0,=,0.0,0,0,=,0,0,0,=,0,42.666666666666664,46.666666666666664,<,-4.0,30,33,<,-3,53,58,<,-5,273,160,>,113
0,20,0.0,0.0,=,0.0,0,0,=,0,0,0,=,0,46.666666666666664,48.0,<,-1.3333333333333357,33,36,<,-3,58,60,<,-2,160,183,<,-23
22,20,0.0,0.0,=,0.0,0,0,=,0,0,0,=,0,48.0,46.666666666666664,>,1.3333333333333357,36,33,>,3,60,58,>,2,183,160,>,23
0,20,0.0,0.0,=,0.0,0,0,=,0,0,0,=,0,46.666666666666664,49.333333333333336,<,-2.6666666666666714,33,32,>,1,58,59,<,-1,160,208,<,-48
3,20,0.0,0.0,=,0.0,0,0,=,0,0,0,=,0,49.333333333333336,46.666666666666664,>,2.6666666666666714,32,33,<,-1,59,58,>,1,208,160,>,48
0,20,0.0,0.0,=,0.0,0,0,=,0,0,0,=,0,46.666666666666664,47.666666666666664,<,-1.0,33,42,<,-9,58,51,>,7,160,294,<,-134
113,20,0.0,0.0,=,0.0,0,0,=,0,0,0,=,0,47.666666666666664,46.666666666666664,>,1.0,42,33,>,9,51,58,<,-7,294,160,>,134
0,20,0.0,0.0,=,0.0,0,0,=,0,0,0,=,0,46.666666666666664,43.666666666666664,>,3.0,33,43,<,-10,58,45,>,13,160,269,<,-109
77,20,0.0,0.0,=,0.0,0,0,=,0,0,0,=,0,43.666666666666664,46.666666666666664,<,-3.0,43,33,>,10,45,58,<,-13,269,160,>,109
0,20,0.0,0.0,=,0.0,0,0,=,0,0,0,=,0,46.666666666666664,37.666666666666664,>,9.0,33,32,>,1,58,45,>,13,160,200,<,-40
34,20,0.0,0.0,=,0.0,0,0,=,0,0,0,=,0,37.666666666666664,46.666666666666664,<,-9.0,32,33,<,-1,45,58,<,-13,200,160,>,40
0,20,0.0,0.0,=,0.0,0,0,=,0,0,0,=,0,46.666666666666664,41.0,>,5.666666666666664,33,37,<,-4,58,49,>,9,160,216,<,-56
37,20,0.0,0.0,=,0.0,0,0,=,0,0,0,=,0,41.0,46.666666666666664,<,-5.666666666666664,37,33,>,4,49,58,<,-9,216,160,>,56
0,20,0.0,0.0,=,0.0,0,0,=,0,0,0,=,0,46.666666666666664,49.0,<,-2.3333333333333357,33,32,>,1,58,59,<,-1,160,144,>,16
22,20,0.0,0.0,=,0.0,0,0,=,0,0,0,=,0,49.0,46.666666666666664,>,2.3333333333333357,32,33,<,-1,59,58,>,1,144,160,<,-16
0,20,0.0,0.0,=,0.0,0,0,=,0,0,0,=,0,46.666666666666664,43.666666666666664,>,3.0,33,32,>,1,58,59,<,-1,160,290,<,-130
79,20,0.0,0.0,=,0.0,0,0,=,0,0,0,=,0,43.666666666666664,46.666666666666664,<,-3.0,32,33,<,-1,59,58,>,1,290,160,>,130
0,20,0.0,0.0,=,0.0,0,0,=,0,0,0,=,0,46.666666666666664,47.333333333333336,<,-0.6666666666666714,33,40,<,-7,58,54,>,4,160,318,<,-158
81,20,0.0,0.0,=,0.0,0,0,=,0,0,0,=,0,47.333333333333336,46.666666666666664,>,0.6666666666666714,40,33,>,7,54,58,<,-4,318,160,>,158
0,20,0.0,0.0,=,0.0,0,0,=,0,0,0,=,0,46.666666666666664,50.333333333333336,<,-3.6666666666666714,33,45,<,-12,58,55,>,3,160,243,<,-83
31,20,0.0,0.0,=,0.0,0,0,=,0,0,0,=,0,50.333333333333336,46.666666666666664,>,3.6666666666666714,45,33,>,12,55,58,<,-3,243,160,>,83
0,20,0.0,0.0,=,0.0,0,0,=,0,0,0,=,0,46.666666666666664,43.666666666666664,>,3.0,33,38,<,-5,58,49,>,9,160,186,<,-26
20,20,0.0,0.0,=,0.0,0,0,=,0,0,0,=,0,43.666666666666664,46.666666666666664,<,-3.0,38,33,>,5,49,58,<,-9,186,160,>,26
0,20,0.0,0.0,=,0.0,0,0,=,0,0,0,=,0,46.666666666666664,47.0,<,-0.3333333333333357,33,38,<,-5,58,57,>,1,160,111,>,49
7,20,0.0,0.0,=,0.0,0,0,=,0,0,0,=,0,47.0,46.666666666666664,>,0.3333333333333357,38,33,>,5,57,58,<,-1,111,160,<,-49
0,20,0.0,0.0,=,0.0,0,0,=,0,0,0,=,0,46.666666666666664,44.666666666666664,>,2.0,33,36,<,-3,58,59,<,-1,160,207,<,-47
48,20,0.0,0.0,=,0.0,0,0,=,0,0,0,=,0,44.666666666666664,46.666666666666664,<,-2.0,36,33,>,3,59,58,>,1,207,160,>,47
0,20,0.0,0.0,=,0.0,0,0,=,0,0,0,=,0,46.666666666666664,43.666666666666664,>,3.0,33,35,<,-2,58,53,>,5,160,172,<,-12
71,20,0.0,0.0,=,0.0,0,0,=,0,0,0,=,0,43.666666666666664,46.666666666666664,<,-3.0,35,33,>,2,53,58,<,-5,172,160,>,12
0,20,0.0,0.0,=,0.0,0,0,=,0,0,0,=,0,46.666666666666664,42.333333333333336,>,4.333333333333329,33,30,>,3,58,49,>,9,160,244,<,-84
16,20,0.0,0.0,=,0.0,0,0,=,0,0,0,=,0,42.333333333333336,46.666666666666664,<,-4.333333333333329,30,33,<,-3,49,58,<,-9,244,160,>,84
0,20,0.0,0.0,=,0.0,0,0,=,0,0,0,=,0,46.666666666666664,39.666666666666664,>,7.0,33,30,>,3,58,57,>,1,160,113,>,47
12,20,0.0,0.0,=,0.0,0,0,=,0,0,0,=,0,39.666666666666664,46.666666666666664,<,-7.0,30,33,<,-3,57,58,<,-1,113,160,<,-47
0,19,7.666666666666667,20.333333333333332,<,-12.666666666666664,0,0,=,0,23,61,<,-38,49.333333333333336,41.333333333333336,>,8.0,32,37,<,-5,59,49,>,10,208,109,>,99
23,19,20.333333333333332,7.666666666666667,>,12.666666666666664,0,0,=,0,61,23,>,38,41.333333333333336,49.333333333333336,<,-8.0,37,32,>,5,49,59,<,-10,109,208,<,-99
0,19,7.666666666666667,10.333333333333334,<,-2.666666666666667,0,0,=,0,23,31,<,-8,49.333333333333336,47.0,>,2.3333333333333357,32,38,<,-6,59,57,>,2,208,111,>,97
26,19,10.333333333333334,7.666666666666667,>,2.666666666666667,0,0,=,0,31,23,>,8,47.0,49.333333333333336,<,-2.3333333333333357,38,32,>,6,57,59,<,-2,111,208,<,-97
0,19,7.666666666666667,17.333333333333332,<,-9.666666666666664,0,0,=,0,23,52,<,-29,49.333333333333336,39.666666666666664,>,9.666666666666671,32,30,>,2,59,57,>,2,208,113,>,95
21,19,17.333333333333332,7.666666666666667,>,9.666666666666664,0,0,=,0,52,23,>,29,39.666666666666664,49.333333333333336,<,-9.666666666666671,30,32,<,-2,57,59,<,-2,113,208,<,-95
0,19,7.666666666666667,5.0,>,2.666666666666667,0,0,=,0,23,15,>,8,49.333333333333336,42.333333333333336,>,7.0,32,30,>,2,59,49,>,10,208,244,<,-36
0,19,5.0,7.666666666666667,<,-2.666666666666667,0,0,=,0,15,23,<,-8,42.333333333333336,49.333333333333336,<,-7.0,30,32,<,-2,49,59,<,-10,244,208,>,36
0,19,7.666666666666667,19.0,<,-11.333333333333332,0,0,=,0,23,57,<,-34,49.333333333333336,43.666666666666664,>,5.666666666666671,32,38,<,-6,59,49,>,10,208,186,>,22
54,19,19.0,7.666666666666667,>,11.333333333333332,0,0,=,0,57,23,>,34,43.666666666666664,49.333333333333336,<,-5.666666666666671,38,32,>,6,49,59,<,-10,186,208,<,-22
0,19,7.666666666666667,11.333333333333334,<,-3.666666666666667,0,0,=,0,23,34,<,-11,49.333333333333336,48.0,>,1.3333333333333357,32,36,<,-4,59,60,<,-1,208,183,>,25
56,19,11.333333333333334,7.666666666666667,>,3.666666666666667,0,0,=,0,34,23,>,11,48.0,49.333333333333336,<,-1.3333333333333357,36,32,>,4,60,59,>,1,183,208,<,-25
0,19,7.666666666666667,19.333333333333332,<,-11.666666666666664,0,0,=,0,23,58,<,-35,49.333333333333336,49.0,>,0.3333333333333357,32,32,=,0,59,59,=,0,208,144,>,64
22,19,19.333333333333332,7.666666666666667,>,11.666666666666664,0,0,=,0,58,23,>,35,49.0,49.333333333333336,<,-0.3333333333333357,32,32,=,0,59,59,=,0,144,208,<,-64
0,19,7.666666666666667,7.0,>,0.666666666666667,0,0,=,0,23,21,>,2,49.333333333333336,50.333333333333336,<,-1.0,32,45,<,-13,59,55,>,4,208,243,<,-35
40,19,7.0,7.666666666666667,<,-0.666666666666667,0,0,=,0,21,23,<,-2,50.333333333333336,49.333333333333336,>,1.0,45,32,>,13,55,59,<,-4,243,208,>,35
0,19,7.666666666666667,13.333333333333334,<,-5.666666666666667,0,0,=,0,23,40,<,-17,49.333333333333336,37.666666666666664,>,11.666666666666671,32,32,=,0,59,45,>,14,208,200,>,8
9,19,13.333333333333334,7.666666666666667,>,5.666666666666667,0,0,=,0,40,23,>,17,37.666666666666664,49.333333333333336,<,-11.666666666666671,32,32,=,0,45,59,<,-14,200,208,<,-8
0,19,7.666666666666667,16.333333333333332,<,-8.666666666666664,0,0,=,0,23,49,<,-26,49.333333333333336,41.0,>,8.333333333333336,32,37,<,-5,59,49,>,10,208,216,<,-8
46,19,16.333333333333332,7.666666666666667,>,8.666666666666664,0,0,=,0,49,23,>,26,41.0,49.333333333333336,<,-8.333333333333336,37,32,>,5,49,59,<,-10,216,208,>,8
0,19,7.666666666666667,21.0,<,-13.333333333333332,0,0,=,0,23,63,<,-40,49.333333333333336,44.666666666666664,>,4.666666666666671,32,36,<,-4,59,59,=,0,208,207,>,1
73,19,21.0,7.666666666666667,>,13.333333333333332,0,0,=,0,63,23,>,40,44.666666666666664,49.333333333333336,<,-4.666666666666671,36,32,>,4,59,59,=,0,207,208,<,-1
0,19,7.666666666666667,22.666666666666668,<,-15.0,0,0,=,0,23,68,<,-45,49.333333333333336,42.666666666666664,>,6.666666666666671,32,30,>,2,59,53,>,6,208,273,<,-65
92,19,22.666666666666668,7.666666666666667,>,15.0,0,0,=,0,68,23,>,45,42.666666666666664,49.333333333333336,<,-6.666666666666671,30,32,<,-2,53,59,<,-6,273,208,>,65
0,19,7.666666666666667,19.333333333333332,<,-11.666666666666664,0,0,=,0,23,58,<,-35,49.333333333333336,43.666666666666664,>,5.666666666666671,32,35,<,-3,59,53,>,6,208,172,>,36
27,19,19.333333333333332,7.666666666666667,>,11.666666666666664,0,0,=,0,58,23,>,35,43.666666666666664,49.333333333333336,<,-5.666666666666671,35,32,>,3,53,59,<,-6,172,208,<,-36
0,19,7.666666666666667,16.666666666666668,<,-9.0,0,0,=,0,23,50,<,-27,49.333333333333336,43.666666666666664,>,5.666666666666671,32,43,<,-11,59,45,>,14,208,269,<,-61
102,19,16.666666666666668,7.666666666666667,>,9.0,0,0,=,0,50,23,>,27,43.666666666666664,49.333333333333336,<,-5.666666666666671,43,32,>,11,45,59,<,-14,269,208,>,61
0,19,7.666666666666667,14.666666666666666,<,-6.999999999999999,0,0,=,0,23,44,<,-21,49.333333333333336,43.666666666666664,>,5.666666666666671,32,32,=,0,59,59,=,0,208,290,<,-82
92,19,14.666666666666666,7.666666666666667,>,6.999999999999999,0,0,=,0,44,23,>,21,43.666666666666664,49.333333333333336,<,-5.666666666666671,32,32,=,0,59,59,=,0,290,208,>,82
0,19,7.666666666666667,18.666666666666668,<,-11.0,0,0,=,0,23,56,<,-33,49.333333333333336,46.0,>,3.3333333333333357,32,35,<,-3,59,53,>,6,208,234,<,-26
48,19,18.666666666666668,7.666666666666667,>,11.0,0,0,=,0,56,23,>,33,46.0,49.333333333333336,<,-3.3333333333333357,35,32,>,3,53,59,<,-6,234,208,>,26
0,19,7.666666666666667,21.0,<,-13.333333333333332,0,0,=,0,23,63,<,-40,49.333333333333336,47.333333333333336,>,2.0,32,40,<,-8,59,54,>,5,208,318,<,-110
155,19,21.0,7.666666666666667,>,13.333333333333332,0,0,=,0,63,23,>,40,47.333333333333336,49.333333333333336,<,-2.0,40,32,>,8,54,59,<,-5,318,208,>,110
0,19,7.666666666666667,20.0,<,-12.333333333333332,0,0,=,0,23,60,<,-37,49.333333333333336,47.666666666666664,>,1.6666666666666714,32,42,<,-10,59,51,>,8,208,294,<,-86
116,19,20.0,7.666666666666667,>,12.333333333333332,0,0,=,0,60,23,>,37,47.666666666666664,49.333333333333336,<,-1.6666666666666714,42,32,>,10,51,59,<,-8,294,208,>,86
0,18,18.0,14.0,>,4.0,0,0,=,0,31,27,>,4,47.0,42.333333333333336,>,4.666666666666664,38,30,>,8,57,49,>,8,111,244,<,-133
11,18,14.0,18.0,<,-4.0,0,0,=,0,27,31,<,-4,42.333333333333336,47.0,<,-4.666666666666664,30,38,<,-8,49,57,<,-8,244,111,>,133
0,18,18.0,28.333333333333332,<,-10.333333333333332,0,0,=,0,31,45,<,-14,47.0,37.666666666666664,>,9.333333333333336,38,32,>,6,57,45,>,12,111,200,<,-89
23,18,28.333333333333332,18.0,>,10.333333333333332,0,0,=,0,45,31,>,14,37.666666666666664,47.0,<,-9.333333333333336,32,38,<,-6,45,57,<,-12,200,111,>,89
0,18,18.0,27.0,<,-9.0,0,0,=,0,31,52,<,-21,47.0,39.666666666666664,>,7.333333333333336,38,30,>,8,57,57,=,0,111,113,<,-2
23,18,27.0,18.0,>,9.0,0,0,=,0,52,31,>,21,39.666666666666664,47.0,<,-7.333333333333336,30,38,<,-8,57,57,=,0,113,111,>,2
0,18,18.0,34.0,<,-16.0,0,0,=,0,31,58,<,-27,47.0,49.0,<,-2.0,38,32,>,6,57,59,<,-2,111,144,<,-33
131,18,34.0,18.0,>,16.0,0,0,=,0,58,31,>,27,49.0,47.0,>,2.0,32,38,<,-6,59,57,>,2,144,111,>,33
0,18,18.0,48.666666666666664,<,-30.666666666666664,0,0,=,0,31,85,<,-54,47.0,41.333333333333336,>,5.666666666666664,38,37,>,1,57,49,>,8,111,109,>,2
20,18,48.666666666666664,18.0,>,30.666666666666664,0,0,=,0,85,31,>,54,41.333333333333336,47.0,<,-5.666666666666664,37,38,<,-1,49,57,<,-8,109,111,<,-2
0,18,18.0,38.666666666666664,<,-20.666666666666664,0,0,=,0,31,58,<,-27,47.0,43.666666666666664,>,3.3333333333333357,38,35,>,3,57,53,>,4,111,172,<,-61
94,18,38.666666666666664,18.0,>,20.666666666666664,0,0,=,0,58,31,>,27,43.666666666666664,47.0,<,-3.3333333333333357,35,38,<,-3,53,57,<,-4,172,111,>,61
0,18,18.0,27.666666666666668,<,-9.666666666666668,0,0,=,0,31,62,<,-31,47.0,50.333333333333336,<,-3.3333333333333357,38,45,<,-7,57,55,>,2,111,243,<,-132
135,18,27.666666666666668,18.0,>,9.666666666666668,0,0,=,0,62,31,>,31,50.333333333333336,47.0,>,3.3333333333333357,45,38,>,7,55,57,<,-2,243,111,>,132
0,18,18.0,35.333333333333336,<,-17.333333333333336,0,0,=,0,31,57,<,-26,47.0,41.0,>,6.0,38,37,>,1,57,49,>,8,111,216,<,-105
149,18,35.333333333333336,18.0,>,17.333333333333336,0,0,=,0,57,31,>,26,41.0,47.0,<,-6.0,37,38,<,-1,49,57,<,-8,216,111,>,105
0,18,18.0,39.333333333333336,<,-21.333333333333336,0,0,=,0,31,62,<,-31,47.0,46.0,>,1.0,38,35,>,3,57,53,>,4,111,234,<,-123
193,18,39.333333333333336,18.0,>,21.333333333333336,0,0,=,0,62,31,>,31,46.0,47.0,<,-1.0,35,38,<,-3,53,57,<,-4,234,111,>,123
0,18,18.0,28.0,<,-10.0,0,0,=,0,31,57,<,-26,47.0,43.666666666666664,>,3.3333333333333357,38,38,=,0,57,49,>,8,111,186,<,-75
40,18,28.0,18.0,>,10.0,0,0,=,0,57,31,>,26,43.666666666666664,47.0,<,-3.3333333333333357,38,38,=,0,49,57,<,-8,186,111,>,75
0,18,18.0,18.0,=,0.0,0,0,=,0,31,34,<,-3,47.0,48.0,<,-1.0,38,36,>,2,57,60,<,-3,111,183,<,-72
75,18,18.0,18.0,=,0.0,0,0,=,0,34,31,>,3,48.0,47.0,>,1.0,36,38,<,-2,60,57,>,3,183,111,>,72
0,18,18.0,45.333333333333336,<,-27.333333333333336,0,0,=,0,31,73,<,-42,47.0,44.666666666666664,>,2.3333333333333357,38,36,>,2,57,59,<,-2,111,207,<,-96
188,18,45.333333333333336,18.0,>,27.333333333333336,0,0,=,0,73,31,>,42,44.666666666666664,47.0,<,-2.3333333333333357,36,38,<,-2,59,57,>,2,207,111,>,96
0,18,18.0,31.666666666666668,<,-13.666666666666668,0,0,=,0,31,68,<,-37,47.0,42.666666666666664,>,4.333333333333336,38,30,>,8,57,53,>,4,111,273,<,-162
116,18,31.666666666666668,18.0,>,13.666666666666668,0,0,=,0,68,31,>,37,42.666666666666664,47.0,<,-4.333333333333336,30,38,<,-8,53,57,<,-4,273,111,>,162
0,18,18.0,25.333333333333332,<,-7.333333333333332,0,0,=,0,31,44,<,-13,47.0,43.666666666666664,>,3.3333333333333357,38,32,>,6,57,59,<,-2,111,290,<,-179
164,18,25.333333333333332,18.0,>,7.333333333333332,0,0,=,0,44,31,>,13,43.666666666666664,47.0,<,-3.3333333333333357,32,38,<,-6,59,57,>,2,290,111,>,179
0,18,18.0,30.0,<,-12.0,0,0,=,0,31,50,<,-19,47.0,43.666666666666664,>,3.3333333333333357,38,43,<,-5,57,45,>,12,111,269,<,-158
190,18,30.0,18.0,>,12.0,0,0,=,0,50,31,>,19,43.666666666666664,47.0,<,-3.3333333333333357,43,38,>,5,45,57,<,-12,269,111,>,158
0,18,18.0,43.0,<,-25.0,0,0,=,0,31,69,<,-38,47.0,47.666666666666664,<,-0.6666666666666643,38,42,<,-4,57,51,>,6,111,294,<,-183
86,18,43.0,18.0,>,25.0,0,0,=,0,69,31,>,38,47.666666666666664,47.0,>,0.6666666666666643,42,38,>,4,51,57,<,-6,294,111,>,183
0,18,18.0,34.0,<,-16.0,0,0,=,0,31,63,<,-32,47.0,47.333333333333336,<,-0.3333333333333357,38,40,<,-2,57,54,>,3,111,318,<,-207
203,18,34.0,18.0,>,16.0,0,0,=,0,63,31,>,32,47.333333333333336,47.0,>,0.3333333333333357,40,38,>,2,54,57,<,-3,318,111,>,207
0,17,23.666666666666668,12.333333333333334,>,11.333333333333334,0,0,=,0,40,22,>,18,37.666666666666664,42.333333333333336,<,-4.666666666666671,32,30,>,2,45,49,<,-4,200,244,<,-44
11,17,12.333333333333334,23.666666666666668,<,-11.333333333333334,0,0,=,0,22,40,<,-18,42.333333333333336,37.666666666666664,>,4.666666666666671,30,32,<,-2,49,45,>,4,244,200,>,44
0,17,23.666666666666668,37.666666666666664,<,-13.999999999999996,0,0,=,0,40,61,<,-21,37.666666666666664,41.333333333333336,<,-3.6666666666666714,32,37,<,-5,45,49,<,-4,200,109,>,91
20,17,37.666666666666664,23.666666666666668,>,13.999999999999996,0,0,=,0,61,40,>,21,41.333333333333336,37.666666666666664,>,3.6666666666666714,37,32,>,5,49,45,>,4,109,200,<,-91
0,17,23.666666666666668,40.666666666666664,<,-16.999999999999996,0,0,=,0,40,70,<,-30,37.666666666666664,39.666666666666664,<,-2.0,32,30,>,2,45,57,<,-12,200,113,>,87
83,17,40.666666666666664,23.666666666666668,>,16.999999999999996,0,0,=,0,70,40,>,30,39.666666666666664,37.666666666666664,>,2.0,30,32,<,-2,57,45,>,12,113,200,<,-87
0,17,23.666666666666668,23.666666666666668,=,0.0,0,0,=,0,40,57,<,-17,37.666666666666664,43.666666666666664,<,-6.0,32,38,<,-6,45,49,<,-4,200,186,>,14
67,17,23.666666666666668,23.666666666666668,=,0.0,0,0,=,0,57,40,>,17,43.666666666666664,37.666666666666664,>,6.0,38,32,>,6,49,45,>,4,186,200,<,-14
0,17,23.666666666666668,41.333333333333336,<,-17.666666666666668,0,0,=,0,40,90,<,-50,37.666666666666664,48.0,<,-10.333333333333336,32,36,<,-4,45,60,<,-15,200,183,>,17
75,17,41.333333333333336,23.666666666666668,>,17.666666666666668,0,0,=,0,90,40,>,50,48.0,37.666666666666664,>,10.333333333333336,36,32,>,4,60,45,>,15,183,200,<,-17
0,17,23.666666666666668,26.666666666666668,<,-3.0,0,0,=,0,40,60,<,-20,37.666666666666664,47.666666666666664,<,-10.0,32,42,<,-10,45,51,<,-6,200,294,<,-94
86,17,26.666666666666668,23.666666666666668,>,3.0,0,0,=,0,60,40,>,20,47.666666666666664,37.666666666666664,>,10.0,42,32,>,10,51,45,>,6,294,200,>,94
0,17,23.666666666666668,38.0,<,-14.333333333333332,0,0,=,0,40,58,<,-18,37.666666666666664,43.666666666666664,<,-6.0,32,35,<,-3,45,53,<,-8,200,172,>,28
94,17,38.0,23.666666666666668,>,14.333333333333332,0,0,=,0,58,40,>,18,43.666666666666664,37.666666666666664,>,6.0,35,32,>,3,53,45,>,8,172,200,<,-28
0,17,23.666666666666668,38.333333333333336,<,-14.666666666666668,0,0,=,0,40,68,<,-28,37.666666666666664,42.666666666666664,<,-5.0,32,30,>,2,45,53,<,-8,200,273,<,-73
137,17,38.333333333333336,23.666666666666668,>,14.666666666666668,0,0,=,0,68,40,>,28,42.666666666666664,37.666666666666664,>,5.0,30,32,<,-2,53,45,>,8,273,200,>,73
0,17,23.666666666666668,34.0,<,-10.333333333333332,0,0,=,0,40,58,<,-18,37.666666666666664,49.0,<,-11.333333333333336,32,32,=,0,45,59,<,-14,200,144,>,56
169,17,34.0,23.666666666666668,>,10.333333333333332,0,0,=,0,58,40,>,18,49.0,37.666666666666664,>,11.333333333333336,32,32,=,0,59,45,>,14,144,200,<,-56
0,17,23.666666666666668,10.333333333333334,>,13.333333333333334,0,0,=,0,40,21,>,19,37.666666666666664,50.333333333333336,<,-12.666666666666671,32,45,<,-13,45,55,<,-10,200,243,<,-43
11,17,10.333333333333334,23.666666666666668,<,-13.333333333333334,0,0,=,0,21,40,<,-19,50.333333333333336,37.666666666666664,>,12.666666666666671,45,32,>,13,55,45,>,10,243,200,>,43
0,17,23.666666666666668,21.0,>,2.666666666666668,0,0,=,0,40,49,<,-9,37.666666666666664,41.0,<,-3.3333333333333357,32,37,<,-5,45,49,<,-4,200,216,<,-16
0,17,21.0,23.666666666666668,<,-2.666666666666668,0,0,=,0,49,40,>,9,41.0,37.666666666666664,>,3.3333333333333357,37,32,>,5,49,45,>,4,216,200,>,16
0,17,23.666666666666668,39.666666666666664,<,-15.999999999999996,0,0,=,0,40,75,<,-35,37.666666666666664,43.666666666666664,<,-6.0,32,32,=,0,45,59,<,-14,200,290,<,-90
164,17,39.666666666666664,23.666666666666668,>,15.999999999999996,0,0,=,0,75,40,>,35,43.666666666666664,37.666666666666664,>,6.0,32,32,=,0,59,45,>,14,290,200,>,90
0,17,23.666666666666668,45.333333333333336,<,-21.666666666666668,0,0,=,0,40,73,<,-33,37.666666666666664,44.666666666666664,<,-7.0,32,36,<,-4,45,59,<,-14,200,207,<,-7
131,17,45.333333333333336,23.666666666666668,>,21.666666666666668,0,0,=,0,73,40,>,33,44.666666666666664,37.666666666666664,>,7.0,36,32,>,4,59,45,>,14,207,200,>,7
0,17,23.666666666666668,31.0,<,-7.333333333333332,0,0,=,0,40,50,<,-10,37.666666666666664,43.666666666666664,<,-6.0,32,43,<,-11,45,45,=,0,200,269,<,-69
207,17,31.0,23.666666666666668,>,7.333333333333332,0,0,=,0,50,40,>,10,43.666666666666664,37.666666666666664,>,6.0,43,32,>,11,45,45,=,0,269,200,>,69
0,17,23.666666666666668,35.0,<,-11.333333333333332,0,0,=,0,40,56,<,-16,37.666666666666664,46.0,<,-8.333333333333336,32,35,<,-3,45,53,<,-8,200,234,<,-34
100,17,35.0,23.666666666666668,>,11.333333333333332,0,0,=,0,56,40,>,16,46.0,37.666666666666664,>,8.333333333333336,35,32,>,3,53,45,>,8,234,200,>,34
0,17,23.666666666666668,46.666666666666664,<,-22.999999999999996,0,0,=,0,40,77,<,-37,37.666666666666664,47.333333333333336,<,-9.666666666666671,32,40,<,-8,45,54,<,-9,200,318,<,-118
223,17,46.666666666666664,23.666666666666668,>,22.999999999999996,0,0,=,0,77,40,>,37,47.333333333333336,37.666666666666664,>,9.666666666666671,40,32,>,8,54,45,>,9,318,200,>,118
0,16,29.0,35.333333333333336,<,-6.333333333333336,14,10,>,4,49,75,<,-26,41.0,50.333333333333336,<,-9.333333333333336,37,45,<,-8,49,55,<,-6,216,243,<,-27
11,16,35.333333333333336,29.0,>,6.333333333333336,10,14,<,-4,75,49,>,26,50.333333333333336,41.0,>,9.333333333333336,45,37,>,8,55,49,>,6,243,216,>,27
0,16,29.0,38.333333333333336,<,-9.333333333333336,14,15,<,-1,49,78,<,-29,41.0,42.333333333333336,<,-1.3333333333333357,37,30,>,7,49,49,=,0,216,244,<,-28
0,16,38.333333333333336,29.0,>,9.333333333333336,15,14,>,1,78,49,>,29,42.333333333333336,41.0,>,1.3333333333333357,30,37,<,-7,49,49,=,0,244,216,>,28
0,16,29.0,45.0,<,-16.0,14,22,<,-8,49,61,<,-12,41.0,41.333333333333336,<,-0.3333333333333357,37,37,=,0,49,49,=,0,216,109,>,107
11,16,45.0,29.0,>,16.0,22,14,>,8,61,49,>,12,41.333333333333336,41.0,>,0.3333333333333357,37,37,=,0,49,49,=,0,109,216,<,-107
0,16,29.0,41.0,<,-12.0,14,14,=,0,49,57,<,-8,41.0,43.666666666666664,<,-2.6666666666666643,37,38,<,-1,49,49,=,0,216,186,>,30
67,16,41.0,29.0,>,12.0,14,14,=,0,57,49,>,8,43.666666666666664,41.0,>,2.6666666666666643,38,37,>,1,49,49,=,0,186,216,<,-30
0,16,29.0,58.0,<,-29.0,14,34,<,-20,49,90,<,-41,41.0,48.0,<,-7.0,37,36,>,1,49,60,<,-11,216,183,>,33
84,16,58.0,29.0,>,29.0,34,14,>,20,90,49,>,41,48.0,41.0,>,7.0,36,37,<,-1,60,49,>,11,183,216,<,-33
0,16,29.0,51.333333333333336,<,-22.333333333333336,14,32,<,-18,49,70,<,-21,41.0,39.666666666666664,>,1.3333333333333357,37,30,>,7,49,57,<,-8,216,113,>,103
163,16,51.333333333333336,29.0,>,22.333333333333336,32,14,>,18,70,49,>,21,39.666666666666664,41.0,<,-1.3333333333333357,30,37,<,-7,57,49,>,8,113,216,<,-103
0,16,29.0,44.0,<,-15.0,14,20,<,-6,49,60,<,-11,41.0,47.666666666666664,<,-6.666666666666664,37,42,<,-5,49,51,<,-2,216,294,<,-78
179,16,44.0,29.0,>,15.0,20,14,>,6,60,49,>,11,47.666666666666664,41.0,>,6.666666666666664,42,37,>,5,51,49,>,2,294,216,>,78
0,16,29.0,67.66666666666667,<,-38.66666666666667,14,56,<,-42,49,89,<,-40,41.0,43.666666666666664,<,-2.6666666666666643,37,35,>,2,49,53,<,-4,216,172,>,44
273,16,67.66666666666667,29.0,>,38.66666666666667,56,14,>,42,89,49,>,40,43.666666666666664,41.0,>,2.6666666666666643,35,37,<,-2,53,49,>,4,172,216,<,-44
0,16,29.0,40.666666666666664,<,-11.666666666666664,14,17,<,-3,49,56,<,-7,41.0,46.0,<,-5.0,37,35,>,2,49,53,<,-4,216,234,<,-18
100,16,40.666666666666664,29.0,>,11.666666666666664,17,14,>,3,56,49,>,7,46.0,41.0,>,5.0,35,37,<,-2,53,49,>,4,234,216,>,18
0,16,29.0,58.333333333333336,<,-29.333333333333336,14,39,<,-25,49,73,<,-24,41.0,44.666666666666664,<,-3.6666666666666643,37,36,>,1,49,59,<,-10,216,207,>,9
131,16,58.333333333333336,29.0,>,29.333333333333336,39,14,>,25,73,49,>,24,44.666666666666664,41.0,>,3.6666666666666643,36,37,<,-1,59,49,>,10,207,216,<,-9
0,16,29.0,52.333333333333336,<,-23.333333333333336,14,42,<,-28,49,68,<,-19,41.0,42.666666666666664,<,-1.6666666666666643,37,30,>,7,49,53,<,-4,216,273,<,-57
137,16,52.333333333333336,29.0,>,23.333333333333336,42,14,>,28,68,49,>,19,42.666666666666664,41.0,>,1.6666666666666643,30,37,<,-7,53,49,>,4,273,216,>,57
0,16,29.0,65.33333333333333,<,-36.33333333333333,14,44,<,-30,49,77,<,-28,41.0,43.666666666666664,<,-2.6666666666666643,37,32,>,5,49,59,<,-10,216,290,<,-74
177,16,65.33333333333333,29.0,>,36.33333333333333,44,14,>,30,77,49,>,28,43.666666666666664,41.0,>,2.6666666666666643,32,37,<,-5,59,49,>,10,290,216,>,74
0,16,29.0,41.0,<,-12.0,14,21,<,-7,49,58,<,-9,41.0,49.0,<,-8.0,37,32,>,5,49,59,<,-10,216,144,>,72
160,16,41.0,29.0,>,12.0,21,14,>,7,58,49,>,9,49.0,41.0,>,8.0,32,37,<,-5,59,49,>,10,144,216,<,-72
0,16,29.0,40.0,<,-11.0,14,27,<,-13,49,50,<,-1,41.0,43.666666666666664,<,-2.6666666666666643,37,43,<,-6,49,45,>,4,216,269,<,-53
216,16,40.0,29.0,>,11.0,27,14,>,13,50,49,>,1,43.666666666666664,41.0,>,2.6666666666666643,43,37,>,6,45,49,<,-4,269,216,>,53
0,16,29.0,71.66666666666667,<,-42.66666666666667,14,63,<,-49,49,77,<,-28,41.0,47.333333333333336,<,-6.333333333333336,37,40,<,-3,49,54,<,-5,216,318,<,-102
247,16,71.66666666666667,29.0,>,42.66666666666667,63,14,>,49,77,49,>,28,47.333333333333336,41.0,>,6.333333333333336,40,37,>,3,54,49,>,5,318,216,>,102
0,15,44.333333333333336,42.0,>,2.3333333333333357,15,22,<,-7,78,61,>,17,42.333333333333336,41.333333333333336,>,1.0,30,37,<,-7,49,49,=,0,244,109,>,135
0,15,42.0,44.333333333333336,<,-2.3333333333333357,22,15,>,7,61,78,<,-17,41.333333333333336,42.333333333333336,<,-1.0,37,30,>,7,49,49,=,0,109,244,<,-135
0,15,44.333333333333336,41.666666666666664,>,2.6666666666666714,15,21,<,-6,78,75,>,3,42.333333333333336,50.333333333333336,<,-8.0,30,45,<,-15,49,55,<,-6,244,243,>,1
60,15,41.666666666666664,44.333333333333336,<,-2.6666666666666714,21,15,>,6,75,78,<,-3,50.333333333333336,42.333333333333336,>,8.0,45,30,>,15,55,49,>,6,243,244,<,-1
0,15,44.333333333333336,58.0,<,-13.666666666666664,15,52,<,-37,78,65,>,13,42.333333333333336,43.666666666666664,<,-1.3333333333333286,30,38,<,-8,49,49,=,0,244,186,>,58
152,15,58.0,44.333333333333336,>,13.666666666666664,52,15,>,37,65,78,<,-13,43.666666666666664,42.333333333333336,>,1.3333333333333286,38,30,>,8,49,49,=,0,186,244,<,-58
0,15,44.333333333333336,43.0,>,1.3333333333333357,15,34,<,-19,78,50,>,28,42.333333333333336,48.0,<,-5.666666666666664,30,36,<,-6,49,60,<,-11,244,183,>,61
84,15,43.0,44.333333333333336,<,-1.3333333333333357,34,15,>,19,50,78,<,-28,48.0,42.333333333333336,>,5.666666666666664,36,30,>,6,60,49,>,11,183,244,<,-61
0,15,44.333333333333336,34.0,>,10.333333333333336,15,17,<,-2,78,56,>,22,42.333333333333336,46.0,<,-3.6666666666666643,30,35,<,-5,49,53,<,-4,244,234,>,10
0,15,34.0,44.333333333333336,<,-10.333333333333336,17,15,>,2,56,78,<,-22,46.0,42.333333333333336,>,3.6666666666666643,35,30,>,5,53,49,>,4,234,244,<,-10
0,15,44.333333333333336,46.666666666666664,<,-2.3333333333333286,15,38,<,-23,78,63,>,15,42.333333333333336,44.666666666666664,<,-2.3333333333333286,30,36,<,-6,49,59,<,-10,244,207,>,37
36,15,46.666666666666664,44.333333333333336,>,2.3333333333333286,38,15,>,23,63,78,<,-15,44.666666666666664,42.333333333333336,>,2.3333333333333286,36,30,>,6,59,49,>,10,207,244,<,-37
0,15,44.333333333333336,48.0,<,-3.6666666666666643,15,34,<,-19,78,68,>,10,42.333333333333336,42.666666666666664,<,-0.3333333333333286,30,30,=,0,49,53,<,-4,244,273,<,-29
94,15,48.0,44.333333333333336,>,3.6666666666666643,34,15,>,19,68,78,<,-10,42.666666666666664,42.333333333333336,>,0.3333333333333286,30,30,=,0,53,49,>,4,273,244,>,29
0,15,44.333333333333336,42.666666666666664,>,1.6666666666666714,15,21,<,-6,78,58,>,20,42.333333333333336,49.0,<,-6.666666666666664,30,32,<,-2,49,59,<,-10,244,144,>,100
173,15,42.666666666666664,44.333333333333336,<,-1.6666666666666714,21,15,>,6,58,78,<,-20,49.0,42.333333333333336,>,6.666666666666664,32,30,>,2,59,49,>,10,144,244,<,-100
0,15,44.333333333333336,47.0,<,-2.6666666666666643,15,32,<,-17,78,57,>,21,42.333333333333336,39.666666666666664,>,2.6666666666666714,30,30,=,0,49,57,<,-8,244,113,>,131
163,15,47.0,44.333333333333336,>,2.6666666666666643,32,15,>,17,57,78,<,-21,39.666666666666664,42.333333333333336,<,-2.6666666666666714,30,30,=,0,57,49,>,8,113,244,<,-131
0,15,44.333333333333336,44.333333333333336,=,0.0,15,12,>,3,78,77,>,1,42.333333333333336,43.666666666666664,<,-1.3333333333333286,30,32,<,-2,49,59,<,-10,244,290,<,-46
158,15,44.333333333333336,44.333333333333336,=,0.0,12,15,<,-3,77,78,<,-1,43.666666666666664,42.333333333333336,>,1.3333333333333286,32,30,>,2,59,49,>,10,290,244,>,46
0,15,44.333333333333336,47.333333333333336,<,-3.0,15,30,<,-15,78,60,>,18,42.333333333333336,47.666666666666664,<,-5.333333333333329,30,42,<,-12,49,51,<,-2,244,294,<,-50
139,15,47.333333333333336,44.333333333333336,>,3.0,30,15,>,15,60,78,<,-18,47.666666666666664,42.333333333333336,>,5.333333333333329,42,30,>,12,51,49,>,2,294,244,>,50
0,15,44.333333333333336,44.0,>,0.3333333333333357,15,27,<,-12,78,55,>,23,42.333333333333336,43.666666666666664,<,-1.3333333333333286,30,43,<,-13,49,45,>,4,244,269,<,-25
172,15,44.0,44.333333333333336,<,-0.3333333333333357,27,15,>,12,55,78,<,-23,43.666666666666664,42.333333333333336,>,1.3333333333333286,43,30,>,13,45,49,<,-4,269,244,>,25
0,15,44.333333333333336,72.33333333333333,<,-27.999999999999993,15,63,<,-48,78,79,<,-1,42.333333333333336,47.333333333333336,<,-5.0,30,40,<,-10,49,54,<,-5,244,318,<,-74
226,15,72.33333333333333,44.333333333333336,>,27.999999999999993,63,15,>,48,79,78,>,1,47.333333333333336,42.333333333333336,>,5.0,40,30,>,10,54,49,>,5,318,244,>,74
0,15,44.333333333333336,66.0,<,-21.666666666666664,15,51,<,-36,78,89,<,-11,42.333333333333336,43.666666666666664,<,-1.3333333333333286,30,35,<,-5,49,53,<,-4,244,172,>,72
241,15,66.0,44.333333333333336,>,21.666666666666664,51,15,>,36,89,78,>,11,43.666666666666664,42.333333333333336,>,1.3333333333333286,35,30,>,5,53,49,>,4,172,244,<,-72
0,14,33.0,31.333333333333332,>,1.6666666666666679,17,22,<,-5,53,43,>,10,46.0,41.333333333333336,>,4.666666666666664,35,37,<,-2,53,49,>,4,234,109,>,125
0,14,31.333333333333332,33.0,<,-1.6666666666666679,22,17,>,5,43,53,<,-10,41.333333333333336,46.0,<,-4.666666666666664,37,35,>,2,49,53,<,-4,109,234,<,-125
0,14,33.0,54.0,<,-21.0,17,38,<,-21,53,85,<,-32,46.0,44.666666666666664,>,1.3333333333333357,35,36,<,-1,53,59,<,-6,234,207,>,27
36,14,54.0,33.0,>,21.0,38,17,>,21,85,53,>,32,44.666666666666664,46.0,<,-1.3333333333333357,36,35,>,1,59,53,>,6,207,234,<,-27
0,14,33.0,47.333333333333336,<,-14.333333333333336,17,29,<,-12,53,75,<,-22,46.0,50.333333333333336,<,-4.333333333333336,35,45,<,-10,53,55,<,-2,234,243,<,-9
60,14,47.333333333333336,33.0,>,14.333333333333336,29,17,>,12,75,53,>,22,50.333333333333336,46.0,>,4.333333333333336,45,35,>,10,55,53,>,2,243,234,>,9
0,14,33.0,47.333333333333336,<,-14.333333333333336,17,45,<,-28,53,50,>,3,46.0,48.0,<,-2.0,35,36,<,-1,53,60,<,-7,234,183,>,51
142,14,47.333333333333336,33.0,>,14.333333333333336,45,17,>,28,50,53,<,-3,48.0,46.0,>,2.0,36,35,>,1,60,53,>,7,183,234,<,-51
0,14,33.0,52.666666666666664,<,-19.666666666666664,17,34,<,-17,53,82,<,-29,46.0,42.666666666666664,>,3.3333333333333357,35,30,>,5,53,53,=,0,234,273,<,-39
94,14,52.666666666666664,33.0,>,19.666666666666664,34,17,>,17,82,53,>,29,42.666666666666664,46.0,<,-3.3333333333333357,30,35,<,-5,53,53,=,0,273,234,>,39
0,14,33.0,40.333333333333336,<,-7.333333333333336,17,30,<,-13,53,52,>,1,46.0,47.666666666666664,<,-1.6666666666666643,35,42,<,-7,53,51,>,2,234,294,<,-60
139,14,40.333333333333336,33.0,>,7.333333333333336,30,17,>,13,52,53,<,-1,47.666666666666664,46.0,>,1.6666666666666643,42,35,>,7,51,53,<,-2,294,234,>,60
0,14,33.0,47.666666666666664,<,-14.666666666666664,17,26,<,-9,53,65,<,-12,46.0,43.666666666666664,>,2.3333333333333357,35,38,<,-3,53,49,>,4,234,186,>,48
61,14,47.666666666666664,33.0,>,14.666666666666664,26,17,>,9,65,53,>,12,43.666666666666664,46.0,<,-2.3333333333333357,38,35,>,3,49,53,<,-4,186,234,<,-48
0,14,33.0,56.333333333333336,<,-23.333333333333336,17,12,>,5,53,80,<,-27,46.0,43.666666666666664,>,2.3333333333333357,35,32,>,3,53,59,<,-6,234,290,<,-56
158,14,56.333333333333336,33.0,>,23.333333333333336,12,17,<,-5,80,53,>,27,43.666666666666664,46.0,<,-2.3333333333333357,32,35,<,-3,59,53,>,6,290,234,>,56
0,14,33.0,59.333333333333336,<,-26.333333333333336,17,32,<,-15,53,89,<,-36,46.0,39.666666666666664,>,6.333333333333336,35,30,>,5,53,57,<,-4,234,113,>,121
161,14,59.333333333333336,33.0,>,26.333333333333336,32,17,>,15,89,53,>,36,39.666666666666664,46.0,<,-6.333333333333336,30,35,<,-5,57,53,>,4,113,234,<,-121
0,14,33.0,46.666666666666664,<,-13.666666666666664,17,27,<,-10,53,58,<,-5,46.0,43.666666666666664,>,2.3333333333333357,35,43,<,-8,53,45,>,8,234,269,<,-35
172,14,46.666666666666664,33.0,>,13.666666666666664,27,17,>,10,58,53,>,5,43.666666666666664,46.0,<,-2.3333333333333357,43,35,>,8,45,53,<,-8,269,234,>,35
0,14,33.0,26.666666666666668,>,6.333333333333332,17,10,>,7,53,49,>,4,46.0,49.0,<,-3.0,35,32,>,3,53,59,<,-6,234,144,>,90
0,14,26.666666666666668,33.0,<,-6.333333333333332,10,17,<,-7,49,53,<,-4,49.0,46.0,>,3.0,32,35,<,-3,59,53,>,6,144,234,<,-90
0,14,33.0,59.666666666666664,<,-26.666666666666664,17,25,<,-8,53,79,<,-26,46.0,47.333333333333336,<,-1.3333333333333357,35,40,<,-5,53,54,<,-1,234,318,<,-84
160,14,59.666666666666664,33.0,>,26.666666666666664,25,17,>,8,79,53,>,26,47.333333333333336,46.0,>,1.3333333333333357,40,35,>,5,54,53,>,1,318,234,>,84
0,14,33.0,50.333333333333336,<,-17.333333333333336,17,11,>,6,53,89,<,-36,46.0,43.666666666666664,>,2.3333333333333357,35,35,=,0,53,53,=,0,234,172,>,62
170,14,50.333333333333336,33.0,>,17.333333333333336,11,17,<,-6,89,53,>,36,43.666666666666664,46.0,<,-2.3333333333333357,35,35,=,0,53,53,=,0,172,234,<,-62
0,13,38.0,18.333333333333332,>,19.666666666666668,22,10,>,12,63,24,>,39,41.333333333333336,49.0,<,-7.666666666666664,37,32,>,5,49,59,<,-10,109,144,<,-35
0,13,18.333333333333332,38.0,<,-19.666666666666668,10,22,<,-12,24,63,<,-39,49.0,41.333333333333336,>,7.666666666666664,32,37,<,-5,59,49,>,10,144,109,>,35
0,13,38.0,50.666666666666664,<,-12.666666666666664,22,28,<,-6,63,85,<,-22,41.333333333333336,44.666666666666664,<,-3.3333333333333286,37,36,>,1,49,59,<,-10,109,207,<,-98
104,13,50.666666666666664,38.0,>,12.666666666666664,28,22,>,6,85,63,>,22,44.666666666666664,41.333333333333336,>,3.3333333333333286,36,37,<,-1,59,49,>,10,207,109,>,98
0,13,38.0,54.0,<,-16.0,22,38,<,-16,63,75,<,-12,41.333333333333336,50.333333333333336,<,-9.0,37,45,<,-8,49,55,<,-6,109,243,<,-134
140,13,54.0,38.0,>,16.0,38,22,>,16,75,63,>,12,50.333333333333336,41.333333333333336,>,9.0,45,37,>,8,55,49,>,6,243,109,>,134
0,13,38.0,29.333333333333332,>,8.666666666666668,22,10,>,12,63,52,>,11,41.333333333333336,43.666666666666664,<,-2.3333333333333286,37,38,<,-1,49,49,=,0,109,186,<,-77
22,13,29.333333333333332,38.0,<,-8.666666666666668,10,22,<,-12,52,63,<,-11,43.666666666666664,41.333333333333336,>,2.3333333333333286,38,37,>,1,49,49,=,0,186,109,>,77
0,13,38.0,45.0,<,-7.0,22,11,>,11,63,82,<,-19,41.333333333333336,42.666666666666664,<,-1.3333333333333286,37,30,>,7,49,53,<,-4,109,273,<,-164
0,13,45.0,38.0,>,7.0,11,22,<,-11,82,63,>,19,42.666666666666664,41.333333333333336,>,1.3333333333333286,30,37,<,-7,53,49,>,4,273,109,>,164
0,13,38.0,51.333333333333336,<,-13.333333333333336,22,39,<,-17,63,63,=,0,41.333333333333336,47.666666666666664,<,-6.333333333333329,37,42,<,-5,49,51,<,-2,109,294,<,-185
164,13,51.333333333333336,38.0,>,13.333333333333336,39,22,>,17,63,63,=,0,47.666666666666664,41.333333333333336,>,6.333333333333329,42,37,>,5,51,49,>,2,294,109,>,185
0,13,38.0,40.333333333333336,<,-2.3333333333333357,22,24,<,-2,63,50,>,13,41.333333333333336,48.0,<,-6.666666666666664,37,36,>,1,49,60,<,-11,109,183,<,-74
146,13,40.333333333333336,38.0,>,2.3333333333333357,24,22,>,2,50,63,<,-13,48.0,41.333333333333336,>,6.666666666666664,36,37,<,-1,60,49,>,11,183,109,>,74
0,13,38.0,59.333333333333336,<,-21.333333333333336,22,21,>,1,63,80,<,-17,41.333333333333336,43.666666666666664,<,-2.3333333333333286,37,32,>,5,49,59,<,-10,109,290,<,-181
148,13,59.333333333333336,38.0,>,21.333333333333336,21,22,<,-1,80,63,>,17,43.666666666666664,41.333333333333336,>,2.3333333333333286,32,37,<,-5,59,49,>,10,290,109,>,181
0,13,38.0,45.0,<,-7.0,22,25,<,-3,63,75,<,-12,41.333333333333336,47.333333333333336,<,-6.0,37,40,<,-3,49,54,<,-5,109,318,<,-209
100,13,45.0,38.0,>,7.0,25,22,>,3,75,63,>,12,47.333333333333336,41.333333333333336,>,6.0,40,37,>,3,54,49,>,5,318,109,>,209
0,13,38.0,47.666666666666664,<,-9.666666666666664,22,22,=,0,63,89,<,-26,41.333333333333336,39.666666666666664,>,1.6666666666666714,37,30,>,7,49,57,<,-8,109,113,<,-4
163,13,47.666666666666664,38.0,>,9.666666666666664,22,22,=,0,89,63,>,26,39.666666666666664,41.333333333333336,<,-1.6666666666666714,30,37,<,-7,57,49,>,8,113,109,>,4
0,13,38.0,53.0,<,-15.0,22,11,>,11,63,89,<,-26,41.333333333333336,43.666666666666664,<,-2.3333333333333286,37,35,>,2,49,53,<,-4,109,172,<,-63
170,13,53.0,38.0,>,15.0,11,22,<,-11,89,63,>,26,43.666666666666664,41.333333333333336,>,2.3333333333333286,35,37,<,-2,53,49,>,4,172,109,>,63
0,13,38.0,44.666666666666664,<,-6.666666666666664,22,27,<,-5,63,58,>,5,41.333333333333336,43.666666666666664,<,-2.3333333333333286,37,43,<,-6,49,45,>,4,109,269,<,-160
158,13,44.666666666666664,38.0,>,6.666666666666664,27,22,>,5,58,63,<,-5,43.666666666666664,41.333333333333336,>,2.3333333333333286,43,37,>,6,45,49,<,-4,269,109,>,160
0,12,37.0,29.333333333333332,>,7.666666666666668,11,10,>,1,82,54,>,28,42.666666666666664,49.0,<,-6.333333333333336,30,32,<,-2,53,59,<,-6,273,144,>,129
0,12,29.333333333333332,37.0,<,-7.666666666666668,10,11,<,-1,54,82,<,-28,49.0,42.666666666666664,>,6.333333333333336,32,30,>,2,59,53,>,6,144,273,<,-129
0,12,37.0,41.333333333333336,<,-4.333333333333336,11,10,>,1,82,88,<,-6,42.666666666666664,43.666666666666664,<,-1.0,30,38,<,-8,53,49,>,4,273,186,>,87
22,12,41.333333333333336,37.0,>,4.333333333333336,10,11,<,-1,88,82,>,6,43.666666666666664,42.666666666666664,>,1.0,38,30,>,8,49,53,<,-4,186,273,<,-87
0,12,37.0,48.0,<,-11.0,11,25,<,-14,82,84,<,-2,42.666666666666664,47.333333333333336,<,-4.666666666666671,30,40,<,-10,53,54,<,-1,273,318,<,-45
100,12,48.0,37.0,>,11.0,25,11,>,14,84,82,>,2,47.333333333333336,42.666666666666664,>,4.666666666666671,40,30,>,10,54,53,>,1,318,273,>,45
0,12,37.0,50.666666666666664,<,-13.666666666666664,11,28,<,-17,82,85,<,-3,42.666666666666664,44.666666666666664,<,-2.0,30,36,<,-6,53,59,<,-6,273,207,>,66
104,12,50.666666666666664,37.0,>,13.666666666666664,28,11,>,17,85,82,>,3,44.666666666666664,42.666666666666664,>,2.0,36,30,>,6,59,53,>,6,207,273,<,-66
0,12,37.0,57.333333333333336,<,-20.333333333333336,11,38,<,-27,82,85,<,-3,42.666666666666664,50.333333333333336,<,-7.666666666666671,30,45,<,-15,53,55,<,-2,273,243,>,30
140,12,57.333333333333336,37.0,>,20.333333333333336,38,11,>,27,85,82,>,3,50.333333333333336,42.666666666666664,>,7.666666666666671,45,30,>,15,55,53,>,2,243,273,<,-30
0,12,37.0,48.666666666666664,<,-11.666666666666664,11,24,<,-13,82,75,>,7,42.666666666666664,48.0,<,-5.333333333333336,30,36,<,-6,53,60,<,-7,273,183,>,90
146,12,48.666666666666664,37.0,>,11.666666666666664,24,11,>,13,75,82,<,-7,48.0,42.666666666666664,>,5.333333333333336,36,30,>,6,60,53,>,7,183,273,<,-90
0,12,37.0,52.333333333333336,<,-15.333333333333336,11,21,<,-10,82,80,>,2,42.666666666666664,43.666666666666664,<,-1.0,30,32,<,-2,53,59,<,-6,273,290,<,-17
148,12,52.333333333333336,37.0,>,15.333333333333336,21,11,>,10,80,82,<,-2,43.666666666666664,42.666666666666664,>,1.0,32,30,>,2,59,53,>,6,290,273,>,17
0,12,37.0,51.0,<,-14.0,11,46,<,-35,82,58,>,24,42.666666666666664,43.666666666666664,<,-1.0,30,43,<,-13,53,45,>,8,273,269,>,4
158,12,51.0,37.0,>,14.0,46,11,>,35,58,82,<,-24,43.666666666666664,42.666666666666664,>,1.0,43,30,>,13,45,53,<,-8,269,273,<,-4
0,12,37.0,57.0,<,-20.0,11,22,<,-11,82,89,<,-7,42.666666666666664,39.666666666666664,>,3.0,30,30,=,0,53,57,<,-4,273,113,>,160
164,12,57.0,37.0,>,20.0,22,11,>,11,89,82,>,7,39.666666666666664,42.666666666666664,<,-3.0,30,30,=,0,57,53,>,4,113,273,<,-160
0,12,37.0,38.666666666666664,<,-1.6666666666666643,11,14,<,-3,82,63,>,19,42.666666666666664,47.666666666666664,<,-5.0,30,42,<,-12,53,51,>,2,273,294,<,-21
145,12,38.666666666666664,37.0,>,1.6666666666666643,14,11,>,3,63,82,<,-19,47.666666666666664,42.666666666666664,>,5.0,42,30,>,12,51,53,<,-2,294,273,>,21
0,12,37.0,28.0,>,9.0,11,11,=,0,82,59,>,23,42.666666666666664,43.666666666666664,<,-1.0,30,35,<,-5,53,53,=,0,273,172,>,101
0,12,28.0,37.0,<,-9.0,11,11,=,0,59,82,<,-23,43.666666666666664,42.666666666666664,>,1.0,35,30,>,5,53,53,=,0,172,273,<,-101
0,11,29.333333333333332,15.666666666666666,>,13.666666666666666,10,11,<,-1,54,22,>,32,49.0,43.666666666666664,>,5.333333333333336,32,35,<,-3,59,53,>,6,144,172,<,-28
0,11,15.666666666666666,29.333333333333332,<,-13.666666666666666,11,10,>,1,22,54,<,-32,43.666666666666664,49.0,<,-5.333333333333336,35,32,>,3,53,59,<,-6,172,144,>,28
0,11,29.333333333333332,43.0,<,-13.666666666666668,10,15,<,-5,54,88,<,-34,49.0,43.666666666666664,>,5.333333333333336,32,38,<,-6,59,49,>,10,144,186,<,-42
0,11,43.0,29.333333333333332,>,13.666666666666668,15,10,>,5,88,54,>,34,43.666666666666664,49.0,<,-5.333333333333336,38,32,>,6,49,59,<,-10,186,144,>,42
0,11,29.333333333333332,59.0,<,-29.666666666666668,10,25,<,-15,54,84,<,-30,49.0,47.333333333333336,>,1.6666666666666643,32,40,<,-8,59,54,>,5,144,318,<,-174
98,11,59.0,29.333333333333332,>,29.666666666666668,25,10,>,15,84,54,>,30,47.333333333333336,49.0,<,-1.6666666666666643,40,32,>,8,54,59,<,-5,318,144,>,174
0,11,29.333333333333332,62.0,<,-32.66666666666667,10,39,<,-29,54,85,<,-31,49.0,44.666666666666664,>,4.333333333333336,32,36,<,-4,59,59,=,0,144,207,<,-63
103,11,62.0,29.333333333333332,>,32.66666666666667,39,10,>,29,85,54,>,31,44.666666666666664,49.0,<,-4.333333333333336,36,32,>,4,59,59,=,0,207,144,>,63
0,11,29.333333333333332,70.0,<,-40.66666666666667,10,38,<,-28,54,87,<,-33,49.0,50.333333333333336,<,-1.3333333333333357,32,45,<,-13,59,55,>,4,144,243,<,-99
136,11,70.0,29.333333333333332,>,40.66666666666667,38,10,>,28,87,54,>,33,50.333333333333336,49.0,>,1.3333333333333357,45,32,>,13,55,59,<,-4,243,144,>,99
0,11,29.333333333333332,43.333333333333336,<,-14.000000000000004,10,14,<,-4,54,77,<,-23,49.0,47.666666666666664,>,1.3333333333333357,32,42,<,-10,59,51,>,8,144,294,<,-150
92,11,43.333333333333336,29.333333333333332,>,14.000000000000004,14,10,>,4,77,54,>,23,47.666666666666664,49.0,<,-1.3333333333333357,42,32,>,10,51,59,<,-8,294,144,>,150
0,11,29.333333333333332,66.0,<,-36.66666666666667,10,47,<,-37,54,76,<,-22,49.0,48.0,>,1.0,32,36,<,-4,59,60,<,-1,144,183,<,-39
147,11,66.0,29.333333333333332,>,36.66666666666667,47,10,>,37,76,54,>,22,48.0,49.0,<,-1.0,36,32,>,4,60,59,>,1,183,144,>,39
0,11,29.333333333333332,68.66666666666667,<,-39.33333333333334,10,56,<,-46,54,80,<,-26,49.0,43.666666666666664,>,5.333333333333336,32,32,=,0,59,59,=,0,144,290,<,-146
163,11,68.66666666666667,29.333333333333332,>,39.33333333333334,56,10,>,46,80,54,>,26,43.666666666666664,49.0,<,-5.333333333333336,32,32,=,0,59,59,=,0,290,144,>,146
0,11,29.333333333333332,42.333333333333336,<,-13.000000000000004,10,23,<,-13,54,58,<,-4,49.0,43.666666666666664,>,5.333333333333336,32,43,<,-11,59,45,>,14,144,269,<,-125
54,11,42.333333333333336,29.333333333333332,>,13.000000000000004,23,10,>,13,58,54,>,4,43.666666666666664,49.0,<,-5.333333333333336,43,32,>,11,45,59,<,-14,269,144,>,125
0,11,29.333333333333332,69.33333333333333,<,-40.0,10,59,<,-49,54,89,<,-35,49.0,39.666666666666664,>,9.333333333333336,32,30,>,2,59,57,>,2,144,113,>,31
170,11,69.33333333333333,29.333333333333332,>,40.0,59,10,>,49,89,54,>,35,39.666666666666664,49.0,<,-9.333333333333336,30,32,<,-2,57,59,<,-2,113,144,<,-31
0,10,47.666666666666664,40.0,>,7.666666666666664,15,14,>,1,88,84,>,4,43.666666666666664,43.666666666666664,=,0.0,38,35,>,3,49,53,<,-4,186,172,>,14
0,10,40.0,47.666666666666664,<,-7.666666666666664,14,15,<,-1,84,88,<,-4,43.666666666666664,43.666666666666664,=,0.0,35,38,<,-3,53,49,>,4,172,186,<,-14
0,10,47.666666666666664,43.666666666666664,>,4.0,15,23,<,-8,88,62,>,26,43.666666666666664,43.666666666666664,=,0.0,38,43,<,-5,49,45,>,4,186,269,<,-83
54,10,43.666666666666664,47.666666666666664,<,-4.0,23,15,>,8,62,88,<,-26,43.666666666666664,43.666666666666664,=,0.0,43,38,>,5,45,49,<,-4,269,186,>,83
0,10,47.666666666666664,44.666666666666664,>,3.0,15,14,>,1,88,77,>,11,43.666666666666664,47.666666666666664,<,-4.0,38,42,<,-4,49,51,<,-2,186,294,<,-108
92,10,44.666666666666664,47.666666666666664,<,-3.0,14,15,<,-1,77,88,<,-11,47.666666666666664,43.666666666666664,>,4.0,42,38,>,4,51,49,>,2,294,186,>,108
0,10,47.666666666666664,79.0,<,-31.333333333333336,15,68,<,-53,88,85,>,3,43.666666666666664,47.333333333333336,<,-3.6666666666666714,38,40,<,-2,49,54,<,-5,186,318,<,-132
98,10,79.0,47.666666666666664,>,31.333333333333336,68,15,>,53,85,88,<,-3,47.333333333333336,43.666666666666664,>,3.6666666666666714,40,38,>,2,54,49,>,5,318,186,>,132
0,10,47.666666666666664,39.333333333333336,>,8.333333333333329,15,17,<,-2,88,62,>,26,43.666666666666664,44.666666666666664,<,-1.0,38,36,>,2,49,59,<,-10,186,207,<,-21
103,10,39.333333333333336,47.666666666666664,<,-8.333333333333329,17,15,>,2,62,88,<,-26,44.666666666666664,43.666666666666664,>,1.0,36,38,<,-2,59,49,>,10,207,186,>,21
0,10,47.666666666666664,86.66666666666667,<,-39.00000000000001,15,85,<,-70,88,88,=,0,43.666666666666664,50.333333333333336,<,-6.666666666666671,38,45,<,-7,49,55,<,-6,186,243,<,-57
148,10,86.66666666666667,47.666666666666664,>,39.00000000000001,85,15,>,70,88,88,=,0,50.333333333333336,43.666666666666664,>,6.666666666666671,45,38,>,7,55,49,>,6,243,186,>,57
0,10,47.666666666666664,57.666666666666664,<,-10.0,15,22,<,-7,88,76,>,12,43.666666666666664,48.0,<,-4.333333333333336,38,36,>,2,49,60,<,-11,186,183,>,3
0,10,57.666666666666664,47.666666666666664,>,10.0,22,15,>,7,76,88,<,-12,48.0,43.666666666666664,>,4.333333333333336,36,38,<,-2,60,49,>,11,183,186,<,-3
0,10,47.666666666666664,49.666666666666664,<,-2.0,15,23,<,-8,88,70,>,18,43.666666666666664,43.666666666666664,=,0.0,38,32,>,6,49,59,<,-10,186,290,<,-104
113,10,49.666666666666664,47.666666666666664,>,2.0,23,15,>,8,70,88,<,-18,43.666666666666664,43.666666666666664,=,0.0,32,38,<,-6,59,49,>,10,290,186,>,104
0,10,47.666666666666664,50.0,<,-2.3333333333333357,15,31,<,-16,88,60,>,28,43.666666666666664,39.666666666666664,>,4.0,38,30,>,8,49,57,<,-8,186,113,>,73
179,10,50.0,47.666666666666664,>,2.3333333333333357,31,15,>,16,60,88,<,-28,39.666666666666664,43.666666666666664,<,-4.0,30,38,<,-8,57,49,>,8,113,186,<,-73
0,9,48.0,61.0,<,-13.0,22,14,>,8,75,85,<,-10,48.0,43.666666666666664,>,4.333333333333336,36,35,>,1,60,53,>,7,183,172,>,11
0,9,61.0,48.0,>,13.0,14,22,<,-8,85,75,>,10,43.666666666666664,48.0,<,-4.333333333333336,35,36,<,-1,53,60,<,-7,172,183,<,-11
0,9,48.0,43.666666666666664,>,4.333333333333336,22,23,<,-1,75,62,>,13,48.0,43.666666666666664,>,4.333333333333336,36,43,<,-7,60,45,>,15,183,269,<,-86
21,9,43.666666666666664,48.0,<,-4.333333333333336,23,22,>,1,62,75,<,-13,43.666666666666664,48.0,<,-4.333333333333336,43,36,>,7,45,60,<,-15,269,183,>,86
0,9,48.0,40.333333333333336,>,7.666666666666664,22,14,>,8,75,64,>,11,48.0,47.666666666666664,>,0.3333333333333357,36,42,<,-6,60,51,>,9,183,294,<,-111
69,9,40.333333333333336,48.0,<,-7.666666666666664,14,22,<,-8,64,75,<,-11,47.666666666666664,48.0,<,-0.3333333333333357,42,36,>,6,51,60,<,-9,294,183,>,111
0,9,48.0,65.66666666666667,<,-17.66666666666667,22,28,<,-6,75,85,<,-10,48.0,47.333333333333336,>,0.6666666666666643,36,40,<,-4,60,54,>,6,183,318,<,-135
0,9,65.66666666666667,48.0,>,17.66666666666667,28,22,>,6,85,75,>,10,47.333333333333336,48.0,<,-0.6666666666666643,40,36,>,4,54,60,<,-6,318,183,>,135
0,9,48.0,38.333333333333336,>,9.666666666666664,22,17,>,5,75,59,>,16,48.0,44.666666666666664,>,3.3333333333333357,36,36,=,0,60,59,>,1,183,207,<,-24
76,9,38.333333333333336,48.0,<,-9.666666666666664,17,22,<,-5,59,75,<,-16,44.666666666666664,48.0,<,-3.3333333333333357,36,36,=,0,59,60,<,-1,207,183,>,24
0,9,48.0,36.666666666666664,>,11.333333333333336,22,23,<,-1,75,56,>,19,48.0,43.666666666666664,>,4.333333333333336,36,32,>,4,60,59,>,1,183,290,<,-107
100,9,36.666666666666664,48.0,<,-11.333333333333336,23,22,>,1,56,75,<,-19,43.666666666666664,48.0,<,-4.333333333333336,32,36,<,-4,59,60,<,-1,290,183,>,107
0,9,48.0,84.33333333333333,<,-36.33333333333333,22,80,<,-58,75,88,<,-13,48.0,50.333333333333336,<,-2.3333333333333357,36,45,<,-9,60,55,>,5,183,243,<,-60
89,9,84.33333333333333,48.0,>,36.33333333333333,80,22,>,58,88,75,>,13,50.333333333333336,48.0,>,2.3333333333333357,45,36,>,9,55,60,<,-5,243,183,>,60
0,9,48.0,42.0,>,6.0,22,31,<,-9,75,60,>,15,48.0,39.666666666666664,>,8.333333333333336,36,30,>,6,60,57,>,3,183,113,>,70
145,9,42.0,48.0,<,-6.0,31,22,>,9,60,75,<,-15,39.666666666666664,48.0,<,-8.333333333333336,30,36,<,-6,57,60,<,-3,113,183,<,-70
0,8,41.666666666666664,51.333333333333336,<,-9.666666666666671,13,14,<,-1,84,85,<,-1,47.333333333333336,43.666666666666664,>,3.6666666666666714,40,35,>,5,54,53,>,1,318,172,>,146
0,8,51.333333333333336,41.666666666666664,>,9.666666666666671,14,13,>,1,85,84,>,1,43.666666666666664,47.333333333333336,<,-3.6666666666666714,35,40,<,-5,53,54,<,-1,172,318,<,-146
0,8,41.666666666666664,41.333333333333336,>,0.3333333333333286,13,23,<,-10,84,55,>,29,47.333333333333336,43.666666666666664,>,3.6666666666666714,40,43,<,-3,54,45,>,9,318,269,>,49
21,8,41.333333333333336,41.666666666666664,<,-0.3333333333333286,23,13,>,10,55,84,<,-29,43.666666666666664,47.333333333333336,<,-3.6666666666666714,43,40,>,3,45,54,<,-9,269,318,<,-49
0,8,41.666666666666664,34.333333333333336,>,7.333333333333329,13,14,<,-1,84,64,>,20,47.333333333333336,47.666666666666664,<,-0.3333333333333286,40,42,<,-2,54,51,>,3,318,294,>,24
47,8,34.333333333333336,41.666666666666664,<,-7.333333333333329,14,13,>,1,64,84,<,-20,47.666666666666664,47.333333333333336,>,0.3333333333333286,42,40,>,2,51,54,<,-3,294,318,<,-24
0,8,41.666666666666664,45.0,<,-3.3333333333333357,13,37,<,-24,84,59,>,25,47.333333333333336,44.666666666666664,>,2.6666666666666714,40,36,>,4,54,59,<,-5,318,207,>,111
76,8,45.0,41.666666666666664,>,3.3333333333333357,37,13,>,24,59,84,<,-25,44.666666666666664,47.333333333333336,<,-2.6666666666666714,36,40,<,-4,59,54,>,5,207,318,<,-111
0,8,41.666666666666664,67.0,<,-25.333333333333336,13,36,<,-23,84,85,<,-1,47.333333333333336,50.333333333333336,<,-3.0,40,45,<,-5,54,55,<,-1,318,243,>,75
0,8,67.0,41.666666666666664,>,25.333333333333336,36,13,>,23,85,84,>,1,50.333333333333336,47.333333333333336,>,3.0,45,40,>,5,55,54,>,1,243,318,<,-75
0,8,41.666666666666664,39.333333333333336,>,2.3333333333333286,13,31,<,-18,84,56,>,28,47.333333333333336,43.666666666666664,>,3.6666666666666714,40,32,>,8,54,59,<,-5,318,290,>,28
81,8,39.333333333333336,41.666666666666664,<,-2.3333333333333286,31,13,>,18,56,84,<,-28,43.666666666666664,47.333333333333336,<,-3.6666666666666714,32,40,<,-8,59,54,>,5,290,318,<,-28
0,8,41.666666666666664,44.333333333333336,<,-2.6666666666666714,13,35,<,-22,84,60,>,24,47.333333333333336,39.666666666666664,>,7.666666666666671,40,30,>,10,54,57,<,-3,318,113,>,205
145,8,44.333333333333336,41.666666666666664,>,2.6666666666666714,35,13,>,22,60,84,<,-24,39.666666666666664,47.333333333333336,<,-7.666666666666671,30,40,<,-10,57,54,>,3,113,318,<,-205
0,7,48.666666666666664,49.0,<,-0.3333333333333357,25,14,>,11,85,78,>,7,50.333333333333336,43.666666666666664,>,6.666666666666671,45,35,>,10,55,53,>,2,243,172,>,71
0,7,49.0,48.666666666666664,>,0.3333333333333357,14,25,<,-11,78,85,<,-7,43.666666666666664,50.333333333333336,<,-6.666666666666671,35,45,<,-10,53,55,<,-2,172,243,<,-71
0,7,48.666666666666664,61.333333333333336,<,-12.666666666666671,25,46,<,-21,85,83,>,2,50.333333333333336,43.666666666666664,>,6.666666666666671,45,43,>,2,55,45,>,10,243,269,<,-26
113,7,61.333333333333336,48.666666666666664,>,12.666666666666671,46,25,>,21,83,85,<,-2,43.666666666666664,50.333333333333336,<,-6.666666666666671,43,45,<,-2,45,55,<,-10,269,243,>,26
0,7,48.666666666666664,36.666666666666664,>,12.0,25,14,>,11,85,71,>,14,50.333333333333336,47.666666666666664,>,2.6666666666666714,45,42,>,3,55,51,>,4,243,294,<,-51
47,7,36.666666666666664,48.666666666666664,<,-12.0,14,25,<,-11,71,85,<,-14,47.666666666666664,50.333333333333336,<,-2.6666666666666714,42,45,<,-3,51,55,<,-4,294,243,>,51
0,7,48.666666666666664,29.666666666666668,>,18.999999999999996,25,13,>,12,85,39,>,46,50.333333333333336,44.666666666666664,>,5.666666666666671,45,36,>,9,55,59,<,-4,243,207,>,36
72,7,29.666666666666668,48.666666666666664,<,-18.999999999999996,13,25,<,-12,39,85,<,-46,44.666666666666664,50.333333333333336,<,-5.666666666666671,36,45,<,-9,59,55,>,4,207,243,<,-36
0,7,48.666666666666664,55.0,<,-6.333333333333336,25,31,<,-6,85,78,>,7,50.333333333333336,43.666666666666664,>,6.666666666666671,45,32,>,13,55,59,<,-4,243,290,<,-47
81,7,55.0,48.666666666666664,>,6.333333333333336,31,25,>,6,78,85,<,-7,43.666666666666664,50.333333333333336,<,-6.666666666666671,32,45,<,-13,59,55,>,4,290,243,>,47
0,7,48.666666666666664,50.666666666666664,<,-2.0,25,38,<,-13,85,60,>,25,50.333333333333336,39.666666666666664,>,10.666666666666671,45,30,>,15,55,57,<,-2,243,113,>,130
181,7,50.666666666666664,48.666666666666664,>,2.0,38,25,>,13,60,85,<,-25,39.666666666666664,50.333333333333336,<,-10.666666666666671,30,45,<,-15,57,55,>,2,113,243,<,-130
0,6,48.0,41.0,>,7.0,14,14,=,0,78,71,>,7,43.666666666666664,47.666666666666664,<,-4.0,35,42,<,-7,53,51,>,2,172,294,<,-122
62,6,41.0,48.0,<,-7.0,14,14,=,0,71,78,<,-7,47.666666666666664,43.666666666666664,>,4.0,42,35,>,7,51,53,<,-2,294,172,>,122
0,6,48.0,28.0,>,20.0,14,13,>,1,78,39,>,39,43.666666666666664,44.666666666666664,<,-1.0,35,36,<,-1,53,59,<,-6,172,207,<,-35
72,6,28.0,48.0,<,-20.0,13,14,<,-1,39,78,<,-39,44.666666666666664,43.666666666666664,>,1.0,36,35,>,1,59,53,>,6,207,172,>,35
0,6,48.0,51.0,<,-3.0,14,19,<,-5,78,78,=,0,43.666666666666664,43.666666666666664,=,0.0,35,32,>,3,53,59,<,-6,172,290,<,-118
64,6,51.0,48.0,>,3.0,19,14,>,5,78,78,=,0,43.666666666666664,43.666666666666664,=,0.0,32,35,<,-3,59,53,>,6,290,172,>,118
0,6,48.0,46.666666666666664,>,1.3333333333333357,14,11,>,3,78,83,<,-5,43.666666666666664,43.666666666666664,=,0.0,35,43,<,-8,53,45,>,8,172,269,<,-97
0,6,46.666666666666664,48.0,<,-1.3333333333333357,11,14,<,-3,83,78,>,5,43.666666666666664,43.666666666666664,=,0.0,43,35,>,8,45,53,<,-8,269,172,>,97
0,6,48.0,56.666666666666664,<,-8.666666666666664,14,54,<,-40,78,60,>,18,43.666666666666664,39.666666666666664,>,4.0,35,30,>,5,53,57,<,-4,172,113,>,59
181,6,56.666666666666664,48.0,>,8.666666666666664,54,14,>,40,60,78,<,-18,39.666666666666664,43.666666666666664,<,-4.0,30,35,<,-5,57,53,>,4,113,172,<,-59
0,5,40.333333333333336,41.333333333333336,<,-1.0,11,15,<,-4,83,71,>,12,43.666666666666664,47.666666666666664,<,-4.0,43,42,>,1,45,51,<,-6,269,294,<,-25
62,5,41.333333333333336,40.333333333333336,>,1.0,15,11,>,4,71,83,<,-12,47.666666666666664,43.666666666666664,>,4.0,42,43,<,-1,51,45,>,6,294,269,>,25
0,5,40.333333333333336,51.0,<,-10.666666666666664,11,19,<,-8,83,78,>,5,43.666666666666664,43.666666666666664,=,0.0,43,32,>,11,45,59,<,-14,269,290,<,-21
64,5,51.0,40.333333333333336,>,10.666666666666664,19,11,>,8,78,83,<,-5,43.666666666666664,43.666666666666664,=,0.0,32,43,<,-11,59,45,>,14,290,269,>,21
0,5,40.333333333333336,34.666666666666664,>,5.666666666666671,11,13,<,-2,83,59,>,24,43.666666666666664,44.666666666666664,<,-1.0,43,36,>,7,45,59,<,-14,269,207,>,62
72,5,34.666666666666664,40.333333333333336,<,-5.666666666666671,13,11,>,2,59,83,<,-24,44.666666666666664,43.666666666666664,>,1.0,36,43,<,-7,59,45,>,14,207,269,<,-62
0,5,40.333333333333336,43.0,<,-2.6666666666666643,11,19,<,-8,83,56,>,27,43.666666666666664,39.666666666666664,>,4.0,43,30,>,13,45,57,<,-12,269,113,>,156
0,5,43.0,40.333333333333336,>,2.6666666666666643,19,11,>,8,56,83,<,-27,39.666666666666664,43.666666666666664,<,-4.0,30,43,<,-13,57,45,>,12,113,269,<,-156
0,4,45.666666666666664,55.666666666666664,<,-10.0,19,15,>,4,64,81,<,-17,39.666666666666664,47.666666666666664,<,-8.0,30,42,<,-12,57,51,>,6,113,294,<,-181
97,4,55.666666666666664,45.666666666666664,>,10.0,15,19,<,-4,81,64,>,17,47.666666666666664,39.666666666666664,>,8.0,42,30,>,12,51,57,<,-6,294,113,>,181
0,4,45.666666666666664,60.333333333333336,<,-14.666666666666671,19,47,<,-28,64,78,<,-14,39.666666666666664,43.666666666666664,<,-4.0,30,32,<,-2,57,59,<,-2,113,290,<,-177
135,4,60.333333333333336,45.666666666666664,>,14.666666666666671,47,19,>,28,78,64,>,14,43.666666666666664,39.666666666666664,>,4.0,32,30,>,2,59,57,>,2,290,113,>,177
0,4,45.666666666666664,54.0,<,-8.333333333333336,19,13,>,6,64,90,<,-26,39.666666666666664,44.666666666666664,<,-5.0,30,36,<,-6,57,59,<,-2,113,207,<,-94
103,4,54.0,45.666666666666664,>,8.333333333333336,13,19,<,-6,90,64,>,26,44.666666666666664,39.666666666666664,>,5.0,36,30,>,6,59,57,>,2,207,113,>,94
0,3,44.333333333333336,72.33333333333333,<,-27.999999999999993,13,65,<,-52,90,81,>,9,44.666666666666664,47.666666666666664,<,-3.0,36,42,<,-6,59,51,>,8,207,294,<,-87
97,3,72.33333333333333,44.333333333333336,>,27.999999999999993,65,13,>,52,81,90,<,-9,47.666666666666664,44.666666666666664,>,3.0,42,36,>,6,51,59,<,-8,294,207,>,87
0,3,44.333333333333336,54.0,<,-9.666666666666664,13,37,<,-24,90,78,>,12,44.666666666666664,43.666666666666664,>,1.0,36,32,>,4,59,59,=,0,207,290,<,-83
103,3,54.0,44.333333333333336,>,9.666666666666664,37,13,>,24,78,90,<,-12,43.666666666666664,44.666666666666664,<,-1.0,32,36,<,-4,59,59,=,0,290,207,>,83
0,2,46.333333333333336,79.66666666666667,<,-33.333333333333336,14,71,<,-57,78,87,<,-9,43.666666666666664,47.666666666666664,<,-4.0,32,42,<,-10,59,51,>,8,290,294,<,-4
97,2,79.66666666666667,46.333333333333336,>,33.333333333333336,71,14,>,57,87,78,>,9,47.666666666666664,43.666666666666664,>,4.0,42,32,>,10,51,59,<,-8,294,290,>,4
